id,first_name,last_name,email,job_title,basic_salary,allowances,gross_salary
1,Inge,Reinisch,ireinisch0@ft.com,Statistician IV,1976,1492,3468
2,Therine,Chalice,tchalice1@mapy.cz,Assistant Professor,9887,1328,11215
3,Linn,Carragher,lcarragher2@go.com,Tax Accountant,8656,773,9429
4,Daven,Stennine,dstennine3@shareasale.com,Senior Developer,6676,594,7270
5,Valery,Konrad,vkonrad4@elegantthemes.com,Social Worker,7932,502,8434
6,Randi,Abela,rabela5@prlog.org,Payment Adjustment Coordinator,5190,1744,6934
7,Chic,Lamswood,clamswood6@lycos.com,Recruiting Manager,3366,221,3587
8,Reggie,Dudeney,rdudeney7@paginegialle.it,Senior Quality Engineer,9361,615,9976
9,Korry,Sambedge,ksambedge8@ehow.com,Mechanical Systems Engineer,5153,1646,6799
10,Sheri,Callendar,scallendar9@merriam-webster.com,Programmer II,6009,1182,7191
11,Arvie,Kollach,akollacha@mapy.cz,Engineer II,9456,1383,10839
12,Nikolia,Morrissey,nmorrisseyb@un.org,Financial Analyst,5266,1815,7081
13,Lindie,Poulden,lpouldenc@tripadvisor.com,Social Worker,7645,700,8345
14,Lindsy,Goade,lgoaded@gov.uk,Compensation Analyst,1972,1118,3090
15,Darlene,Esberger,desbergere@imdb.com,VP Accounting,6036,1121,7157
16,Tomkin,todor,ttodorf@umn.edu,Assistant Media Planner,9674,971,10645
17,Melisandra,Asquez,masquezg@wikispaces.com,Analog Circuit Design manager,2770,374,3144
18,Renault,Crampsy,rcrampsyh@jimdo.com,Marketing Assistant,5146,1124,6270
19,Ariana,Copestick,acopesticki@youku.com,Marketing Manager,5367,1463,6830
20,Ware,Coit,wcoitj@infoseek.co.jp,Senior Quality Engineer,8501,1734,10235
21,Daffie,Pyrke,dpyrkek@google.co.uk,Programmer Analyst II,2928,976,3904
22,Matti,Iowarch,miowarchl@amazon.co.jp,Administrative Officer,8567,1358,9925
23,Cecil,Floris,cflorism@cmu.edu,Web Designer I,7424,1071,8495
24,Salmon,Chivrall,schivralln@com.com,Administrative Officer,8921,686,9607
25,Masha,Gatesman,mgatesmano@simplemachines.org,Physical Therapy Assistant,9367,1780,11147
26,Dacie,Cogley,dcogleyp@1und1.de,Senior Editor,4253,222,4475
27,Hadley,Plaistowe,hplaistoweq@reference.com,Financial Advisor,9372,1244,10616
28,Nerti,Vigors,nvigorsr@sphinn.com,Internal Auditor,9269,679,9948
29,Cozmo,O' Cloney,cocloneys@sun.com,Help Desk Operator,3541,755,4296
30,Findlay,Whiffen,fwhiffent@usatoday.com,Safety Technician IV,7920,1381,9301
31,Corrie,Rarity,crarityu@canalblog.com,VP Product Management,1686,489,2175
32,Eydie,Robjant,erobjantv@reverbnation.com,Quality Control Specialist,5374,617,5991
33,Harper,Diver,hdiverw@unicef.org,Senior Cost Accountant,7290,901,8191
34,Sam,Ferby,sferbyx@bloglovin.com,Research Nurse,2914,820,3734
35,Iris,Disbrey,idisbreyy@cloudflare.com,Clinical Specialist,7580,646,8226
36,Don,Habbon,dhabbonz@sitemeter.com,Senior Developer,8622,309,8931
37,Brok,Washtell,bwashtell10@hud.gov,Account Coordinator,1210,1523,2733
38,Morgun,Cullington,mcullington11@devhub.com,Social Worker,9204,449,9653
39,Omar,McGiveen,omcgiveen12@sciencedaily.com,Account Coordinator,1191,1793,2984
40,Merlina,Ruppelin,mruppelin13@merriam-webster.com,Design Engineer,2155,1846,4001
41,Bartram,Suddick,bsuddick14@mail.ru,Paralegal,5197,838,6035
42,Margot,MacMillan,mmacmillan15@gov.uk,Senior Quality Engineer,2512,1557,4069
43,Curtice,Sabatier,csabatier16@admin.ch,VP Accounting,5028,1558,6586
44,Gwendolen,Schmidt,gschmidt17@whitehouse.gov,Business Systems Development Analyst,2022,1098,3120
45,Gisella,Benedite,gbenedite18@uiuc.edu,Financial Analyst,3400,1934,5334
46,Sherilyn,Bohlin,sbohlin19@google.it,Quality Engineer,6516,1185,7701
47,Raffaello,McCrory,rmccrory1a@oracle.com,Executive Secretary,7168,1851,9019
48,Lani,Espinheira,lespinheira1b@nps.gov,Automation Specialist III,5262,362,5624
49,Webster,Rook,wrook1c@rakuten.co.jp,Computer Systems Analyst III,5401,563,5964
50,Brandie,Swindles,bswindles1d@vinaora.com,Data Coordiator,9919,1069,10988
51,Pierre,Majury,pmajury1e@163.com,Nurse,9242,303,9545
52,Ginny,Ingamells,gingamells1f@edublogs.org,Environmental Specialist,6323,851,7174
53,Georgette,Bennike,gbennike1g@twitpic.com,Pharmacist,4344,1062,5406
54,Enos,Imlin,eimlin1h@cloudflare.com,Tax Accountant,9733,1542,11275
55,Emogene,Fallanche,efallanche1i@mapquest.com,Research Assistant III,1374,673,2047
56,Alvira,McIlwrick,amcilwrick1j@spotify.com,Office Assistant I,7073,456,7529
57,Arri,Sedger,asedger1k@unesco.org,Financial Advisor,6796,1483,8279
58,Margaret,Andrew,mandrew1l@sun.com,Help Desk Technician,9550,1285,10835
59,Marijo,Daintree,mdaintree1m@devhub.com,Senior Developer,7420,1140,8560
60,Jock,Kirvell,jkirvell1n@xrea.com,VP Sales,6943,552,7495
61,Madelyn,Stang-Gjertsen,mstanggjertsen1o@hud.gov,Research Nurse,5871,1101,6972
62,Estele,Korpal,ekorpal1p@delicious.com,Administrative Officer,6253,416,6669
63,Heather,Rudman,hrudman1q@flavors.me,Dental Hygienist,7647,268,7915
64,Belicia,Brumby,bbrumby1r@diigo.com,Senior Quality Engineer,6502,376,6878
65,Lucilia,Ferrick,lferrick1s@huffingtonpost.com,Technical Writer,9517,1393,10910
66,Dorey,Adey,dadey1t@geocities.com,Office Assistant III,8239,753,8992
67,Nate,Pettman,npettman1u@hhs.gov,Assistant Media Planner,1020,292,1312
68,Fonzie,Cesconi,fcesconi1v@japanpost.jp,Graphic Designer,6351,1470,7821
69,Des,Banham,dbanham1w@illinois.edu,Staff Accountant I,6912,1853,8765
70,Enrique,MacIlurick,emacilurick1x@icq.com,Recruiting Manager,6852,1209,8061
71,Thekla,Danbi,tdanbi1y@reuters.com,Community Outreach Specialist,6972,1437,8409
72,Ryley,Lawther,rlawther1z@fc2.com,Paralegal,9970,1186,11156
73,Benjamin,Orrill,borrill20@google.com,Environmental Tech,2085,801,2886
74,Laurice,Inkles,linkles21@nifty.com,Design Engineer,4857,541,5398
75,Nevsa,Rubinovitsch,nrubinovitsch22@skyrock.com,Staff Scientist,7305,1151,8456
76,Bettine,Casaroli,bcasaroli23@blogtalkradio.com,Chemical Engineer,8620,1176,9796
77,Drusy,Gallamore,dgallamore24@java.com,Payment Adjustment Coordinator,5902,1170,7072
78,Phil,Elvins,pelvins25@ted.com,VP Marketing,5541,510,6051
79,Marja,Berends,mberends26@homestead.com,Health Coach III,4487,1009,5496
80,Rivalee,Aspell,raspell27@jalbum.net,Information Systems Manager,5310,816,6126
81,Karrah,Gurling,kgurling28@bluehost.com,Recruiting Manager,8948,1933,10881
82,Tito,Ettritch,tettritch29@ibm.com,Actuary,7381,987,8368
83,Marv,Charrier,mcharrier2a@hubpages.com,Nurse,6114,1085,7199
84,Thomasa,McClaurie,tmcclaurie2b@eepurl.com,Structural Engineer,4861,818,5679
85,Linea,Darree,ldarree2c@phpbb.com,Pharmacist,2865,270,3135
86,Nevile,Laydon,nlaydon2d@mozilla.com,Account Executive,7999,1500,9499
87,Rowan,Margarson,rmargarson2e@jalbum.net,Internal Auditor,4729,1374,6103
88,Leland,Allden,lallden2f@mashable.com,Safety Technician IV,8995,214,9209
89,Rourke,Domerc,rdomerc2g@sourceforge.net,Operator,2475,1738,4213
90,Lavena,Pashbee,lpashbee2h@usda.gov,Nurse Practicioner,9389,400,9789
91,Willette,Bushen,wbushen2i@symantec.com,Design Engineer,3752,456,4208
92,Dwight,Albutt,dalbutt2j@mtv.com,Assistant Media Planner,7027,1837,8864
93,Laurent,Yea,lyea2k@google.de,Nurse,2688,1555,4243
94,Rainer,Cathcart,rcathcart2l@blogspot.com,Senior Developer,5010,967,5977
95,Solly,Gertray,sgertray2m@instagram.com,Dental Hygienist,1652,1075,2727
96,Bartholemy,Gammon,bgammon2n@netscape.com,Administrative Officer,6925,324,7249
97,Jobey,Drews,jdrews2o@hexun.com,Project Manager,7733,317,8050
98,Trish,Stellman,tstellman2p@nba.com,Web Developer I,1509,662,2171
99,Rodd,Roach,rroach2q@linkedin.com,Research Nurse,5106,1597,6703
100,Cristabel,Preator,cpreator2r@unblog.fr,Payment Adjustment Coordinator,1332,395,1727
101,Pattin,Swadon,pswadon2s@constantcontact.com,Computer Systems Analyst III,7942,444,8386
102,Bibbye,Sloam,bsloam2t@parallels.com,Software Consultant,7876,1521,9397
103,Cristian,Coulston,ccoulston2u@geocities.jp,Chief Design Engineer,1435,1681,3116
104,Rory,Hawkin,rhawkin2v@nifty.com,Account Coordinator,1946,1699,3645
105,Delphine,Hornung,dhornung2w@usa.gov,Software Test Engineer IV,4684,968,5652
106,Garrard,Prangley,gprangley2x@bloomberg.com,Junior Executive,6550,1068,7618
107,Glynda,Bradshaw,gbradshaw2y@zimbio.com,Database Administrator II,1255,907,2162
108,Ema,Higgonet,ehiggonet2z@umich.edu,Statistician IV,5578,889,6467
109,Kingston,Albro,kalbro30@opensource.org,Office Assistant II,3046,429,3475
110,Genevieve,Drugan,gdrugan31@hc360.com,Teacher,4270,662,4932
111,Haily,Batalle,hbatalle32@qq.com,Web Developer III,9641,810,10451
112,Martina,Lere,mlere33@mashable.com,Engineer II,7418,873,8291
113,Sondra,Gofton,sgofton34@wisc.edu,Occupational Therapist,5291,1492,6783
114,Stewart,MacCostigan,smaccostigan35@opera.com,Recruiter,6766,1099,7865
115,Trish,Dri,tdri36@cdbaby.com,Safety Technician I,2223,1403,3626
116,Adrienne,Salvadori,asalvadori37@com.com,Programmer I,1775,1139,2914
117,Lannie,Emig,lemig38@vk.com,Assistant Professor,4614,1728,6342
118,Shaw,Benois,sbenois39@nsw.gov.au,Research Associate,6522,393,6915
119,Laverne,Tunnadine,ltunnadine3a@google.co.jp,Systems Administrator II,8057,1582,9639
120,Hall,Kilmaster,hkilmaster3b@cmu.edu,Analyst Programmer,7094,1447,8541
121,Artemis,Howie,ahowie3c@goodreads.com,Staff Scientist,4347,217,4564
122,Kyle,Teare,kteare3d@tuttocitta.it,Administrative Assistant IV,5689,262,5951
123,Helyn,Wabersich,hwabersich3e@adobe.com,Administrative Officer,8687,1945,10632
124,Melesa,Bowich,mbowich3f@1und1.de,Nurse,2358,946,3304
125,Alastair,Ginner,aginner3g@yandex.ru,VP Quality Control,5356,342,5698
126,Claybourne,Alliott,calliott3h@issuu.com,Paralegal,1978,992,2970
127,Roscoe,Mathevon,rmathevon3i@hugedomains.com,Software Test Engineer III,2956,1802,4758
128,Tiena,O'Hoey,tohoey3j@princeton.edu,Professor,8892,348,9240
129,Alyson,Stride,astride3k@purevolume.com,Legal Assistant,8997,1932,10929
130,Lanae,Kelso,lkelso3l@nih.gov,General Manager,9283,294,9577
131,Deonne,Harower,dharower3m@123-reg.co.uk,Geologist IV,8673,1577,10250
132,Jude,Esmead,jesmead3n@prlog.org,VP Sales,7920,1497,9417
133,Herve,Wainman,hwainman3o@g.co,Design Engineer,1148,1480,2628
134,Pippy,Tatters,ptatters3p@wikimedia.org,Quality Control Specialist,3999,1196,5195
135,Sonnnie,Olorenshaw,solorenshaw3q@omniture.com,Internal Auditor,9201,939,10140
136,Pavla,Grocock,pgrocock3r@studiopress.com,Payment Adjustment Coordinator,8129,690,8819
137,Zedekiah,McColgan,zmccolgan3s@wikimedia.org,Account Representative II,8286,1616,9902
138,Orland,Gallymore,ogallymore3t@ifeng.com,Mechanical Systems Engineer,7188,1930,9118
139,Kizzie,Decroix,kdecroix3u@deviantart.com,Geological Engineer,7626,743,8369
140,Dorris,Phinn,dphinn3v@goo.gl,VP Product Management,7138,1783,8921
141,Jeff,Crassweller,jcrassweller3w@tripadvisor.com,VP Marketing,6936,508,7444
142,Mohandas,Earland,mearland3x@sourceforge.net,Compensation Analyst,5775,414,6189
143,Aubry,Bushell,abushell3y@mac.com,Structural Engineer,6044,1280,7324
144,Stephine,Deam,sdeam3z@blinklist.com,Project Manager,5590,889,6479
145,Dre,Soar,dsoar40@nature.com,Environmental Tech,4070,950,5020
146,Eileen,Roberti,eroberti41@dagondesign.com,VP Accounting,3104,958,4062
147,Melvyn,Lothean,mlothean42@youtu.be,Teacher,7868,1251,9119
148,Catharina,Lynde,clynde43@wikimedia.org,Programmer Analyst I,8049,1039,9088
149,Kirsti,Lacknor,klacknor44@theatlantic.com,Biostatistician III,9782,1634,11416
150,Tadd,Thripp,tthripp45@cdbaby.com,Financial Advisor,4416,534,4950
151,Carce,Manjin,cmanjin46@whitehouse.gov,Operator,8436,324,8760
152,Odey,Dunlap,odunlap47@psu.edu,Human Resources Assistant IV,9791,466,10257
153,Dyna,O'Kynsillaghe,dokynsillaghe48@addtoany.com,Assistant Manager,8809,1242,10051
154,Giffy,Wedon,gwedon49@privacy.gov.au,Senior Financial Analyst,9216,302,9518
155,Dael,Full,dfull4a@hexun.com,Speech Pathologist,8008,922,8930
156,Kimble,Silson,ksilson4b@boston.com,Professor,6255,379,6634
157,Dunstan,Oswald,doswald4c@chicagotribune.com,Web Designer IV,8353,1447,9800
158,Carlee,World,cworld4d@moonfruit.com,Statistician IV,6291,937,7228
159,Samantha,Baldack,sbaldack4e@multiply.com,Programmer Analyst II,5556,1463,7019
160,Milly,Bobasch,mbobasch4f@feedburner.com,Structural Engineer,2158,1812,3970
161,Johanna,Caneo,jcaneo4g@senate.gov,Programmer II,3799,1827,5626
162,Burr,Stovold,bstovold4h@admin.ch,Nuclear Power Engineer,3446,770,4216
163,Andree,Benjefield,abenjefield4i@angelfire.com,Compensation Analyst,5432,1033,6465
164,Gustav,McCafferty,gmccafferty4j@stanford.edu,Technical Writer,3849,554,4403
165,Yorgos,Dekeyser,ydekeyser4k@umn.edu,Software Engineer IV,5446,1409,6855
166,Cassy,Welbourn,cwelbourn4l@uiuc.edu,Developer I,9433,259,9692
167,Lise,McKibbin,lmckibbin4m@europa.eu,Desktop Support Technician,3728,1174,4902
168,Berny,Guerrin,bguerrin4n@skyrock.com,Senior Cost Accountant,3917,476,4393
169,Beckie,Danielsson,bdanielsson4o@wufoo.com,Speech Pathologist,3535,1794,5329
170,Tanner,Abrahmson,tabrahmson4p@trellian.com,Structural Analysis Engineer,6240,1269,7509
171,Rayner,Arlow,rarlow4q@nhs.uk,Product Engineer,9761,243,10004
172,Shannan,Imesson,simesson4r@vistaprint.com,VP Marketing,5471,1847,7318
173,Dyann,Cowx,dcowx4s@facebook.com,Statistician III,4731,1081,5812
174,Melicent,Surridge,msurridge4t@pen.io,Quality Engineer,6367,953,7320
175,Ringo,Manning,rmanning4u@gov.uk,Internal Auditor,1698,988,2686
176,Feodor,Kraut,fkraut4v@wiley.com,Editor,9337,1818,11155
177,Towny,Sebrook,tsebrook4w@ca.gov,Financial Advisor,4430,1058,5488
178,Taber,Luby,tluby4x@zimbio.com,Account Representative II,8989,1798,10787
179,Shanta,Bampford,sbampford4y@deliciousdays.com,Programmer Analyst IV,9154,1329,10483
180,Danya,Haton,dhaton4z@samsung.com,Speech Pathologist,3332,634,3966
181,Bran,Gatsby,bgatsby50@alexa.com,Assistant Manager,8730,1795,10525
182,Rutledge,Brettle,rbrettle51@t.co,Senior Sales Associate,1318,1368,2686
183,Ingemar,Houchin,ihouchin52@businessweek.com,Geologist I,6730,568,7298
184,Charlene,Abbotson,cabbotson53@wix.com,Environmental Specialist,2777,1499,4276
185,Wilek,Carmont,wcarmont54@furl.net,Chief Design Engineer,7711,856,8567
186,Elyse,Blayd,eblayd55@ucoz.ru,Research Nurse,4378,788,5166
187,Ellwood,Collymore,ecollymore56@businessinsider.com,Structural Analysis Engineer,5595,827,6422
188,Adria,Koenraad,akoenraad57@jalbum.net,Analyst Programmer,1777,1914,3691
189,Major,Teffrey,mteffrey58@goo.gl,Assistant Professor,1997,1016,3013
190,Timotheus,Pointon,tpointon59@addthis.com,Director of Sales,7787,231,8018
191,Meggi,Nijssen,mnijssen5a@unblog.fr,Quality Engineer,9726,1930,11656
192,Donnie,Glassopp,dglassopp5b@deviantart.com,Physical Therapy Assistant,6423,1185,7608
193,Inna,Perschke,iperschke5c@webmd.com,Geological Engineer,7350,237,7587
194,Abner,McArt,amcart5d@homestead.com,General Manager,8766,1566,10332
195,Saunderson,Probyn,sprobyn5e@sbwire.com,Financial Advisor,3694,1663,5357
196,Laura,Duckit,lduckit5f@so-net.ne.jp,Data Coordiator,7793,274,8067
197,Carlota,Lysaght,clysaght5g@discovery.com,Quality Control Specialist,6753,1497,8250
198,Tallie,Longmaid,tlongmaid5h@cornell.edu,Quality Engineer,6281,1345,7626
199,Jeremie,Botwright,jbotwright5i@flickr.com,Senior Cost Accountant,4659,225,4884
200,Corrine,Comford,ccomford5j@simplemachines.org,Assistant Professor,7985,1652,9637
201,Shea,Di Bartolommeo,sdibartolommeo5k@trellian.com,Technical Writer,8104,1463,9567
202,Modesta,Blood,mblood5l@yandex.ru,Help Desk Technician,1797,484,2281
203,Chery,Cozens,ccozens5m@blogspot.com,Electrical Engineer,4810,1910,6720
204,Gerard,Lafflin,glafflin5n@indiatimes.com,VP Product Management,5062,1028,6090
205,Verena,Petrashkov,vpetrashkov5o@issuu.com,Help Desk Operator,4799,1991,6790
206,Kikelia,O'Neill,koneill5p@wsj.com,Data Coordiator,6136,943,7079
207,Hayward,Allon,hallon5q@dedecms.com,Account Representative I,1194,938,2132
208,Meier,Twelvetree,mtwelvetree5r@4shared.com,Engineer I,2553,1014,3567
209,Locke,Filyushkin,lfilyushkin5s@prweb.com,Assistant Manager,7568,905,8473
210,Norby,Wellstood,nwellstood5t@vistaprint.com,Administrative Assistant I,9782,1910,11692
211,Arthur,Muris,amuris5u@si.edu,GIS Technical Architect,4129,896,5025
212,Hurleigh,Killiner,hkilliner5v@utexas.edu,Software Engineer III,6797,553,7350
213,Shawn,McMearty,smcmearty5w@whitehouse.gov,Occupational Therapist,9233,826,10059
214,Bobette,Silverthorne,bsilverthorne5x@mapy.cz,VP Accounting,1625,601,2226
215,Jessika,Mowling,jmowling5y@eventbrite.com,Pharmacist,9494,1747,11241
216,Zsazsa,Renhard,zrenhard5z@purevolume.com,Nuclear Power Engineer,2831,686,3517
217,Kala,Hassey,khassey60@boston.com,Programmer IV,2722,1130,3852
218,Lanette,Goodbarne,lgoodbarne61@bigcartel.com,Automation Specialist II,6173,809,6982
219,Cosetta,Moen,cmoen62@ovh.net,Financial Advisor,6761,1617,8378
220,Adlai,Frears,afrears63@so-net.ne.jp,VP Product Management,7890,1976,9866
221,Robbert,Minet,rminet64@washington.edu,Staff Accountant IV,5274,880,6154
222,Lucienne,Robinet,lrobinet65@gmpg.org,Mechanical Systems Engineer,4308,626,4934
223,Lorrie,Bayman,lbayman66@nymag.com,VP Marketing,2172,1369,3541
224,Derk,Denkel,ddenkel67@blogspot.com,Recruiter,4060,567,4627
225,Rochelle,Magog,rmagog68@tuttocitta.it,Graphic Designer,5378,219,5597
226,Sullivan,Bischop,sbischop69@e-recht24.de,Cost Accountant,2974,300,3274
227,Avram,Bernardt,abernardt6a@businessinsider.com,Graphic Designer,8291,1470,9761
228,Edward,Alves,ealves6b@ebay.co.uk,Social Worker,8260,1164,9424
229,Berny,Ciobutaro,bciobutaro6c@indiatimes.com,Business Systems Development Analyst,1634,1231,2865
230,Verene,Betty,vbetty6d@bravesites.com,Analog Circuit Design manager,5256,289,5545
231,Jodie,Bidwell,jbidwell6e@ucsd.edu,Desktop Support Technician,9398,1708,11106
232,Stacie,Gregoletti,sgregoletti6f@cyberchimps.com,VP Quality Control,7954,1094,9048
233,Wynn,Satford,wsatford6g@imgur.com,Electrical Engineer,8530,995,9525
234,Buffy,Barlie,bbarlie6h@google.com,Financial Advisor,4505,449,4954
235,Morse,De Carlo,mdecarlo6i@whitehouse.gov,Compensation Analyst,3412,1823,5235
236,Sharon,Chawner,schawner6j@zdnet.com,Editor,3291,1545,4836
237,Osborne,Marin,omarin6k@cmu.edu,Research Assistant I,4630,1983,6613
238,Myrna,Still,mstill6l@is.gd,Environmental Specialist,4788,229,5017
239,Gregorio,Caffin,gcaffin6m@nifty.com,Product Engineer,8999,204,9203
240,Nadia,Barrowcliff,nbarrowcliff6n@huffingtonpost.com,General Manager,7099,311,7410
241,Rand,Kitchenman,rkitchenman6o@independent.co.uk,Financial Advisor,1913,1403,3316
242,Lucina,Parris,lparris6p@wordpress.com,Project Manager,7961,267,8228
243,Eldon,Assinder,eassinder6q@yale.edu,Clinical Specialist,8639,401,9040
244,Alva,Baroch,abaroch6r@elpais.com,Help Desk Operator,8757,1285,10042
245,Garfield,Germaine,ggermaine6s@csmonitor.com,Automation Specialist II,2493,1639,4132
246,Karlotta,Izzett,kizzett6t@google.co.uk,Structural Engineer,7290,1550,8840
247,Paulette,Yates,pyates6u@deviantart.com,Safety Technician II,4184,1376,5560
248,Pincas,French,pfrench6v@g.co,Web Designer II,8901,489,9390
249,Mahala,Tallyn,mtallyn6w@ow.ly,Nuclear Power Engineer,6762,1739,8501
250,Georgianna,Loveday,gloveday6x@japanpost.jp,Health Coach I,2982,1275,4257
251,Ula,McClaurie,umcclaurie6y@sohu.com,Payment Adjustment Coordinator,8458,351,8809
252,Noel,Gherardelli,ngherardelli6z@msu.edu,Quality Engineer,2493,1215,3708
253,Aldridge,MacNalley,amacnalley70@shop-pro.jp,Database Administrator III,2478,1191,3669
254,Melisande,Dashkov,mdashkov71@vimeo.com,Environmental Tech,3891,802,4693
255,Kathy,Bortoli,kbortoli72@hc360.com,Software Test Engineer IV,4193,1593,5786
256,Lilllie,Ditts,lditts73@intel.com,Cost Accountant,3634,653,4287
257,Willyt,Cundy,wcundy74@fotki.com,GIS Technical Architect,9904,1347,11251
258,Claresta,Clell,cclell75@1und1.de,Financial Advisor,4343,573,4916
259,Emmerich,Kermitt,ekermitt76@europa.eu,Senior Quality Engineer,7395,244,7639
260,Jennee,Marikhin,jmarikhin77@addtoany.com,Programmer Analyst III,5968,884,6852
261,Danya,Howsden,dhowsden78@ted.com,Financial Advisor,1940,1218,3158
262,Worth,Andreazzi,wandreazzi79@devhub.com,Cost Accountant,2646,362,3008
263,Jewelle,Saterweyte,jsaterweyte7a@cargocollective.com,Automation Specialist IV,2542,817,3359
264,Gibb,Burnup,gburnup7b@yellowbook.com,Desktop Support Technician,2244,1272,3516
265,Berti,Omand,bomand7c@ebay.co.uk,Recruiting Manager,8546,212,8758
266,Alaric,Von Der Empten,avonderempten7d@goo.gl,Environmental Specialist,3207,268,3475
267,Lyndell,Dalziell,ldalziell7e@friendfeed.com,Compensation Analyst,8562,1053,9615
268,Ola,Hammerberg,ohammerberg7f@domainmarket.com,Project Manager,9969,1453,11422
269,Lilyan,Garmey,lgarmey7g@altervista.org,Pharmacist,2607,1325,3932
270,Maurise,Humberstone,mhumberstone7h@epa.gov,Community Outreach Specialist,7228,266,7494
271,Brooks,Wallentin,bwallentin7i@upenn.edu,Legal Assistant,1316,1154,2470
272,Timofei,Hayhoe,thayhoe7j@chicagotribune.com,Web Developer II,4264,336,4600
273,Margarete,Connochie,mconnochie7k@about.com,Senior Sales Associate,4712,379,5091
274,Josefa,Scott,jscott7l@java.com,Analog Circuit Design manager,8532,598,9130
275,Steven,Curr,scurr7m@t-online.de,Administrative Assistant III,7782,1879,9661
276,Ephrayim,Bilovus,ebilovus7n@meetup.com,Teacher,2885,1396,4281
277,Wynn,Cicculini,wcicculini7o@aboutads.info,Project Manager,2989,596,3585
278,Mel,Kerby,mkerby7p@amazonaws.com,Developer II,7778,1769,9547
279,Julina,Mourant,jmourant7q@archive.org,Human Resources Assistant IV,8634,1724,10358
280,Juliette,Simonaitis,jsimonaitis7r@so-net.ne.jp,Statistician III,6027,909,6936
281,Ode,MacCosty,omaccosty7s@tmall.com,Business Systems Development Analyst,6985,1562,8547
282,Bat,Collinette,bcollinette7t@google.ca,Executive Secretary,3695,1662,5357
283,Berty,Nunnerley,bnunnerley7u@wix.com,Environmental Tech,7774,892,8666
284,Violette,Howell,vhowell7v@independent.co.uk,Associate Professor,8090,1766,9856
285,Tersina,Gjerde,tgjerde7w@ucla.edu,Office Assistant III,3674,758,4432
286,Edith,Garvagh,egarvagh7x@discuz.net,Structural Analysis Engineer,7125,651,7776
287,Earvin,Biscomb,ebiscomb7y@wufoo.com,Recruiter,8439,1266,9705
288,Dasi,Cremen,dcremen7z@discovery.com,Media Manager II,8843,1632,10475
289,Dallas,Brunel,dbrunel80@mlb.com,Marketing Assistant,1614,378,1992
290,Marillin,Iacomo,miacomo81@cdbaby.com,Pharmacist,9892,1099,10991
291,Bo,Chestney,bchestney82@virginia.edu,Chemical Engineer,7169,1848,9017
292,Erika,Beecker,ebeecker83@google.fr,Editor,3637,1097,4734
293,Amory,Weedon,aweedon84@springer.com,Environmental Tech,7337,1702,9039
294,Case,Morrall,cmorrall85@multiply.com,VP Accounting,6832,491,7323
295,Clari,O'Scollain,coscollain86@mashable.com,Desktop Support Technician,6806,1595,8401
296,Jacky,Snowden,jsnowden87@blogs.com,Research Assistant I,5656,1418,7074
297,Lavinie,Albion,lalbion88@reverbnation.com,VP Marketing,3361,1335,4696
298,Mala,Lutwidge,mlutwidge89@ehow.com,Office Assistant IV,6159,1837,7996
299,Kiley,Cockram,kcockram8a@phpbb.com,Tax Accountant,4120,825,4945
300,Thornton,Glenfield,tglenfield8b@mozilla.com,Senior Developer,6676,1047,7723
301,Meris,Fernanando,mfernanando8c@scientificamerican.com,Recruiting Manager,2413,1173,3586
302,Neill,Tomik,ntomik8d@indiatimes.com,Business Systems Development Analyst,5737,476,6213
303,Fenelia,Condy,fcondy8e@nydailynews.com,Accounting Assistant II,4935,1659,6594
304,Schuyler,oldey,soldey8f@google.fr,Nuclear Power Engineer,1800,1639,3439
305,Kylila,Threadgall,kthreadgall8g@dot.gov,Systems Administrator III,6516,512,7028
306,Alyss,Pering,apering8h@ycombinator.com,Environmental Specialist,6579,1758,8337
307,Cecile,Faireclough,cfaireclough8i@uiuc.edu,Senior Cost Accountant,4306,1688,5994
308,Taber,Capeloff,tcapeloff8j@angelfire.com,Sales Representative,2673,1379,4052
309,Nadeen,Arkcoll,narkcoll8k@typepad.com,Librarian,1638,1086,2724
310,Harald,Kahen,hkahen8l@imageshack.us,Accounting Assistant II,4425,801,5226
311,Tucker,Oselton,toselton8m@nature.com,Account Coordinator,2488,1252,3740
312,Dmitri,Cashman,dcashman8n@usda.gov,Desktop Support Technician,1709,1563,3272
313,Kimball,Clere,kclere8o@facebook.com,Accounting Assistant I,8976,844,9820
314,Kiley,Todeo,ktodeo8p@naver.com,Junior Executive,6847,1318,8165
315,Myrna,McAlester,mmcalester8q@princeton.edu,Legal Assistant,4730,1971,6701
316,Nicolina,Blackbrough,nblackbrough8r@themeforest.net,Payment Adjustment Coordinator,2064,267,2331
317,Worden,Wisedale,wwisedale8s@squidoo.com,Marketing Manager,7646,987,8633
318,Penny,Minichillo,pminichillo8t@bbc.co.uk,Chemical Engineer,5238,850,6088
319,Cullin,Guillet,cguillet8u@cmu.edu,Staff Accountant I,2416,1136,3552
320,Noel,Koch,nkoch8v@vk.com,VP Quality Control,6708,1009,7717
321,Chrotoem,Geraldo,cgeraldo8w@xing.com,Director of Sales,5379,383,5762
322,Darcie,Morfield,dmorfield8x@instagram.com,Human Resources Assistant I,6652,381,7033
323,Tamarra,Holborn,tholborn8y@rambler.ru,Actuary,6003,1098,7101
324,Rusty,Follos,rfollos8z@is.gd,Structural Engineer,5273,497,5770
325,Dorey,Halfhide,dhalfhide90@loc.gov,Clinical Specialist,5900,1571,7471
326,Hildagard,Lang,hlang91@oakley.com,Information Systems Manager,1511,1418,2929
327,Bendick,Boissier,bboissier92@guardian.co.uk,Senior Financial Analyst,2175,534,2709
328,Joletta,Hallstone,jhallstone93@wikipedia.org,GIS Technical Architect,8447,801,9248
329,Florian,Grasser,fgrasser94@clickbank.net,Pharmacist,1893,1513,3406
330,Paddie,Polleye,ppolleye95@cam.ac.uk,Human Resources Manager,8207,753,8960
331,Cyb,Legon,clegon96@bizjournals.com,Community Outreach Specialist,4728,1707,6435
332,Natasha,Utterson,nutterson97@reddit.com,Geologist I,5200,484,5684
333,Dre,Sibyllina,dsibyllina98@noaa.gov,VP Accounting,3842,1122,4964
334,Nata,Giacoboni,ngiacoboni99@list-manage.com,Office Assistant II,9823,777,10600
335,Effie,Denekamp,edenekamp9a@gnu.org,Business Systems Development Analyst,1237,908,2145
336,Ewan,Gronous,egronous9b@nbcnews.com,Registered Nurse,6548,1003,7551
337,Tessy,Greenrde,tgreenrde9c@lycos.com,Librarian,3222,915,4137
338,Siusan,Drescher,sdrescher9d@hhs.gov,Recruiting Manager,1075,1844,2919
339,Claudianus,Ibbott,cibbott9e@tuttocitta.it,Graphic Designer,6499,1917,8416
340,Lanie,Fernandez,lfernandez9f@amazon.co.uk,Help Desk Operator,9446,1480,10926
341,Rand,Neeves,rneeves9g@wsj.com,Account Coordinator,5255,880,6135
342,Morgana,Pendle,mpendle9h@berkeley.edu,Legal Assistant,9588,1446,11034
343,Bradley,Selwood,bselwood9i@hc360.com,Mechanical Systems Engineer,4514,1250,5764
344,Marina,Vallance,mvallance9j@earthlink.net,Geologist III,3732,1726,5458
345,Dorie,Ferrai,dferrai9k@eepurl.com,Media Manager III,1605,293,1898
346,Millie,Leeburne,mleeburne9l@npr.org,Computer Systems Analyst IV,5901,1425,7326
347,Reeba,Maclaine,rmaclaine9m@usa.gov,Pharmacist,4465,1528,5993
348,Dorisa,Gold,dgold9n@so-net.ne.jp,Database Administrator III,4052,238,4290
349,Delcine,Kiff,dkiff9o@apple.com,VP Sales,6856,1273,8129
350,Arabelle,Woolvin,awoolvin9p@psu.edu,Analog Circuit Design manager,3548,580,4128
351,Richart,Bothen,rbothen9q@fastcompany.com,Occupational Therapist,2298,275,2573
352,Annaliese,Cicchetto,acicchetto9r@hao123.com,Operator,1214,1733,2947
353,Effie,Colls,ecolls9s@shop-pro.jp,Structural Engineer,6416,763,7179
354,Bette-ann,Barnicott,bbarnicott9t@friendfeed.com,Marketing Manager,9342,791,10133
355,Jacquenette,Sheaber,jsheaber9u@newyorker.com,Professor,2788,1662,4450
356,Vanya,Scarsbrook,vscarsbrook9v@acquirethisname.com,Structural Engineer,5571,1637,7208
357,Marijn,Shaefer,mshaefer9w@google.ca,Geological Engineer,1641,1548,3189
358,Wayland,Tyreman,wtyreman9x@hibu.com,Assistant Professor,7958,1540,9498
359,Othilia,Coghill,ocoghill9y@netscape.com,Web Developer I,1823,1432,3255
360,Whitney,Mews,wmews9z@bloglovin.com,Mechanical Systems Engineer,7291,1726,9017
361,Artemis,Younger,ayoungera0@macromedia.com,VP Accounting,9588,632,10220
362,Eleanor,Darling,edarlinga1@craigslist.org,Research Assistant II,8426,1433,9859
363,Megen,Fleote,mfleotea2@yahoo.com,Electrical Engineer,7300,1451,8751
364,Jethro,Fishe,jfishea3@mlb.com,Actuary,3319,1059,4378
365,Franchot,Epinay,fepinaya4@ocn.ne.jp,Accountant IV,9542,559,10101
366,Eimile,Greenland,egreenlanda5@nifty.com,Product Engineer,3141,827,3968
367,Vinnie,Gravener,vgravenera6@google.es,Cost Accountant,4509,1899,6408
368,Hughie,Lipp,hlippa7@techcrunch.com,Product Engineer,8731,1797,10528
369,Kirbie,Qusklay,kqusklaya8@techcrunch.com,Developer II,5004,783,5787
370,Jaymie,Behnke,jbehnkea9@craigslist.org,Design Engineer,8668,531,9199
371,Riki,Boddy,rboddyaa@weather.com,Programmer III,5997,1757,7754
372,Dolli,Garlee,dgarleeab@dyndns.org,Tax Accountant,3182,694,3876
373,Tommi,Brouwer,tbrouwerac@pbs.org,Programmer Analyst IV,2411,760,3171
374,Isis,Gasken,igaskenad@wp.com,Senior Financial Analyst,5755,974,6729
375,Sadye,Robker,srobkerae@nifty.com,Editor,8339,896,9235
376,Meade,Reddihough,mreddihoughaf@bigcartel.com,Quality Control Specialist,9541,1344,10885
377,Kirsten,Pointing,kpointingag@army.mil,Director of Sales,1321,1673,2994
378,Kelbee,Bridges,kbridgesah@nationalgeographic.com,Compensation Analyst,8119,255,8374
379,Merci,Millership,mmillershipai@wufoo.com,Web Developer III,2947,1523,4470
380,Kylen,Sprake,ksprakeaj@ftc.gov,Structural Analysis Engineer,6490,1949,8439
381,Trev,Kembry,tkembryak@walmart.com,Computer Systems Analyst III,9632,502,10134
382,Lloyd,Twelve,ltwelveal@forbes.com,Executive Secretary,3123,1972,5095
383,Ardelia,Ecclesall,aecclesallam@vinaora.com,Business Systems Development Analyst,4913,1146,6059
384,Chrissy,Lickorish,clickorishan@va.gov,VP Quality Control,9235,793,10028
385,Nerty,Croci,ncrociao@senate.gov,Information Systems Manager,9556,1986,11542
386,Clarine,Haddington,chaddingtonap@pen.io,Director of Sales,8795,1843,10638
387,Costanza,Jowling,cjowlingaq@twitpic.com,Sales Representative,5279,733,6012
388,Raychel,Blakeborough,rblakeboroughar@issuu.com,Structural Engineer,3513,851,4364
389,Ursala,Tettersell,utettersellas@geocities.jp,Teacher,4622,237,4859
390,Kari,Renouf,krenoufat@omniture.com,Marketing Assistant,5317,1766,7083
391,Frannie,Enion,fenionau@tamu.edu,Account Representative I,5339,1882,7221
392,Janessa,Ridde,jriddeav@craigslist.org,Help Desk Operator,6038,472,6510
393,Frank,Auckland,faucklandaw@twitpic.com,Automation Specialist II,4457,365,4822
394,Ilyse,MacIntosh,imacintoshax@ft.com,Geological Engineer,2964,826,3790
395,Russell,Hayth,rhaythay@acquirethisname.com,Geological Engineer,5994,1171,7165
396,Ranice,Symms,rsymmsaz@ftc.gov,Graphic Designer,4108,1211,5319
397,Torrie,Maplestone,tmaplestoneb0@businessweek.com,Civil Engineer,7268,555,7823
398,Howie,Broadis,hbroadisb1@infoseek.co.jp,Structural Analysis Engineer,8839,1929,10768
399,Kala,Kintzel,kkintzelb2@sohu.com,Database Administrator II,9257,303,9560
400,Koralle,Skocroft,kskocroftb3@ted.com,Web Designer I,8868,1073,9941
401,Amalea,Staniford,astanifordb4@geocities.jp,Safety Technician II,1696,1411,3107
402,Gardner,Wilson,gwilsonb5@ning.com,Design Engineer,4032,1949,5981
403,Gladi,Kirlin,gkirlinb6@mayoclinic.com,Help Desk Technician,8672,1358,10030
404,Romonda,Jakuszewski,rjakuszewskib7@surveymonkey.com,Accounting Assistant II,4112,1676,5788
405,Remus,Morriarty,rmorriartyb8@java.com,Developer IV,2948,1151,4099
406,Borg,Basilotta,bbasilottab9@networksolutions.com,Dental Hygienist,5984,742,6726
407,Cletis,Yarnton,cyarntonba@skype.com,Compensation Analyst,7316,1504,8820
408,Trixie,Beagin,tbeaginbb@nasa.gov,Senior Sales Associate,8020,1574,9594
409,Dacie,Coutts,dcouttsbc@icq.com,Recruiting Manager,2096,1018,3114
410,Robina,Spinola,rspinolabd@icio.us,Budget/Accounting Analyst I,5300,1151,6451
411,Fernando,Challin,fchallinbe@360.cn,Human Resources Manager,9380,1202,10582
412,Nan,Sheals,nshealsbf@livejournal.com,Operator,9952,1718,11670
413,Melisse,Lattka,mlattkabg@sina.com.cn,Mechanical Systems Engineer,3670,786,4456
414,Tiffani,Billingham,tbillinghambh@ezinearticles.com,Staff Scientist,2071,244,2315
415,Wendall,Ollin,wollinbi@craigslist.org,Legal Assistant,3585,1175,4760
416,Miriam,Trickett,mtrickettbj@nytimes.com,Web Designer I,7300,1399,8699
417,Miner,Michallat,mmichallatbk@sun.com,Cost Accountant,4875,320,5195
418,Orly,Leverton,olevertonbl@sciencedaily.com,Senior Sales Associate,1791,782,2573
419,Tawnya,Meacher,tmeacherbm@devhub.com,Administrative Officer,5627,416,6043
420,Jerrold,Vizor,jvizorbn@comcast.net,VP Quality Control,4627,962,5589
421,Rosita,Tousey,rtouseybo@dot.gov,Social Worker,3232,750,3982
422,Arel,Elstow,aelstowbp@apple.com,VP Quality Control,4823,283,5106
423,Lucienne,McKinless,lmckinlessbq@bbb.org,Cost Accountant,5527,706,6233
424,Swen,Fliege,sfliegebr@sciencedaily.com,Staff Accountant II,4407,732,5139
425,Caspar,Hayles,chaylesbs@cnet.com,Engineer III,6664,1562,8226
426,Darda,Larcher,dlarcherbt@fc2.com,Web Designer II,5282,650,5932
427,Sonnie,Lindwasser,slindwasserbu@gov.uk,Desktop Support Technician,5418,771,6189
428,Mamie,Petrulis,mpetrulisbv@nationalgeographic.com,Structural Engineer,4734,305,5039
429,Harland,Tuvey,htuveybw@house.gov,Safety Technician III,9227,749,9976
430,Mohammed,Matschke,mmatschkebx@about.com,Budget/Accounting Analyst III,7387,918,8305
431,Dee dee,Fochs,dfochsby@sphinn.com,VP Product Management,8936,819,9755
432,Ringo,Akester,rakesterbz@buzzfeed.com,Research Assistant II,6467,363,6830
433,Georgia,Niesing,gniesingc0@about.me,Tax Accountant,1009,959,1968
434,Margot,McCluney,mmccluneyc1@mysql.com,VP Accounting,8293,724,9017
435,Der,Simonds,dsimondsc2@businessweek.com,Teacher,9560,378,9938
436,Madelin,Brereton,mbreretonc3@gravatar.com,Accounting Assistant I,4618,1261,5879
437,Wylma,Anwyl,wanwylc4@hugedomains.com,Social Worker,7972,1664,9636
438,Christiana,Broseman,cbrosemanc5@wix.com,Analog Circuit Design manager,1667,1701,3368
439,Farand,Greenstreet,fgreenstreetc6@nsw.gov.au,Associate Professor,1233,1795,3028
440,Arleyne,Biernacki,abiernackic7@geocities.com,Health Coach I,1699,1873,3572
441,Renard,Morde,rmordec8@intel.com,Web Designer III,4495,682,5177
442,Mariele,Causby,mcausbyc9@utexas.edu,Data Coordiator,8526,601,9127
443,Dare,Corey,dcoreyca@typepad.com,Computer Systems Analyst I,7508,987,8495
444,Levey,Rotham,lrothamcb@bloglines.com,Dental Hygienist,6174,1911,8085
445,Wallas,Tregenna,wtregennacc@meetup.com,Engineer II,4931,1246,6177
446,Abram,Jone,ajonecd@bloglovin.com,Senior Developer,7893,1329,9222
447,Fleming,Cuzen,fcuzence@tuttocitta.it,Account Coordinator,9451,405,9856
448,Townie,Diggar,tdiggarcf@zimbio.com,Project Manager,5915,1017,6932
449,Bernelle,Lacky,blackycg@admin.ch,Accounting Assistant II,7601,574,8175
450,Lindsay,Godwin,lgodwinch@amazon.de,Clinical Specialist,4316,776,5092
451,Gay,Culwen,gculwenci@latimes.com,Data Coordiator,9601,1803,11404
452,Cathi,Leeburn,cleeburncj@hubpages.com,Teacher,6194,528,6722
453,Ameline,Woodrooffe,awoodrooffeck@skype.com,Accounting Assistant I,1318,359,1677
454,Saunderson,Wile,swilecl@nifty.com,Clinical Specialist,1775,643,2418
455,Adria,Attaway,aattawaycm@psu.edu,Design Engineer,3598,676,4274
456,Byrann,Barck,bbarckcn@networksolutions.com,Dental Hygienist,6722,1114,7836
457,Dita,Barwis,dbarwisco@mysql.com,Human Resources Assistant III,2623,451,3074
458,Phillipe,Roddie,proddiecp@shutterfly.com,Help Desk Technician,7292,316,7608
459,Jorrie,Pelzer,jpelzercq@bandcamp.com,Senior Quality Engineer,6336,296,6632
460,Rosalia,Paty,rpatycr@netvibes.com,Account Representative I,7188,649,7837
461,Frankie,Rance,francecs@google.com,Payment Adjustment Coordinator,1237,1554,2791
462,Alvinia,Houston,ahoustonct@theglobeandmail.com,Accountant II,2002,273,2275
463,Rinaldo,Bredbury,rbredburycu@icio.us,Web Developer IV,6698,870,7568
464,Eugenius,Dunridge,edunridgecv@rakuten.co.jp,Junior Executive,3287,752,4039
465,Ethelred,Devote,edevotecw@mail.ru,Senior Sales Associate,9189,1653,10842
466,Cathleen,Millam,cmillamcx@ted.com,Marketing Assistant,3482,1291,4773
467,Jaynell,Matovic,jmatoviccy@scribd.com,Sales Associate,3970,304,4274
468,Way,Perschke,wperschkecz@google.cn,Help Desk Operator,6824,1448,8272
469,Reggy,Morrieson,rmorriesond0@hubpages.com,Financial Analyst,3115,1635,4750
470,Tamra,Margerrison,tmargerrisond1@ezinearticles.com,Research Nurse,5033,545,5578
471,Tate,Josefer,tjoseferd2@shinystat.com,Programmer Analyst I,4801,1119,5920
472,Anestassia,Dalzell,adalzelld3@tuttocitta.it,Speech Pathologist,3791,1997,5788
473,Gwennie,Austin,gaustind4@alibaba.com,Environmental Tech,9850,1960,11810
474,Jillane,Frangello,jfrangellod5@tiny.cc,Geologist I,4238,1755,5993
475,Jewell,Yanin,jyanind6@java.com,Librarian,4313,1815,6128
476,Kimmi,MacAlpyne,kmacalpyned7@earthlink.net,Legal Assistant,2627,784,3411
477,Kalinda,Giovanitti,kgiovanittid8@cnbc.com,Administrative Officer,8328,394,8722
478,Darya,Braunes,dbraunesd9@shareasale.com,VP Marketing,1200,454,1654
479,Kelcie,Kingerby,kkingerbyda@free.fr,Paralegal,6117,794,6911
480,Constanta,Stanes,cstanesdb@auda.org.au,Information Systems Manager,9286,1634,10920
481,Anna-diane,Cleynaert,acleynaertdc@ed.gov,Analyst Programmer,3687,673,4360
482,Myrtia,Hale,mhaledd@flickr.com,Senior Editor,3290,1123,4413
483,Marillin,Kestle,mkestlede@webnode.com,Systems Administrator I,2473,573,3046
484,Daffy,Bassom,dbassomdf@wordpress.com,Environmental Tech,1833,1300,3133
485,Karalynn,Kenworth,kkenworthdg@pcworld.com,Information Systems Manager,1574,1758,3332
486,Marwin,Rosenwald,mrosenwalddh@qq.com,Actuary,5834,984,6818
487,Myrtia,Freddi,mfreddidi@sciencedaily.com,Recruiting Manager,6795,556,7351
488,Brand,Canete,bcanetedj@ftc.gov,Recruiting Manager,7462,1772,9234
489,Dolores,Winstone,dwinstonedk@friendfeed.com,Paralegal,9270,273,9543
490,Dorothea,Samsonsen,dsamsonsendl@npr.org,Technical Writer,2432,691,3123
491,Moreen,Kitchingman,mkitchingmandm@deliciousdays.com,Account Representative II,2172,313,2485
492,Vinny,Stiegars,vstiegarsdn@storify.com,Developer IV,4152,251,4403
493,Mariette,Mompesson,mmompessondo@meetup.com,Structural Engineer,1046,1346,2392
494,Alexandros,Tabor,atabordp@wikipedia.org,Media Manager IV,1000,1775,2775
495,Raimundo,Sauven,rsauvendq@omniture.com,Database Administrator I,7926,1351,9277
496,Adolphe,Whatsize,awhatsizedr@desdev.cn,Systems Administrator II,1130,536,1666
497,Elspeth,Lindemann,elindemannds@nasa.gov,Financial Analyst,4991,1861,6852
498,Bernie,Murt,bmurtdt@wordpress.com,Internal Auditor,1411,865,2276
499,Gonzalo,Loudyan,gloudyandu@telegraph.co.uk,Quality Control Specialist,4408,460,4868
500,Eben,Tuerena,etuerenadv@google.de,Design Engineer,8332,678,9010
501,Evelina,Kullmann,ekullmanndw@salon.com,Clinical Specialist,3817,960,4777
502,Sherill,Ralph,sralphdx@yelp.com,Programmer IV,6639,1648,8287
503,Amory,Ilyenko,ailyenkody@altervista.org,Human Resources Manager,5592,204,5796
504,Shaun,Linacre,slinacredz@dion.ne.jp,Editor,7944,536,8480
505,Den,Kissock,dkissocke0@omniture.com,Legal Assistant,2434,1449,3883
506,Lyssa,Seiler,lseilere1@indiatimes.com,Safety Technician III,1922,1456,3378
507,Wylie,Allbon,wallbone2@xinhuanet.com,VP Accounting,4075,1006,5081
508,Falkner,Arndell,farndelle3@yelp.com,Nuclear Power Engineer,6055,1415,7470
509,Loralyn,Latehouse,llatehousee4@a8.net,Community Outreach Specialist,8755,540,9295
510,Hube,Bellamy,hbellamye5@vk.com,Sales Representative,6948,1801,8749
511,Venus,Burdus,vburduse6@theguardian.com,Data Coordiator,1489,969,2458
512,Amberly,Fessler,afesslere7@fastcompany.com,Research Assistant I,2029,369,2398
513,Kinnie,Kenion,kkenione8@vkontakte.ru,Environmental Tech,2186,523,2709
514,Lindie,Skeemor,lskeemore9@w3.org,Quality Control Specialist,1934,709,2643
515,Sabrina,Keasey,skeaseyea@soundcloud.com,Electrical Engineer,4436,980,5416
516,Penelope,Horsfield,phorsfieldeb@meetup.com,Associate Professor,5543,436,5979
517,Cleavland,Palek,cpalekec@wikispaces.com,Nurse,9569,1254,10823
518,Sebastian,Lambie,slambieed@businessinsider.com,Internal Auditor,1232,708,1940
519,Brynn,Dunnet,bdunnetee@plala.or.jp,Senior Sales Associate,8737,1629,10366
520,Emmott,Schruyer,eschruyeref@wordpress.com,Internal Auditor,1006,1734,2740
521,Ardra,Feragh,aferagheg@smh.com.au,Recruiting Manager,9211,1176,10387
522,Maribel,Klesl,mklesleh@purevolume.com,Internal Auditor,7026,1340,8366
523,Tabbie,Stanway,tstanwayei@pcworld.com,Physical Therapy Assistant,4479,947,5426
524,Tessa,Degg,tdeggej@360.cn,VP Quality Control,6959,1934,8893
525,Abigale,Lautie,alautieek@harvard.edu,Compensation Analyst,9469,715,10184
526,Sarajane,Christmas,schristmasel@dagondesign.com,Senior Quality Engineer,4100,267,4367
527,Flint,Norridge,fnorridgeem@hatena.ne.jp,Actuary,4068,971,5039
528,Jose,Jorg,jjorgen@nhs.uk,Programmer III,9200,1059,10259
529,Lynna,Lowings,llowingseo@usatoday.com,Senior Sales Associate,9574,624,10198
530,Mufi,Zukerman,mzukermanep@samsung.com,Software Test Engineer III,3397,1151,4548
531,Nickolaus,Siley,nsileyeq@comsenz.com,Marketing Assistant,4269,1565,5834
532,Ferd,Logan,floganer@shinystat.com,Geological Engineer,6301,1411,7712
533,Charisse,Verrell,cverrelles@ftc.gov,Software Consultant,9987,879,10866
534,Christen,Farthing,cfarthinget@weebly.com,Structural Engineer,1131,1947,3078
535,Kathryn,Magarrell,kmagarrelleu@house.gov,Biostatistician III,9734,1370,11104
536,Willi,Shelbourne,wshelbourneev@twitter.com,VP Product Management,7695,1137,8832
537,Sashenka,Chattoe,schattoeew@merriam-webster.com,Internal Auditor,1061,1797,2858
538,Sybila,Milland,smillandex@prlog.org,Geological Engineer,5779,1553,7332
539,Melisent,Tiptaft,mtiptaftey@alibaba.com,Pharmacist,3123,620,3743
540,Sly,Busher,sbusherez@miibeian.gov.cn,Budget/Accounting Analyst IV,8113,1369,9482
541,Doria,Baszkiewicz,dbaszkiewiczf0@blog.com,Business Systems Development Analyst,4289,1272,5561
542,Frederik,Renshaw,frenshawf1@bandcamp.com,Analog Circuit Design manager,3212,1000,4212
543,Benji,Barwise,bbarwisef2@accuweather.com,Nurse,3659,1499,5158
544,Ninette,Quodling,nquodlingf3@woothemes.com,GIS Technical Architect,2184,1246,3430
545,Ophelie,Liddyard,oliddyardf4@nature.com,Developer III,2583,314,2897
546,Martin,Everly,meverlyf5@nydailynews.com,Teacher,5743,1269,7012
547,Nevile,Whylie,nwhylief6@washington.edu,Social Worker,3157,266,3423
548,Eadie,Goulborne,egoulbornef7@php.net,Technical Writer,1127,596,1723
549,Tremayne,Breede,tbreedef8@china.com.cn,Actuary,4956,212,5168
550,Ibbie,Agutter,iagutterf9@cmu.edu,Assistant Manager,1599,1529,3128
551,Leandra,Dobbie,ldobbiefa@naver.com,Account Coordinator,6029,805,6834
552,Morganica,Ely,melyfb@gizmodo.com,Junior Executive,4176,1328,5504
553,Dodie,Trevino,dtrevinofc@sbwire.com,VP Sales,3452,1440,4892
554,Colan,Molnar,cmolnarfd@craigslist.org,Staff Accountant I,4392,1686,6078
555,Torry,Munnings,tmunningsfe@hatena.ne.jp,Accounting Assistant IV,6433,1834,8267
556,Ilse,Obray,iobrayff@google.com.au,Automation Specialist I,8753,1122,9875
557,Alyce,Battye,abattyefg@cam.ac.uk,Social Worker,5392,256,5648
558,Dahlia,Hannaby,dhannabyfh@baidu.com,Structural Analysis Engineer,9444,1248,10692
559,Mozes,Pfleger,mpflegerfi@flickr.com,Design Engineer,5925,1233,7158
560,Engracia,Phelp,ephelpfj@so-net.ne.jp,Analog Circuit Design manager,6980,273,7253
561,Faythe,Alberts,falbertsfk@ustream.tv,Information Systems Manager,6481,1948,8429
562,Elnore,Neild,eneildfl@netvibes.com,Programmer III,2271,1297,3568
563,Vince,Reynalds,vreynaldsfm@apple.com,Internal Auditor,5202,1280,6482
564,Mariquilla,Mallock,mmallockfn@wsj.com,Payment Adjustment Coordinator,3005,831,3836
565,Fitz,Ortmann,fortmannfo@narod.ru,Media Manager IV,3455,476,3931
566,Armin,Vondrys,avondrysfp@sciencedirect.com,Office Assistant III,9659,1273,10932
567,Fons,Peachman,fpeachmanfq@samsung.com,Payment Adjustment Coordinator,5305,859,6164
568,Bronson,Schankelborg,bschankelborgfr@imgur.com,Database Administrator II,6587,1476,8063
569,Cora,De Roberto,cderobertofs@qq.com,Developer II,4959,823,5782
570,Pascale,Sloper,psloperft@behance.net,Sales Representative,7804,1579,9383
571,Cynde,Skewis,cskewisfu@ovh.net,Recruiting Manager,6067,1858,7925
572,Bobbye,Jakes,bjakesfv@mozilla.org,Actuary,2691,449,3140
573,Kyle,Klinck,kklinckfw@ezinearticles.com,Teacher,8795,1166,9961
574,Dante,Halm,dhalmfx@sohu.com,Pharmacist,5055,1993,7048
575,Derek,Jesty,djestyfy@scientificamerican.com,VP Quality Control,8648,465,9113
576,Berkie,Thomen,bthomenfz@privacy.gov.au,Speech Pathologist,6726,576,7302
577,Viviyan,Elliot,velliotg0@imdb.com,Nurse Practicioner,9777,731,10508
578,Tally,Leroy,tleroyg1@discuz.net,Account Executive,1971,1974,3945
579,Gregory,Fawdrey,gfawdreyg2@bluehost.com,Registered Nurse,3699,818,4517
580,Papagena,Aris,parisg3@blogs.com,Assistant Manager,9735,230,9965
581,Netty,Yandell,nyandellg4@skype.com,Product Engineer,3810,548,4358
582,Lane,Mendoza,lmendozag5@slate.com,Occupational Therapist,7354,1408,8762
583,Gabriellia,Normandale,gnormandaleg6@about.com,Business Systems Development Analyst,4081,1817,5898
584,Eydie,Ruddiman,eruddimang7@icio.us,Legal Assistant,5060,1224,6284
585,Ragnar,Rasor,rrasorg8@elegantthemes.com,Human Resources Manager,7418,1356,8774
586,Antonie,Dorbin,adorbing9@bloglovin.com,Executive Secretary,7818,1799,9617
587,Wilden,De Morena,wdemorenaga@ifeng.com,Senior Editor,8108,1036,9144
588,Dore,Wolfer,dwolfergb@google.it,Structural Engineer,1749,406,2155
589,Horten,Broomhead,hbroomheadgc@noaa.gov,Electrical Engineer,2662,1510,4172
590,Carlina,Sutch,csutchgd@w3.org,Analog Circuit Design manager,9086,447,9533
591,Venita,Giddy,vgiddyge@yellowpages.com,Analyst Programmer,3534,1943,5477
592,Barron,Harse,bharsegf@who.int,VP Marketing,7460,1954,9414
593,Annice,Karpfen,akarpfengg@blogtalkradio.com,Geologist IV,5311,547,5858
594,Jerry,Breinl,jbreinlgh@nationalgeographic.com,Teacher,7052,1340,8392
595,Wylie,Snoxell,wsnoxellgi@last.fm,Nurse Practicioner,8700,594,9294
596,Baillie,Keary,bkearygj@com.com,Civil Engineer,1590,1377,2967
597,Priscilla,Gilderoy,pgilderoygk@usa.gov,Research Nurse,4726,591,5317
598,Emmanuel,Legerton,elegertongl@lulu.com,Web Designer III,1142,387,1529
599,Collette,Borge,cborgegm@nps.gov,Research Nurse,3519,1828,5347
600,Datha,Reah,dreahgn@wix.com,Marketing Assistant,4551,1195,5746
601,Cheri,Crossman,ccrossmango@nps.gov,Staff Scientist,6994,866,7860
602,Mile,Meller,mmellergp@harvard.edu,Human Resources Manager,7805,335,8140
603,Christalle,Fritz,cfritzgq@un.org,Food Chemist,2083,632,2715
604,Emiline,Mulroy,emulroygr@vk.com,Staff Scientist,8253,1540,9793
605,Robinson,Kinney,rkinneygs@deviantart.com,Budget/Accounting Analyst IV,5546,1605,7151
606,Eldridge,Hasloch,ehaslochgt@goo.ne.jp,Professor,6106,414,6520
607,Pierce,Gidman,pgidmangu@i2i.jp,Physical Therapy Assistant,3577,234,3811
608,Daile,Yakov,dyakovgv@microsoft.com,Speech Pathologist,3372,882,4254
609,Dillon,Grindell,dgrindellgw@cdc.gov,Developer II,2831,375,3206
610,Ahmed,Hallybone,ahallybonegx@simplemachines.org,Operator,2919,1997,4916
611,Laurene,Cultcheth,lcultchethgy@acquirethisname.com,Computer Systems Analyst II,6983,1572,8555
612,Kissee,Heintz,kheintzgz@blogtalkradio.com,VP Quality Control,1881,918,2799
613,Tamara,Ainscough,tainscoughh0@slideshare.net,Assistant Manager,8010,734,8744
614,Spenser,Defau,sdefauh1@360.cn,Budget/Accounting Analyst IV,1884,1277,3161
615,Laureen,Maddaford,lmaddafordh2@biblegateway.com,Senior Editor,6681,549,7230
616,Filippo,Filliskirk,ffilliskirkh3@edublogs.org,Staff Scientist,5352,1454,6806
617,Rossy,Dunston,rdunstonh4@sphinn.com,Recruiter,7309,909,8218
618,Frederik,De Morena,fdemorenah5@seesaa.net,Programmer II,3187,631,3818
619,Collin,Sultana,csultanah6@godaddy.com,Senior Editor,6995,1916,8911
620,Coralie,Fairpool,cfairpoolh7@surveymonkey.com,Web Developer I,2166,919,3085
621,Alix,Cribbins,acribbinsh8@pbs.org,Occupational Therapist,5117,430,5547
622,Ariadne,Pesak,apesakh9@php.net,Senior Developer,6587,389,6976
623,Montgomery,Staddom,mstaddomha@moonfruit.com,Desktop Support Technician,6420,1943,8363
624,Xaviera,Dallmann,xdallmannhb@cbslocal.com,Cost Accountant,4493,1740,6233
625,Marion,Diter,mditerhc@exblog.jp,General Manager,4758,1793,6551
626,Manya,Lathaye,mlathayehd@bandcamp.com,Business Systems Development Analyst,7478,830,8308
627,Geneva,Gypps,ggyppshe@php.net,Project Manager,2952,1361,4313
628,Charlot,Reichert,creicherthf@reuters.com,Design Engineer,1792,622,2414
629,Waylon,Borzone,wborzonehg@amazon.co.jp,Teacher,3553,1506,5059
630,Alene,Butchart,abutcharthh@icio.us,Programmer IV,1240,1710,2950
631,Aylmer,Boakes,aboakeshi@epa.gov,Director of Sales,8485,1789,10274
632,Basil,Haslum,bhaslumhj@odnoklassniki.ru,Automation Specialist I,1555,1801,3356
633,Kennan,Acomb,kacombhk@wikia.com,Analyst Programmer,6539,523,7062
634,Rochette,Tillett,rtilletthl@sourceforge.net,Geologist II,2982,458,3440
635,Arte,Petricek,apetricekhm@livejournal.com,Senior Editor,7041,352,7393
636,Latrena,Voden,lvodenhn@mayoclinic.com,Staff Accountant I,2744,1947,4691
637,Selinda,Chung,schungho@scribd.com,Librarian,6499,1834,8333
638,Tiphanie,Madgwich,tmadgwichhp@quantcast.com,Quality Control Specialist,1352,1510,2862
639,Antony,Hendrich,ahendrichhq@facebook.com,Budget/Accounting Analyst III,8561,990,9551
640,Fenelia,Pickston,fpickstonhr@google.com.au,Media Manager III,2974,1642,4616
641,Adrian,Toller,atollerhs@guardian.co.uk,Structural Analysis Engineer,9595,1774,11369
642,Ilene,Goutcher,igoutcherht@bing.com,Marketing Assistant,2407,474,2881
643,Scot,Carver,scarverhu@prweb.com,Budget/Accounting Analyst I,9201,477,9678
644,Margot,Osboldstone,mosboldstonehv@amazon.co.jp,Executive Secretary,8527,1253,9780
645,Henry,Serle,hserlehw@slashdot.org,Professor,5933,855,6788
646,Cara,Benjefield,cbenjefieldhx@yelp.com,Senior Editor,4121,293,4414
647,Tim,Delagnes,tdelagneshy@freewebs.com,Senior Financial Analyst,1999,1069,3068
648,Nahum,Dibdale,ndibdalehz@cam.ac.uk,Chemical Engineer,3111,1883,4994
649,Rachelle,Sandifer,rsandiferi0@wikispaces.com,VP Product Management,7259,1780,9039
650,Berrie,Dowtry,bdowtryi1@go.com,Systems Administrator I,4745,1181,5926
651,Mile,Gatsby,mgatsbyi2@forbes.com,Health Coach III,5050,1488,6538
652,Alphonso,Bootes,abootesi3@baidu.com,Electrical Engineer,8452,395,8847
653,Cobbie,Porcas,cporcasi4@myspace.com,Geologist IV,4863,1718,6581
654,Stefan,Biggar,sbiggari5@sciencedaily.com,Paralegal,9852,1193,11045
655,Jolyn,Noble,jnoblei6@jiathis.com,Sales Representative,3074,1484,4558
656,Ivor,Slixby,islixbyi7@barnesandnoble.com,Data Coordiator,5678,772,6450
657,Falito,Taggart,ftaggarti8@apple.com,Help Desk Operator,9592,264,9856
658,Gregory,Virr,gvirri9@boston.com,Data Coordiator,6152,819,6971
659,Daron,Balentyne,dbalentyneia@mlb.com,Staff Scientist,2394,840,3234
660,Wendel,Dood,wdoodib@google.fr,Assistant Professor,6390,922,7312
661,Jemmy,Balchen,jbalchenic@walmart.com,Account Executive,2753,1695,4448
662,Udall,Stert,ustertid@tuttocitta.it,Account Executive,4135,698,4833
663,Sibeal,Haacker,shaackerie@networksolutions.com,Project Manager,7164,573,7737
664,Leigh,Hearfield,lhearfieldif@ycombinator.com,Health Coach III,4073,1122,5195
665,Gerri,Culpen,gculpenig@ovh.net,Assistant Manager,1457,453,1910
666,Catharine,Pemberton,cpembertonih@tumblr.com,Developer I,7801,1958,9759
667,Toma,Tinkham,ttinkhamii@apache.org,Registered Nurse,6361,1758,8119
668,Talbert,Gratrex,tgratrexij@eventbrite.com,Nurse,8058,868,8926
669,Ashly,Bancroft,abancroftik@webeden.co.uk,Internal Auditor,9682,933,10615
670,Merell,Epton,meptonil@yahoo.com,Cost Accountant,3782,1888,5670
671,Bone,Soame,bsoameim@reuters.com,VP Sales,3926,589,4515
672,Erik,Hug,ehugin@clickbank.net,Geological Engineer,1746,335,2081
673,Olly,Strond,ostrondio@berkeley.edu,Structural Engineer,4166,1043,5209
674,Homerus,Merriott,hmerriottip@discuz.net,VP Marketing,6821,237,7058
675,Letty,Seine,lseineiq@unc.edu,Software Engineer I,7335,369,7704
676,Brenden,Priddy,bpriddyir@flavors.me,Software Engineer III,5824,1302,7126
677,Aguie,Konerding,akonerdingis@npr.org,Cost Accountant,2006,1804,3810
678,Miltie,Ivashkin,mivashkinit@zdnet.com,Biostatistician III,7560,807,8367
679,Peterus,Townsley,ptownsleyiu@devhub.com,Pharmacist,5543,1801,7344
680,Onofredo,Pavolillo,opavolilloiv@techcrunch.com,Associate Professor,6100,666,6766
681,Cary,Sallinger,csallingeriw@mac.com,Human Resources Manager,9095,1420,10515
682,Aundrea,Stapford,astapfordix@microsoft.com,Desktop Support Technician,8433,961,9394
683,Sheba,Sutor,ssutoriy@i2i.jp,VP Accounting,4799,1206,6005
684,Wynny,Hamments,whammentsiz@yale.edu,Associate Professor,5124,362,5486
685,Kippy,Matson,kmatsonj0@arstechnica.com,VP Accounting,8600,1602,10202
686,Arabela,Brettle,abrettlej1@studiopress.com,Programmer Analyst I,1772,838,2610
687,Dannie,Denholm,ddenholmj2@economist.com,Research Assistant II,4815,551,5366
688,Ive,Castrillo,icastrilloj3@twitter.com,Cost Accountant,3347,530,3877
689,Pepi,Tingly,ptinglyj4@ebay.com,Web Designer I,2851,1011,3862
690,Auroora,Bohden,abohdenj5@ovh.net,Registered Nurse,9019,1090,10109
691,Wrennie,Thor,wthorj6@jugem.jp,Assistant Professor,2963,982,3945
692,Jarred,Blant,jblantj7@uiuc.edu,Speech Pathologist,1829,1014,2843
693,Blondell,Tebbs,btebbsj8@indiatimes.com,Occupational Therapist,4796,597,5393
694,Berni,McGuinness,bmcguinnessj9@printfriendly.com,Account Representative IV,1445,393,1838
695,Brandy,Roblou,broblouja@sitemeter.com,Database Administrator IV,7540,945,8485
696,Nanny,Brownett,nbrownettjb@ox.ac.uk,VP Product Management,3247,1674,4921
697,Lucius,Tuffey,ltuffeyjc@miibeian.gov.cn,Systems Administrator II,1069,1760,2829
698,Antonius,De Moreno,ademorenojd@weibo.com,Senior Quality Engineer,5609,783,6392
699,Andi,Savin,asavinje@ucoz.ru,Civil Engineer,5015,939,5954
700,Euell,Dimmock,edimmockjf@dagondesign.com,Desktop Support Technician,1665,745,2410
701,Basilius,Janatka,bjanatkajg@google.pl,Dental Hygienist,6245,1863,8108
702,Carlye,Ortet,cortetjh@stumbleupon.com,Administrative Officer,3315,1275,4590
703,Mari,Chessel,mchesselji@cnbc.com,Geological Engineer,8057,1171,9228
704,Devora,Palleske,dpalleskejj@zdnet.com,Marketing Manager,9574,1334,10908
705,Reine,Coleshill,rcoleshilljk@jimdo.com,Desktop Support Technician,6918,402,7320
706,Brice,Smallthwaite,bsmallthwaitejl@deviantart.com,Internal Auditor,6313,1469,7782
707,Rudie,Pavia,rpaviajm@nationalgeographic.com,Administrative Officer,1510,1289,2799
708,Aloysius,Panting,apantingjn@unesco.org,Accountant II,4465,644,5109
709,Hamid,Featherstonhaugh,hfeatherstonhaughjo@fastcompany.com,Account Coordinator,1904,327,2231
710,Sheena,Senechell,ssenechelljp@sakura.ne.jp,Senior Cost Accountant,9786,1802,11588
711,Farrand,Sharpous,fsharpousjq@qq.com,Mechanical Systems Engineer,9312,1620,10932
712,Archy,Baudinelli,abaudinellijr@yale.edu,Help Desk Operator,4449,1242,5691
713,Homerus,Standering,hstanderingjs@cdbaby.com,Software Consultant,4170,556,4726
714,Mickie,Joe,mjoejt@hubpages.com,Chemical Engineer,2549,1449,3998
715,Penny,Gouinlock,pgouinlockju@blogs.com,Geological Engineer,3283,775,4058
716,Ingamar,McElory,imceloryjv@hatena.ne.jp,Nurse,7907,1062,8969
717,Stu,Huc,shucjw@dedecms.com,Information Systems Manager,4335,1264,5599
718,Crista,Kern,ckernjx@dailymail.co.uk,Administrative Assistant I,1744,1883,3627
719,Paquito,Skrzynski,pskrzynskijy@uol.com.br,Account Representative I,1578,1658,3236
720,Waylin,Otridge,wotridgejz@patch.com,Human Resources Manager,3423,1786,5209
721,Romona,Philipps,rphilippsk0@rediff.com,Environmental Specialist,7313,256,7569
722,Adel,Keable,akeablek1@ebay.com,Social Worker,6673,1531,8204
723,Marwin,Coatsworth,mcoatsworthk2@census.gov,Legal Assistant,2094,634,2728
724,Ivor,Buckell,ibuckellk3@yandex.ru,Help Desk Operator,8072,1950,10022
725,Babara,Saddington,bsaddingtonk4@jimdo.com,Social Worker,4812,1173,5985
726,Oneida,Gillicuddy,ogillicuddyk5@globo.com,Information Systems Manager,1797,319,2116
727,Corrine,Byer,cbyerk6@springer.com,Budget/Accounting Analyst I,7209,896,8105
728,Nadiya,Hathorn,nhathornk7@comcast.net,Marketing Assistant,5738,1555,7293
729,Zora,Pike,zpikek8@fda.gov,Human Resources Manager,5963,789,6752
730,Erek,Hews,ehewsk9@elpais.com,Structural Analysis Engineer,3670,1343,5013
731,Heinrick,Dickon,hdickonka@freewebs.com,Health Coach II,1834,938,2772
732,Camellia,Longbottom,clongbottomkb@time.com,Technical Writer,1565,1324,2889
733,Derek,De Giorgis,ddegiorgiskc@ca.gov,Software Engineer III,6946,1213,8159
734,Isidor,Soffe,isoffekd@xinhuanet.com,General Manager,9282,597,9879
735,Edy,Cockshtt,ecockshttke@paypal.com,Health Coach II,8971,989,9960
736,Don,Karlqvist,dkarlqvistkf@nyu.edu,Nurse Practicioner,8990,1625,10615
737,Puff,Bosch,pboschkg@bluehost.com,Structural Engineer,3670,1620,5290
738,Joice,Sadry,jsadrykh@elpais.com,Account Representative I,1692,583,2275
739,Aldus,Dudleston,adudlestonki@youku.com,Director of Sales,8744,1065,9809
740,Allard,Roussel,arousselkj@washington.edu,Associate Professor,5789,1607,7396
741,Conny,Laminman,claminmankk@house.gov,Desktop Support Technician,5106,1180,6286
742,Maure,Perryman,mperrymankl@omniture.com,Pharmacist,6727,1843,8570
743,Brendon,West,bwestkm@hostgator.com,Data Coordiator,9236,686,9922
744,Kerrill,Blayd,kblaydkn@mapquest.com,Financial Analyst,7503,1182,8685
745,Caleb,Waind,cwaindko@usda.gov,Senior Quality Engineer,9097,1089,10186
746,Jerrold,Cannavan,jcannavankp@wordpress.com,Speech Pathologist,7631,491,8122
747,Lettie,Stanbury,lstanburykq@cpanel.net,Mechanical Systems Engineer,5182,483,5665
748,Ferris,Wedge,fwedgekr@zimbio.com,Programmer Analyst I,3822,1738,5560
749,Toddie,Swale,tswaleks@mail.ru,Quality Engineer,1596,255,1851
750,Allie,Bosley,abosleykt@shinystat.com,VP Sales,4618,1790,6408
751,Lolly,Dalgety,ldalgetyku@imdb.com,Administrative Assistant II,7661,1983,9644
752,Rob,Bert,rbertkv@geocities.com,Pharmacist,2402,800,3202
753,Geoffry,Rubbert,grubbertkw@usgs.gov,Technical Writer,5962,1447,7409
754,Amalie,Cornely,acornelykx@trellian.com,Web Developer I,5430,1158,6588
755,Benetta,Tomkin,btomkinky@google.com.au,Recruiter,2062,1414,3476
756,Dick,Nevill,dnevillkz@thetimes.co.uk,Analog Circuit Design manager,6979,1749,8728
757,Alvan,Gooderridge,agooderridgel0@dyndns.org,Senior Cost Accountant,3922,561,4483
758,Abigael,Schulkins,aschulkinsl1@nhs.uk,Actuary,9649,711,10360
759,Laurence,Hucquart,lhucquartl2@marketwatch.com,Account Coordinator,6767,1383,8150
760,Erminia,Tunnicliffe,etunnicliffel3@booking.com,Executive Secretary,8359,897,9256
761,Rene,Atack,ratackl4@unblog.fr,Research Associate,7791,952,8743
762,Dario,Westoll,dwestolll5@technorati.com,Programmer Analyst III,1623,1797,3420
763,Cleavland,Neve,cnevel6@ebay.com,Internal Auditor,7166,1076,8242
764,Jannelle,Navarro,jnavarrol7@technorati.com,Registered Nurse,4080,216,4296
765,Julienne,Ghioni,jghionil8@storify.com,Safety Technician IV,1180,1584,2764
766,Rabbi,Paolacci,rpaolaccil9@dell.com,Research Assistant IV,9906,1916,11822
767,Mab,Spruce,msprucela@multiply.com,Administrative Assistant II,4978,658,5636
768,Ashien,Marsy,amarsylb@noaa.gov,VP Product Management,8819,1300,10119
769,Brig,Dolle,bdollelc@ebay.com,Speech Pathologist,2002,527,2529
770,Ham,Gunson,hgunsonld@ebay.com,Budget/Accounting Analyst I,5774,326,6100
771,Alvan,Lorriman,alorrimanle@pcworld.com,Safety Technician III,3644,1862,5506
772,Tessie,Harrill,tharrilllf@nature.com,Senior Developer,6127,1787,7914
773,Ebeneser,Pavett,epavettlg@purevolume.com,Statistician I,6568,1820,8388
774,Violet,Ridgway,vridgwaylh@cmu.edu,Engineer III,6593,1140,7733
775,Joleen,Smart,jsmartli@storify.com,General Manager,2063,1316,3379
776,Obadiah,Bastide,obastidelj@alibaba.com,Database Administrator I,3759,1885,5644
777,Roxy,Stapleford,rstaplefordlk@aol.com,Technical Writer,2679,964,3643
778,Jori,Skene,jskenell@hubpages.com,Budget/Accounting Analyst I,5501,1938,7439
779,Enriqueta,Benkin,ebenkinlm@boston.com,Accountant IV,5675,1559,7234
780,Ransom,Pesak,rpesakln@forbes.com,Occupational Therapist,5374,625,5999
781,Wolf,Ambler,wamblerlo@pinterest.com,Operator,9816,401,10217
782,Becka,Rugg,brugglp@dailymotion.com,Media Manager I,8440,567,9007
783,Mill,Boxhall,mboxhalllq@domainmarket.com,Software Engineer IV,3965,967,4932
784,Herc,Dudman,hdudmanlr@wikipedia.org,Geologist II,5380,1488,6868
785,Petr,Axon,paxonls@mozilla.org,Nurse,5528,1537,7065
786,Kaleena,Wellesley,kwellesleylt@dropbox.com,Electrical Engineer,3364,704,4068
787,Janina,Woolliams,jwoolliamslu@loc.gov,VP Sales,2041,2000,4041
788,Phylis,Conibere,pconiberelv@weather.com,Help Desk Operator,2698,763,3461
789,Flora,Ventham,fventhamlw@mapy.cz,Environmental Specialist,4817,1558,6375
790,Dennie,Blasetti,dblasettilx@nba.com,Recruiter,1839,1851,3690
791,Hy,Lewerenz,hlewerenzly@bloglovin.com,Accountant I,1868,1603,3471
792,Serena,Habercham,shaberchamlz@archive.org,Desktop Support Technician,6604,1469,8073
793,Danell,Surplice,dsurplicem0@github.io,Senior Editor,9647,328,9975
794,Gib,Tudgay,gtudgaym1@about.me,Speech Pathologist,9188,716,9904
795,Dionne,Dumphries,ddumphriesm2@trellian.com,Administrative Assistant III,2546,1173,3719
796,Shem,Casolla,scasollam3@acquirethisname.com,Teacher,5744,968,6712
797,Jeddy,Branney,jbranneym4@prlog.org,Financial Analyst,7416,1907,9323
798,Georgina,Mewis,gmewism5@arizona.edu,VP Product Management,9915,960,10875
799,Miranda,Cumes,mcumesm6@wsj.com,Media Manager III,6466,570,7036
800,Whitney,Clemmens,wclemmensm7@theatlantic.com,Operator,1028,486,1514
801,Gianina,De Ferrari,gdeferrarim8@imageshack.us,Programmer Analyst IV,8663,1963,10626
802,Jessalyn,MacAvaddy,jmacavaddym9@yahoo.co.jp,Sales Associate,6209,671,6880
803,Hillel,Feaviour,hfeaviourma@comsenz.com,VP Sales,7239,1558,8797
804,Hermy,Janisson,hjanissonmb@cornell.edu,Account Executive,4701,669,5370
805,Hillyer,Dally,hdallymc@uol.com.br,Account Coordinator,5535,1893,7428
806,Brantley,Willmott,bwillmottmd@wikipedia.org,Project Manager,1641,1985,3626
807,Theresa,Adriaan,tadriaanme@cornell.edu,VP Marketing,6342,448,6790
808,Hillery,Bucky,hbuckymf@nymag.com,Physical Therapy Assistant,6081,1491,7572
809,Karmen,Ghione,kghionemg@google.com.au,Senior Cost Accountant,6987,1136,8123
810,Zach,Mehaffey,zmehaffeymh@oakley.com,Food Chemist,5747,1709,7456
811,Xymenes,Conre,xconremi@newyorker.com,Professor,3714,1465,5179
812,Beck,Gillimgham,bgillimghammj@china.com.cn,Sales Representative,2697,1668,4365
813,Shelli,Ausiello,sausiellomk@oaic.gov.au,Systems Administrator II,3069,1330,4399
814,Kary,Ould,kouldml@amazonaws.com,Software Consultant,4305,718,5023
815,Garold,Clymer,gclymermm@blogspot.com,Sales Associate,5754,387,6141
816,Adlai,Bazoche,abazochemn@vk.com,Accountant I,7221,403,7624
817,Clyde,Tredgold,ctredgoldmo@slashdot.org,Director of Sales,8784,1199,9983
818,Simonette,Ferres,sferresmp@vkontakte.ru,Help Desk Technician,3390,1251,4641
819,Alaine,Thamelt,athameltmq@wired.com,Database Administrator II,3010,973,3983
820,Grata,Giggs,ggiggsmr@hatena.ne.jp,Chemical Engineer,4605,1398,6003
821,Caldwell,Oleksinski,coleksinskims@arizona.edu,Analog Circuit Design manager,6380,1309,7689
822,Liam,Lambertini,llambertinimt@chronoengine.com,Systems Administrator III,6777,579,7356
823,Yuri,Klimecki,yklimeckimu@gnu.org,Software Consultant,3581,793,4374
824,Parker,Warboy,pwarboymv@bluehost.com,Accounting Assistant IV,1722,513,2235
825,Enrika,Antrobus,eantrobusmw@globo.com,Librarian,5016,1019,6035
826,Vinny,Learmouth,vlearmouthmx@wsj.com,Paralegal,9920,456,10376
827,Adella,Davidy,adavidymy@creativecommons.org,Software Test Engineer IV,8380,1457,9837
828,Cristionna,Barkly,cbarklymz@fastcompany.com,Statistician IV,4075,262,4337
829,Kristina,Burndred,kburndredn0@tinyurl.com,Assistant Professor,6604,1400,8004
830,Forest,Cote,fcoten1@unblog.fr,Director of Sales,8843,1309,10152
831,Monro,Myderscough,mmyderscoughn2@who.int,Senior Quality Engineer,8572,426,8998
832,Deck,Baskeyfield,dbaskeyfieldn3@dion.ne.jp,Engineer III,1607,435,2042
833,Ray,Fugere,rfugeren4@oaic.gov.au,Physical Therapy Assistant,5349,1725,7074
834,Alecia,Bragge,abraggen5@w3.org,Junior Executive,1433,289,1722
835,Tina,Yesenin,tyeseninn6@bbb.org,VP Marketing,4825,713,5538
836,Camile,Sallenger,csallengern7@google.com,VP Accounting,4156,491,4647
837,Dilan,Bradock,dbradockn8@gmpg.org,Civil Engineer,2294,1554,3848
838,Melita,Milbank,mmilbankn9@people.com.cn,Recruiter,4958,1651,6609
839,Daveta,Zimmer,dzimmerna@is.gd,Quality Engineer,9160,678,9838
840,Sapphira,Freshwater,sfreshwaternb@unesco.org,Web Developer IV,9657,289,9946
841,Haley,MacCafferty,hmaccaffertync@blogs.com,Associate Professor,6588,1346,7934
842,Ronald,Labden,rlabdennd@si.edu,Senior Editor,4305,1959,6264
843,Filip,Blair,fblairne@unc.edu,GIS Technical Architect,9722,363,10085
844,Nataline,Ring,nringnf@chron.com,Pharmacist,8093,789,8882
845,Dex,Stodit,dstoditng@nsw.gov.au,Systems Administrator III,9203,1733,10936
846,Webster,Gordon,wgordonnh@smh.com.au,Social Worker,6470,1993,8463
847,Wendall,Laybourne,wlaybourneni@loc.gov,Recruiting Manager,1194,801,1995
848,Alexandre,Dehn,adehnnj@oaic.gov.au,Director of Sales,8831,1390,10221
849,Crysta,Parcall,cparcallnk@cornell.edu,Professor,8201,693,8894
850,Emmit,Chipchase,echipchasenl@uol.com.br,Marketing Assistant,6385,1994,8379
851,Suzanna,Basten,sbastennm@ovh.net,Computer Systems Analyst IV,1314,1199,2513
852,Gene,Jedrasik,gjedrasiknn@infoseek.co.jp,Geologist I,4345,1666,6011
853,Margi,Padmore,mpadmoreno@reddit.com,Professor,1874,865,2739
854,Regine,Pele,rpelenp@shop-pro.jp,Statistician IV,3352,973,4325
855,Elliott,Kippins,ekippinsnq@163.com,Chemical Engineer,3812,406,4218
856,Jody,Bucke,jbuckenr@infoseek.co.jp,Social Worker,3583,1684,5267
857,Loni,Helliker,lhellikerns@marketwatch.com,General Manager,1028,1451,2479
858,Welsh,Gregr,wgregrnt@mashable.com,Statistician IV,3902,1917,5819
859,Ivonne,Djekovic,idjekovicnu@aol.com,Human Resources Manager,7309,1901,9210
860,Towney,MacMaykin,tmacmaykinnv@discuz.net,Tax Accountant,6711,225,6936
861,Trumaine,Povah,tpovahnw@deviantart.com,Physical Therapy Assistant,9553,1744,11297
862,Andriette,Brayley,abrayleynx@cdbaby.com,Environmental Tech,1390,801,2191
863,Noreen,Harries,nharriesny@1und1.de,Media Manager III,2057,1937,3994
864,Jaynell,Gonsalo,jgonsalonz@cdc.gov,Professor,5111,1267,6378
865,Benetta,Eynon,beynono0@sun.com,Administrative Assistant III,1357,798,2155
866,Shelley,Culvey,sculveyo1@wikimedia.org,Assistant Professor,2865,1682,4547
867,Ivan,Janic,ijanico2@symantec.com,Product Engineer,3650,1900,5550
868,Libbie,Ellwell,lellwello3@woothemes.com,Editor,8156,1997,10153
869,Moina,Finnie,mfinnieo4@amazon.co.jp,Speech Pathologist,9496,1612,11108
870,Clotilda,Stoite,cstoiteo5@google.com.br,Product Engineer,2122,308,2430
871,Almire,Blampy,ablampyo6@ask.com,Tax Accountant,2406,970,3376
872,Nisse,Mallord,nmallordo7@bloglines.com,Editor,3104,1344,4448
873,Xavier,Danilovitch,xdanilovitcho8@toplist.cz,Financial Analyst,7922,664,8586
874,Marylinda,Dance,mdanceo9@dailymail.co.uk,Senior Cost Accountant,4399,1252,5651
875,Josepha,Lemmers,jlemmersoa@myspace.com,Legal Assistant,6089,1640,7729
876,Rurik,Shawe,rshaweob@seesaa.net,Occupational Therapist,8091,1301,9392
877,Riley,Hymus,rhymusoc@slate.com,Marketing Manager,7855,1675,9530
878,Cherish,Leband,clebandod@angelfire.com,Teacher,6994,369,7363
879,Cosetta,Beumant,cbeumantoe@blogs.com,Environmental Tech,5841,721,6562
880,Dena,Bum,dbumof@w3.org,Chemical Engineer,1877,255,2132
881,Jeanette,Cossentine,jcossentineog@csmonitor.com,Physical Therapy Assistant,3423,704,4127
882,Jacki,Tanby,jtanbyoh@nifty.com,Registered Nurse,2437,1590,4027
883,Ringo,Leifer,rleiferoi@trellian.com,Financial Advisor,8826,1389,10215
884,Roby,Riolfi,rriolfioj@apache.org,GIS Technical Architect,7320,1309,8629
885,Jaime,Haill,jhaillok@ibm.com,Compensation Analyst,4638,1944,6582
886,L;urette,Mazonowicz,lmazonowiczol@guardian.co.uk,Analyst Programmer,2558,1320,3878
887,Bridie,Jerzykiewicz,bjerzykiewiczom@go.com,Web Designer I,9006,1567,10573
888,Massimiliano,Mapam,mmapamon@businessinsider.com,Actuary,9768,1830,11598
889,Blake,Charity,bcharityoo@simplemachines.org,Nuclear Power Engineer,3229,1440,4669
890,Vasili,Hendrix,vhendrixop@hc360.com,Biostatistician II,3097,318,3415
891,Elinor,Quarterman,equartermanoq@berkeley.edu,Senior Sales Associate,2183,1156,3339
892,Earvin,McKeevers,emckeeversor@elegantthemes.com,Human Resources Manager,5474,1085,6559
893,Leoline,Gigg,lgiggos@redcross.org,Civil Engineer,8138,1984,10122
894,Christiano,Alleburton,calleburtonot@disqus.com,Human Resources Manager,8874,1258,10132
895,Leigh,Girhard,lgirhardou@pcworld.com,Design Engineer,6577,1359,7936
896,Yorgo,Restill,yrestillov@pinterest.com,Administrative Assistant I,8823,1565,10388
897,Gabe,Lingley,glingleyow@mac.com,Sales Associate,4622,1602,6224
898,Seymour,Cuming,scumingox@shutterfly.com,Human Resources Manager,8567,1541,10108
899,Ailene,Acheson,aachesonoy@typepad.com,Product Engineer,5595,1113,6708
900,Rosy,Zarfai,rzarfaioz@cloudflare.com,Recruiting Manager,9879,1932,11811
901,Caye,Lovett,clovettp0@princeton.edu,Internal Auditor,3022,855,3877
902,Lyssa,Kos,lkosp1@de.vu,Environmental Tech,2054,1011,3065
903,Alexei,Priest,apriestp2@census.gov,Marketing Assistant,2810,944,3754
904,Zilvia,Alans,zalansp3@cpanel.net,Web Developer I,2866,522,3388
905,Stavros,Imlock,simlockp4@slashdot.org,Web Developer I,5274,233,5507
906,Hugo,Doerling,hdoerlingp5@etsy.com,Teacher,3003,1115,4118
907,Ladonna,Rastall,lrastallp6@pcworld.com,Account Executive,8146,1482,9628
908,Leonard,Clinton,lclintonp7@cmu.edu,Mechanical Systems Engineer,2499,1482,3981
909,Royce,Korejs,rkorejsp8@newyorker.com,Design Engineer,7980,1744,9724
910,Addy,Cheater,acheaterp9@wp.com,Analog Circuit Design manager,2021,535,2556
911,Christos,Whittaker,cwhittakerpa@cam.ac.uk,Associate Professor,3577,491,4068
912,Hieronymus,Yakobowitch,hyakobowitchpb@vk.com,Project Manager,3196,1837,5033
913,Ronalda,Pashby,rpashbypc@hao123.com,VP Product Management,4564,1610,6174
914,Alphonse,Al Hirsi,aalhirsipd@apple.com,Compensation Analyst,8146,1750,9896
915,Cordelie,Manchester,cmanchesterpe@china.com.cn,Administrative Officer,4699,677,5376
916,Sonnnie,Shrive,sshrivepf@prnewswire.com,Staff Scientist,5339,1803,7142
917,Ernesto,Ebbers,eebberspg@hibu.com,Marketing Manager,4168,1607,5775
918,Alisa,Silverton,asilvertonph@clickbank.net,Desktop Support Technician,3531,1231,4762
919,Ninnetta,Allwright,nallwrightpi@examiner.com,Recruiting Manager,6102,305,6407
920,Margarethe,MacGinley,mmacginleypj@lulu.com,Nuclear Power Engineer,2537,426,2963
921,Hillel,Maud,hmaudpk@java.com,Librarian,7271,1150,8421
922,Gisele,Barnet,gbarnetpl@flickr.com,Database Administrator II,6234,1349,7583
923,Coralie,Boyford,cboyfordpm@guardian.co.uk,Recruiter,9163,714,9877
924,Gaven,Portugal,gportugalpn@studiopress.com,Staff Accountant II,5868,1373,7241
925,Rey,Lamy,rlamypo@canalblog.com,VP Product Management,3751,865,4616
926,Coralyn,Caygill,ccaygillpp@theguardian.com,Associate Professor,5110,863,5973
927,Witty,Georg,wgeorgpq@google.cn,Administrative Officer,8903,535,9438
928,Berenice,Taks,btakspr@businesswire.com,VP Marketing,6769,1192,7961
929,Arley,Gilmour,agilmourps@webnode.com,Staff Accountant III,7773,657,8430
930,Giorgi,O'Canavan,gocanavanpt@wikispaces.com,Structural Engineer,3892,1018,4910
931,Renie,Mattisson,rmattissonpu@mtv.com,Sales Representative,9617,1365,10982
932,Barbaraanne,Klehyn,bklehynpv@freewebs.com,Assistant Media Planner,5693,689,6382
933,Agatha,Lacky,alackypw@ucoz.com,Sales Associate,3384,1320,4704
934,Wynn,Perl,wperlpx@ebay.co.uk,Quality Engineer,1826,1590,3416
935,Darelle,Cribbin,dcribbinpy@unc.edu,Cost Accountant,2277,244,2521
936,Witty,Backen,wbackenpz@prweb.com,Associate Professor,8174,349,8523
937,Emyle,Kohrding,ekohrdingq0@miitbeian.gov.cn,Desktop Support Technician,9723,304,10027
938,Abba,Gerlack,agerlackq1@blog.com,Office Assistant II,6762,1850,8612
939,Karalee,De Mars,kdemarsq2@indiatimes.com,Geological Engineer,6861,915,7776
940,Denys,De Metz,ddemetzq3@vk.com,Associate Professor,4786,1365,6151
941,Eugene,Haslewood,ehaslewoodq4@ucsd.edu,Account Coordinator,4962,597,5559
942,Aigneis,Flageul,aflageulq5@dagondesign.com,Software Test Engineer I,1563,1656,3219
943,Zared,Thys,zthysq6@ustream.tv,VP Accounting,4706,1199,5905
944,Myca,Dombrell,mdombrellq7@freewebs.com,Structural Analysis Engineer,5664,1006,6670
945,Marven,MacPadene,mmacpadeneq8@geocities.jp,Human Resources Assistant II,8707,395,9102
946,Grantham,Glencros,gglencrosq9@list-manage.com,Accountant III,6621,956,7577
947,Baily,O'Crigane,bocriganeqa@shop-pro.jp,Data Coordiator,6472,360,6832
948,Banky,Edelheid,bedelheidqb@dedecms.com,Pharmacist,6729,1061,7790
949,Melany,Ceccoli,mceccoliqc@themeforest.net,Marketing Manager,2700,614,3314
950,Brice,Fishly,bfishlyqd@blogspot.com,Payment Adjustment Coordinator,4241,904,5145
951,Gil,McVitty,gmcvittyqe@about.me,Financial Advisor,6224,514,6738
952,Jannelle,Wile,jwileqf@domainmarket.com,Director of Sales,1166,1106,2272
953,Candace,Ludl,cludlqg@hp.com,GIS Technical Architect,1134,1085,2219
954,Corina,Ades,cadesqh@ycombinator.com,Graphic Designer,4200,1934,6134
955,Minette,Pavitt,mpavittqi@mashable.com,Pharmacist,5322,1419,6741
956,Susi,Redgrave,sredgraveqj@bbc.co.uk,Social Worker,7647,1118,8765
957,Ibbie,Byne,ibyneqk@facebook.com,Account Coordinator,2283,1401,3684
958,Stephanie,Calver,scalverql@hugedomains.com,Software Engineer III,5817,644,6461
959,Pauletta,Grunson,pgrunsonqm@cnbc.com,Sales Representative,9037,977,10014
960,Almeria,Emm,aemmqn@mail.ru,Graphic Designer,7392,1591,8983
961,Thaddeus,Clampe,tclampeqo@phpbb.com,Assistant Media Planner,6041,1745,7786
962,Gleda,Wiltsher,gwiltsherqp@imageshack.us,Help Desk Technician,3912,927,4839
963,Maye,Kilmary,mkilmaryqq@tamu.edu,Mechanical Systems Engineer,9081,644,9725
964,Cristen,Ruppel,cruppelqr@jigsy.com,Software Consultant,1750,823,2573
965,Vin,Hampton,vhamptonqs@msu.edu,Operator,6393,1154,7547
966,Lauraine,Scudder,lscudderqt@sourceforge.net,Database Administrator II,7795,726,8521
967,Garey,Felgate,gfelgatequ@bandcamp.com,Software Engineer III,5689,1167,6856
968,Tildie,Sanper,tsanperqv@addthis.com,Business Systems Development Analyst,4144,259,4403
969,Maury,Poole,mpooleqw@addtoany.com,Senior Cost Accountant,6967,1188,8155
970,Godwin,Bodesson,gbodessonqx@cam.ac.uk,Business Systems Development Analyst,5502,1589,7091
971,Trenna,Brookton,tbrooktonqy@sphinn.com,Electrical Engineer,5871,226,6097
972,Sybyl,Kretschmer,skretschmerqz@networkadvertising.org,Payment Adjustment Coordinator,5266,1284,6550
973,Daisy,Timmins,dtimminsr0@dmoz.org,Tax Accountant,7470,773,8243
974,Garik,Rosenstiel,grosenstielr1@state.gov,Librarian,6858,1386,8244
975,Godfree,Ness,gnessr2@google.co.jp,Account Coordinator,7793,1611,9404
976,Hartley,Porritt,hporrittr3@shop-pro.jp,Administrative Assistant III,1322,747,2069
977,Ravid,Wandrack,rwandrackr4@goodreads.com,Statistician II,7719,393,8112
978,Cleopatra,Belch,cbelchr5@imgur.com,Civil Engineer,6183,1563,7746
979,Philly,Dhennin,pdhenninr6@youtu.be,Legal Assistant,3586,427,4013
980,Hobard,MacConnulty,hmacconnultyr7@msn.com,Information Systems Manager,3544,815,4359
981,Sharai,Thumim,sthumimr8@usatoday.com,Chemical Engineer,2098,318,2416
982,Hart,Nudd,hnuddr9@ebay.com,Mechanical Systems Engineer,9169,1302,10471
983,Marjory,Albrecht,malbrechtra@list-manage.com,Web Designer II,4252,1939,6191
984,Queenie,Cristofano,qcristofanorb@bigcartel.com,Account Representative IV,9872,952,10824
985,Jaynell,Antonik,jantonikrc@mlb.com,Health Coach I,4719,1319,6038
986,Rodolfo,Pavie,rpavierd@myspace.com,Developer II,2797,1032,3829
987,Jard,Baskwell,jbaskwellre@uiuc.edu,Marketing Manager,2037,1274,3311
988,Myranda,Skilton,mskiltonrf@github.io,Occupational Therapist,6600,1443,8043
989,Bernadene,Pizzie,bpizzierg@apache.org,Executive Secretary,5934,1158,7092
990,Hastie,Elderton,heldertonrh@eventbrite.com,Director of Sales,1134,1596,2730
991,Butch,Stourton,bstourtonri@nih.gov,Administrative Assistant II,8302,371,8673
992,Carny,Zincke,czinckerj@huffingtonpost.com,Nurse Practicioner,1751,648,2399
993,Dareen,Blease,dbleaserk@home.pl,VP Product Management,3377,451,3828
994,Pierette,Benettelli,pbenettellirl@europa.eu,Nuclear Power Engineer,8129,1286,9415
995,Gaynor,Watford,gwatfordrm@cmu.edu,Executive Secretary,8470,387,8857
996,Nealon,Lightbowne,nlightbownern@smh.com.au,Business Systems Development Analyst,4998,1059,6057
997,Saleem,McRill,smcrillro@gnu.org,Engineer II,9687,219,9906
998,Corrianne,Danielczyk,cdanielczykrp@about.me,Analyst Programmer,7969,1400,9369
999,Thorstein,Allwood,tallwoodrq@usda.gov,Office Assistant III,6147,1690,7837
1000,Amitie,Shapero,ashaperorr@boston.com,Civil Engineer,7094,1118,8212
2306,Domeniga,Lavalde,dlavalde0@addtoany.com,Software Consultant,2401,386,2787
2858,Tuesday,Hogbin,thogbin1@state.gov,Physical Therapy Assistant,1561,1667,3228
2838,Shurwood,Oglevie,soglevie2@xing.com,Computer Systems Analyst II,2462,207,2669
2802,Jordana,Piscot,jpiscot3@ucsd.edu,Pharmacist,9076,270,9346
2540,Kamillah,Philcox,kphilcox4@g.co,Environmental Specialist,9398,1657,11055
2609,Drusi,Dallin,ddallin5@technorati.com,Nurse Practicioner,7034,1085,8119
2200,Kinna,Nore,knore6@opera.com,Teacher,9244,1544,10788
2969,Tomasina,Schaumann,tschaumann7@clickbank.net,VP Quality Control,6111,713,6824
2448,Thane,Benedit,tbenedit8@ibm.com,Technical Writer,2101,1737,3838
2149,Fenelia,Jobling,fjobling9@cpanel.net,Operator,5866,454,6320
2115,Evangelia,Gussin,egussina@cdc.gov,Pharmacist,4552,976,5528
2567,Ray,McFade,rmcfadeb@yahoo.co.jp,Structural Engineer,5277,1010,6287
2334,Merridie,Neubigging,mneubiggingc@mtv.com,Recruiter,1913,1345,3258
2744,Emilee,Newling,enewlingd@mysql.com,Analog Circuit Design manager,6703,729,7432
2308,Hildegaard,Ion,hione@accuweather.com,VP Product Management,1952,1754,3706
2018,Julianne,Adriaan,jadriaanf@forbes.com,Administrative Officer,1608,283,1891
2010,Mollie,Fairhall,mfairhallg@wisc.edu,Business Systems Development Analyst,7550,1285,8835
2705,Jeannine,Keyes,jkeyesh@cbc.ca,Staff Scientist,1014,988,2002
2690,Lenard,De Cleen,ldecleeni@goo.gl,Financial Analyst,9456,213,9669
2248,Anthiathia,Hanhart,ahanhartj@163.com,Community Outreach Specialist,6818,1704,8522
2178,Dennis,Maggs,dmaggsk@google.com.au,Librarian,1380,594,1974
2906,Antonin,De Paepe,adepaepel@dropbox.com,Computer Systems Analyst IV,7510,1032,8542
2675,Teodor,Rime,trimem@wikimedia.org,Administrative Assistant I,2840,720,3560
2487,Tessy,Enefer,tenefern@boston.com,Social Worker,3147,1718,4865
2327,Hall,Tulley,htulleyo@chronoengine.com,Food Chemist,9558,306,9864
2527,Mack,Crew,mcrewp@hatena.ne.jp,Budget/Accounting Analyst IV,9729,1839,11568
2036,Wendi,Ponceford,wponcefordq@amazon.com,Research Nurse,7598,1446,9044
2438,Donnie,Sawley,dsawleyr@europa.eu,Mechanical Systems Engineer,7029,1683,8712
2001,Izabel,Northen,inorthens@bbc.co.uk,Financial Analyst,6181,804,6985
2346,Gabbey,Blazey,gblazeyt@timesonline.co.uk,Automation Specialist III,5941,1314,7255
2915,Henriette,Shirland,hshirlandu@shinystat.com,Programmer II,8243,1639,9882
2755,Paola,Powles,ppowlesv@bbc.co.uk,Accounting Assistant IV,7841,501,8342
2198,Norton,Delion,ndelionw@howstuffworks.com,Desktop Support Technician,7874,1935,9809
2403,Leanna,Espadater,lespadaterx@istockphoto.com,Product Engineer,9022,1077,10099
2604,Pearle,Tummons,ptummonsy@statcounter.com,Project Manager,8565,546,9111
2855,Dugald,Houlton,dhoultonz@indiegogo.com,Food Chemist,4183,1147,5330
2223,Mathe,Beagrie,mbeagrie10@cdc.gov,Senior Sales Associate,8621,1002,9623
2981,Ewell,Trappe,etrappe12@smh.com.au,Cost Accountant,9668,514,10182
2988,Gustie,Kenafaque,gkenafaque13@elpais.com,Desktop Support Technician,2587,1421,4008
2980,Goldina,Gitsham,ggitsham14@joomla.org,Biostatistician III,8803,959,9762
2700,Pauli,Snalham,psnalham15@unesco.org,Administrative Officer,4335,221,4556
2664,Kassey,Yakebowitch,kyakebowitch16@technorati.com,Accounting Assistant I,4945,976,5921
2882,Rafaellle,Blamey,rblamey17@csmonitor.com,Director of Sales,3938,1154,5092
2703,Lucho,Soitoux,lsoitoux18@yahoo.com,Structural Analysis Engineer,2497,228,2725
2841,Mikael,Playdon,mplaydon19@edublogs.org,Administrative Assistant II,5159,323,5482
2563,Morganica,Dosdell,mdosdell1a@mediafire.com,Assistant Manager,3931,1410,5341
2640,Hercules,Derges,hderges1b@globo.com,Marketing Assistant,6802,1512,8314
2598,Faydra,Vynehall,fvynehall1c@telegraph.co.uk,Programmer II,3622,1731,5353
2019,Romona,Vannuccinii,rvannuccinii1d@nydailynews.com,Human Resources Manager,2245,1545,3790
2190,Debor,MacAllen,dmacallen1e@cnbc.com,Health Coach IV,8527,1404,9931
2462,Bryce,Miere,bmiere1g@statcounter.com,VP Sales,3135,1374,4509
2382,Angy,Klos,aklos1h@usa.gov,Environmental Tech,1636,1409,3045
2299,Shell,Sommers,ssommers1i@is.gd,Staff Accountant II,8310,862,9172
2067,Muriel,Patron,mpatron1j@sitemeter.com,Graphic Designer,1574,1251,2825
2385,Francis,Annable,fannable1k@xing.com,Administrative Assistant II,8457,1085,9542
2884,Lucine,Carluccio,lcarluccio1l@yale.edu,Database Administrator II,7382,732,8114
2637,Ripley,Alywin,ralywin1m@samsung.com,Developer II,5887,1870,7757
2948,Melonie,Rosencwaig,mrosencwaig1n@ebay.co.uk,Senior Financial Analyst,9575,329,9904
2184,Doy,Murthwaite,dmurthwaite1o@ezinearticles.com,Web Developer III,1825,1716,3541
2141,Dalenna,Deely,ddeely1p@wix.com,Research Associate,5680,1981,7661
2003,Margarita,Mc Menamin,mmcmenamin1q@dyndns.org,Programmer III,3558,1496,5054
2065,Aurthur,Labarre,alabarre1r@google.com.br,Junior Executive,9552,479,10031
2922,Marthena,Landa,mlanda1s@upenn.edu,Geologist III,9512,1601,11113
2435,Dena,Droghan,ddroghan1t@nydailynews.com,Staff Accountant III,9559,1862,11421
2398,Crichton,Kenrat,ckenrat1u@sciencedirect.com,Actuary,8663,1135,9798
2505,Khalil,Pavolini,kpavolini1v@t.co,Senior Cost Accountant,9040,1449,10489
2210,Pooh,Pickless,ppickless1x@usatoday.com,Engineer I,7397,1310,8707
2756,Gwynne,Corkhill,gcorkhill1y@usa.gov,Senior Sales Associate,2300,1642,3942
2784,Free,Barents,fbarents1z@1und1.de,Mechanical Systems Engineer,9957,552,10509
2894,Sianna,Wilkenson,swilkenson20@google.es,Administrative Assistant II,3080,1776,4856
2459,Yehudi,Rieger,yrieger21@so-net.ne.jp,Structural Engineer,9470,512,9982
2008,Selie,Buttrick,sbuttrick22@wikispaces.com,Pharmacist,9638,1198,10836
2526,Calida,Myring,cmyring23@ucoz.com,Biostatistician IV,2707,259,2966
2898,Filippa,Duddle,fduddle24@reuters.com,Quality Engineer,1059,1566,2625
2792,Gabbey,Vasyunkin,gvasyunkin25@uol.com.br,Database Administrator II,1529,536,2065
2927,Sidonia,McReynold,smcreynold26@businesswire.com,Administrative Assistant III,9823,845,10668
2616,Deva,Cotterel,dcotterel27@opera.com,VP Product Management,9308,429,9737
2878,Melody,Zamora,mzamora28@hubpages.com,Professor,5563,445,6008
2057,Marthe,Odgers,modgers29@goo.ne.jp,Electrical Engineer,1945,1808,3753
2345,Allister,Divisek,adivisek2a@pagesperso-orange.fr,Web Developer II,5413,818,6231
2940,Phillip,Warricker,pwarricker2b@answers.com,Environmental Tech,2694,742,3436
2547,Arlana,Earnshaw,aearnshaw2c@oakley.com,Help Desk Operator,1306,1659,2965
2281,Ellissa,Berthouloume,eberthouloume2d@lulu.com,Account Representative IV,2608,1491,4099
2429,Virgil,Christophle,vchristophle2e@japanpost.jp,Senior Editor,4983,530,5513
2356,Elbertine,Risdale,erisdale2f@xrea.com,Registered Nurse,7086,1051,8137
2365,Ax,Kulic,akulic2g@odnoklassniki.ru,Senior Editor,4758,1792,6550
2539,Dalston,Burmingham,dburmingham2h@canalblog.com,Software Consultant,4042,1157,5199
2730,Rutter,Oyley,royley2i@google.pl,Sales Associate,5704,1895,7599
2335,Astrix,Luxen,aluxen2j@boston.com,Biostatistician I,2402,1215,3617
2151,Dagny,O'Curneen,docurneen2k@clickbank.net,Information Systems Manager,8270,1075,9345
2011,Allyson,Inkpin,ainkpin2n@usatoday.com,Occupational Therapist,7091,246,7337
2693,Miles,Standrin,mstandrin2o@w3.org,Speech Pathologist,6122,687,6809
2850,Phelia,Adnam,padnam2p@jimdo.com,Senior Editor,3001,977,3978
2691,Sabra,Pester,spester2q@reuters.com,Web Developer II,4516,940,5456
2463,Wilburt,Arne,warne2r@google.de,Clinical Specialist,9802,1595,11397
2136,Dewain,Gerbl,dgerbl2s@nationalgeographic.com,Account Representative IV,7871,584,8455
2167,Myrtia,Ventum,mventum2t@gravatar.com,Account Executive,7703,1035,8738
2843,Belva,Bahia,bbahia2u@virginia.edu,Biostatistician II,7291,654,7945
2562,Lil,Pasterfield,lpasterfield2v@upenn.edu,Physical Therapy Assistant,4570,1383,5953
2312,Artair,McCadden,amccadden2w@shop-pro.jp,Community Outreach Specialist,4661,488,5149
2978,Imelda,Halksworth,ihalksworth2x@squidoo.com,Software Consultant,5055,1236,6291
2084,Artemas,Edmands,aedmands2y@dagondesign.com,Budget/Accounting Analyst I,1194,849,2043
2521,Adrian,Fosserd,afosserd2z@devhub.com,Chemical Engineer,6393,305,6698
2621,Murielle,Pembry,mpembry30@amazonaws.com,Cost Accountant,1596,1339,2935
2712,Maisey,Dewsnap,mdewsnap31@skyrock.com,Health Coach IV,3523,1647,5170
2476,Jordana,Bredbury,jbredbury32@tamu.edu,Recruiter,1804,1188,2992
2651,Cecil,Griffey,cgriffey33@woothemes.com,Sales Representative,8098,1280,9378
2112,Brandyn,Smallthwaite,bsmallthwaite35@nih.gov,Associate Professor,8184,1388,9572
2461,Lawry,Blonfield,lblonfield36@skyrock.com,Junior Executive,9263,1385,10648
2581,Yves,Gaiford,ygaiford37@sciencedaily.com,General Manager,1074,856,1930
2713,Ansley,Doctor,adoctor38@gmpg.org,Web Developer IV,1612,1800,3412
2645,Rebbecca,Bruun,rbruun39@webmd.com,Recruiter,1773,504,2277
2389,Mildrid,Berrane,mberrane3a@mtv.com,Senior Financial Analyst,6160,1739,7899
2282,Dyna,Cragell,dcragell3b@eventbrite.com,Senior Quality Engineer,9175,1406,10581
2949,Amaleta,Augar,aaugar3c@cmu.edu,Geological Engineer,6123,1112,7235
2432,Keelia,Kruschev,kkruschev3d@linkedin.com,Associate Professor,8327,345,8672
2333,Stuart,Stammer,sstammer3e@deliciousdays.com,Registered Nurse,4744,801,5545
2465,Mac,Jinkins,mjinkins3f@simplemachines.org,Chief Design Engineer,3306,1677,4983
2910,Amata,Arkwright,aarkwright3g@studiopress.com,Sales Representative,4663,771,5434
2413,Tristam,Koschek,tkoschek3h@sphinn.com,Senior Cost Accountant,7798,1258,9056
2639,Kristen,Maryman,kmaryman3i@fda.gov,VP Accounting,1929,348,2277
2176,Sallie,Sealand,ssealand3j@phoca.cz,Design Engineer,8302,972,9274
2537,Husain,Osbaldstone,hosbaldstone3k@buzzfeed.com,Environmental Tech,8185,1733,9918
2257,Benoit,Rawdales,brawdales3l@gravatar.com,Structural Engineer,1409,1965,3374
2917,Starlene,Leer,sleer3m@vistaprint.com,Social Worker,1964,1184,3148
2073,Jedediah,Jerzykiewicz,jjerzykiewicz3o@discuz.net,Software Consultant,6807,1239,8046
2406,Leia,Heditch,lheditch3p@vk.com,Environmental Specialist,1375,334,1709
2341,Bekki,Lilie,blilie3q@cnbc.com,Software Consultant,4096,581,4677
2686,Lorrie,Littledyke,llittledyke3r@flickr.com,Quality Engineer,4170,1257,5427
2009,Zacharias,Thirst,zthirst3s@csmonitor.com,Nurse,6094,1387,7481
2193,Oona,Salmond,osalmond3t@oakley.com,Help Desk Operator,5900,1855,7755
2895,Waylin,Slocum,wslocum3u@loc.gov,Actuary,7526,1185,8711
2044,Fenelia,Gutowski,fgutowski3v@surveymonkey.com,Developer III,9199,1327,10526
2962,Tedi,Munroe,tmunroe3w@gmpg.org,Tax Accountant,1861,1681,3542
2482,See,Risen,srisen3x@edublogs.org,Registered Nurse,8128,1425,9553
2666,Munroe,Rutherforth,mrutherforth3y@cisco.com,Actuary,5716,1957,7673
2217,Ada,Archibold,aarchibold3z@bravesites.com,Biostatistician III,9491,1032,10523
2668,Chelsy,Lowten,clowten40@goo.ne.jp,Internal Auditor,9537,946,10483
2387,Elroy,Legat,elegat42@house.gov,Geological Engineer,3412,1966,5378
2211,Hal,Luffman,hluffman43@de.vu,Compensation Analyst,1752,1139,2891
2849,Syman,Baugham,sbaugham45@prlog.org,Community Outreach Specialist,6423,1184,7607
2860,Brigid,De Vile,bdevile46@state.tx.us,Health Coach III,5372,1502,6874
2245,Cobbie,Greenstock,cgreenstock48@army.mil,Assistant Professor,5031,1537,6568
2139,Colet,Courtin,ccourtin49@marketwatch.com,Teacher,7200,1764,8964
2417,Cortney,Challoner,cchalloner4a@pinterest.com,Research Assistant II,2801,1290,4091
2087,Lauraine,Lanigan,llanigan4b@ted.com,Recruiting Manager,7201,1002,8203
2340,Joanie,Grigg,jgrigg4c@discovery.com,General Manager,2126,1363,3489
2492,Virgie,Rubenfeld,vrubenfeld4d@i2i.jp,Business Systems Development Analyst,6655,494,7149
2037,Callean,Bedward,cbedward4e@blog.com,Social Worker,9657,826,10483
2015,Staci,Stallion,sstallion4f@cbslocal.com,Statistician II,9462,1640,11102
2273,Costa,Dunkerley,cdunkerley4g@vk.com,Senior Sales Associate,6441,1083,7524
2027,Sammy,Druitt,sdruitt4h@pinterest.com,Senior Quality Engineer,2939,1597,4536
2726,Hercules,Spiring,hspiring4i@microsoft.com,VP Quality Control,9061,380,9441
2574,Sharity,Pladen,spladen4l@forbes.com,Sales Representative,2090,632,2722
2815,Brendon,Rydings,brydings4m@bbc.co.uk,Human Resources Assistant II,5801,217,6018
2041,Stanly,Mease,smease4n@berkeley.edu,Assistant Professor,3355,372,3727
2541,Marilyn,Ekless,mekless4p@webs.com,General Manager,2708,1949,4657
2743,Verna,Emerson,vemerson4q@google.com.au,VP Accounting,7460,1183,8643
2352,Olin,Deevey,odeevey4r@ca.gov,Software Test Engineer II,3513,403,3916
2889,Laurene,Malyan,lmalyan4s@woothemes.com,Staff Accountant III,6701,850,7551
2252,Ingelbert,Noell,inoell4t@indiatimes.com,VP Accounting,4828,502,5330
2716,Paulie,Bromfield,pbromfield4u@de.vu,Human Resources Assistant II,5627,934,6561
2575,Kiersten,Baudry,kbaudry4v@amazon.com,Database Administrator IV,2848,1562,4410
2206,Philomena,Attwool,pattwool4w@ucsd.edu,Cost Accountant,8916,1949,10865
2824,Marji,Romushkin,mromushkin4x@adobe.com,Registered Nurse,8710,838,9548
2020,Michell,Taffs,mtaffs4y@census.gov,Mechanical Systems Engineer,1920,814,2734
2851,Kinnie,Marrows,kmarrows4z@desdev.cn,Community Outreach Specialist,9850,1381,11231
2737,Catha,Hartle,chartle52@so-net.ne.jp,Environmental Tech,8470,1929,10399
2911,Elora,Alsopp,ealsopp53@webnode.com,Research Assistant IV,3368,560,3928
2751,Evelina,Fonzone,efonzone55@qq.com,Office Assistant IV,3340,1558,4898
2214,Shelia,Thebeau,sthebeau56@so-net.ne.jp,Cost Accountant,9817,1929,11746
2620,Maria,Gaveltone,mgaveltone57@cpanel.net,Graphic Designer,7196,636,7832
2170,Grata,Liddicoat,gliddicoat58@mapquest.com,Human Resources Manager,1455,1860,3315
2871,Jacquenetta,Morse,jmorse59@youtu.be,Social Worker,8197,762,8959
2418,Loreen,Andrioletti,landrioletti5a@elegantthemes.com,Project Manager,2035,1270,3305
2033,Petronille,Uzzell,puzzell5b@alexa.com,Business Systems Development Analyst,7115,1990,9105
2523,Tamarah,Leither,tleither5d@gnu.org,Librarian,2195,912,3107
2017,Lurline,Huchot,lhuchot5e@home.pl,VP Quality Control,3318,1060,4378
2099,Faydra,Van der Hoeven,fvanderhoeven5g@geocities.jp,Software Consultant,6702,281,6983
2005,Marielle,McNysche,mmcnysche5h@hubpages.com,VP Product Management,1538,1461,2999
2493,Saxe,Grigore,sgrigore5j@archive.org,Help Desk Technician,7497,589,8086
2412,Krystle,Heintz,kheintz5k@jigsy.com,Product Engineer,7576,1169,8745
2904,Leslie,Schoroder,lschoroder5l@bloglines.com,Programmer Analyst I,8575,1590,10165
2590,Ardeen,Wisden,awisden5m@devhub.com,Project Manager,5829,1505,7334
2536,Ciro,Keaves,ckeaves5p@naver.com,Web Developer III,5269,1702,6971
2390,Adeline,Burdin,aburdin5q@bravesites.com,Senior Sales Associate,4340,322,4662
2872,Ofelia,Scargle,oscargle5r@aboutads.info,Mechanical Systems Engineer,6087,847,6934
2738,Ximenez,Dinjes,xdinjes5s@dot.gov,Accounting Assistant IV,6243,210,6453
2089,Zorina,Moyles,zmoyles5t@economist.com,Biostatistician IV,7153,1775,8928
2234,Broderic,Tumayan,btumayan5u@vkontakte.ru,Office Assistant II,3823,530,4353
2267,Rossy,Livezley,rlivezley5w@freewebs.com,Web Developer I,8827,1175,10002
2968,Jamill,Godthaab,jgodthaab5x@mapquest.com,Statistician III,2500,822,3322
2035,Alley,Crosfeld,acrosfeld5y@reuters.com,Recruiting Manager,9322,712,10034
2325,Neville,Gilmartin,ngilmartin5z@theguardian.com,Pharmacist,5252,1761,7013
2534,Shay,Dowker,sdowker61@ca.gov,Office Assistant I,6798,1231,8029
2552,Corrianne,Betteriss,cbetteriss63@hexun.com,Nuclear Power Engineer,2216,1125,3341
2291,Tabatha,McCrohon,tmccrohon64@mayoclinic.com,Dental Hygienist,3714,1719,5433
2343,Maggee,Haggath,mhaggath65@theglobeandmail.com,Account Coordinator,7721,288,8009
2695,Robin,MacKowle,rmackowle67@smugmug.com,Database Administrator IV,5636,906,6542
2053,Billie,Thaw,bthaw68@ft.com,Quality Control Specialist,8436,1932,10368
2452,Henka,Brokenshaw,hbrokenshaw69@bbc.co.uk,Senior Editor,8637,1057,9694
2464,Berna,Rutland,brutland6a@tmall.com,Analog Circuit Design manager,8128,1944,10072
2122,Lyndell,Hallihan,lhallihan6b@answers.com,Marketing Manager,4504,1347,5851
2428,Rayna,Paine,rpaine6c@utexas.edu,General Manager,2673,1652,4325
2974,Moria,Fraine,mfraine6d@wikia.com,Analog Circuit Design manager,1360,860,2220
2379,Gordan,Biles,gbiles6e@npr.org,Teacher,3813,505,4318
2095,Cinda,Beazer,cbeazer6f@wunderground.com,Engineer III,7498,985,8483
2548,Nissie,Fomichyov,nfomichyov6h@alexa.com,Analyst Programmer,9157,621,9778
2885,Nara,O'Kane,nokane6i@nationalgeographic.com,Research Assistant IV,4959,1620,6579
2558,Chandra,Escott,cescott6k@pagesperso-orange.fr,Software Consultant,8662,1228,9890
2350,Shep,Husthwaite,shusthwaite6l@cdc.gov,Human Resources Assistant III,6985,943,7928
2814,Erek,Rigts,erigts6m@google.co.uk,GIS Technical Architect,1007,1671,2678
2503,Merrili,Adrianello,madrianello6n@walmart.com,Junior Executive,2455,1667,4122
2942,Derick,Staker,dstaker6o@sciencedaily.com,Data Coordiator,9320,1364,10684
2321,Charles,Boyford,cboyford6p@utexas.edu,Speech Pathologist,1890,1027,2917
2457,Franchot,Self,fself6q@people.com.cn,Environmental Tech,2999,971,3970
2496,Edmund,Ucchino,eucchino6r@prlog.org,Administrative Assistant III,2794,1473,4267
2551,Kurtis,Scurlock,kscurlock6s@goo.ne.jp,Technical Writer,9618,696,10314
2821,Oneida,Weildish,oweildish6t@apache.org,Office Assistant I,1338,1140,2478
2900,Karly,Dargue,kdargue6u@yahoo.co.jp,Environmental Specialist,8765,960,9725
2788,Janifer,Sposito,jsposito6v@china.com.cn,Biostatistician IV,1088,835,1923
2491,Christoffer,Roberto,croberto6w@ihg.com,Sales Associate,5320,1333,6653
2888,Emmalyn,Lamort,elamort6x@census.gov,Software Engineer II,9726,1817,11543
2216,Harcourt,Nealand,hnealand71@jigsy.com,Office Assistant II,1582,1466,3048
2373,Lilyan,Sheringham,lsheringham73@hp.com,Design Engineer,6478,527,7005
2869,Freda,Badam,fbadam74@t.co,Account Executive,7979,1444,9423
2128,Ricki,Messum,rmessum75@oracle.com,Professor,7411,1839,9250
2773,Ashia,Halhead,ahalhead76@vinaora.com,Pharmacist,7629,1702,9331
2647,Peggy,Mullard,pmullard78@e-recht24.de,Analyst Programmer,9100,571,9671
2742,Melanie,Batters,mbatters79@delicious.com,Technical Writer,4127,1496,5623
2347,Hugh,De Malchar,hdemalchar7b@xing.com,Registered Nurse,8887,314,9201
2519,Roberto,Coorington,rcoorington7c@eepurl.com,Tax Accountant,2375,1920,4295
2222,Harcourt,Musto,hmusto7d@google.it,Safety Technician IV,5218,1085,6303
2518,Mohammed,Wrankling,mwrankling7e@nymag.com,Sales Associate,3809,848,4657
2731,Wynn,Marunchak,wmarunchak7f@godaddy.com,VP Product Management,3579,1936,5515
2963,Vivia,Brownlow,vbrownlow7g@ovh.net,Analog Circuit Design manager,4782,778,5560
2956,Nat,Baggot,nbaggot7h@rambler.ru,Geologist II,9678,1323,11001
2104,Maxie,Londsdale,mlondsdale7i@webs.com,Geologist I,9083,1080,10163
2209,Andre,Haggerston,ahaggerston7j@1688.com,Geological Engineer,3506,1973,5479
2857,Dorothy,Miettinen,dmiettinen7k@geocities.jp,Marketing Assistant,9073,1732,10805
2298,Marigold,Dallaway,mdallaway7l@springer.com,Geologist II,2340,1127,3467
2607,Marco,Wixey,mwixey7o@msu.edu,Financial Analyst,9462,877,10339
2632,Vitoria,Posselt,vposselt7p@timesonline.co.uk,Graphic Designer,9769,1726,11495
2294,Darrelle,Gilogly,dgilogly7r@tmall.com,Programmer II,5473,1582,7055
2592,Jedd,Sansbury,jsansbury7u@odnoklassniki.ru,VP Quality Control,2341,1240,3581
2332,Camel,Seth,cseth7v@exblog.jp,Civil Engineer,1477,1385,2862
2875,Heinrick,Dalgetty,hdalgetty7w@example.com,Physical Therapy Assistant,7592,784,8376
2733,Fiona,Cheke,fcheke7x@answers.com,Statistician II,9541,1627,11168
2673,Tatiania,Bletcher,tbletcher7y@ucsd.edu,Pharmacist,3159,1164,4323
2156,Othella,Chasmer,ochasmer7z@adobe.com,Automation Specialist III,5092,620,5712
2153,Allistir,Sirman,asirman80@tiny.cc,Software Test Engineer I,9049,1339,10388
2064,Rodolph,Quesne,rquesne81@acquirethisname.com,Data Coordiator,8937,642,9579
2360,Aylmer,Barratt,abarratt82@hhs.gov,Research Nurse,9540,455,9995
2506,Victoir,Dansie,vdansie83@instagram.com,VP Accounting,7999,856,8855
2424,Jens,Assiratti,jassiratti84@cbslocal.com,Nuclear Power Engineer,8374,490,8864
2634,Onfre,Houltham,ohoultham86@jalbum.net,General Manager,8863,760,9623
2369,Odetta,Drayn,odrayn87@howstuffworks.com,Tax Accountant,7967,526,8493
2740,Carmelina,Jizhaki,cjizhaki8a@biblegateway.com,Accountant IV,1516,861,2377
2568,Brocky,O'Toole,botoole8d@lycos.com,Nurse Practicioner,1357,293,1650
2573,Baudoin,Swinyard,bswinyard8e@elegantthemes.com,Recruiting Manager,6659,1468,8127
2142,Hannis,Wilfing,hwilfing8l@list-manage.com,Structural Analysis Engineer,4098,1846,5944
2585,Rubia,Antuk,rantuk8m@columbia.edu,Senior Sales Associate,1178,227,1405
2304,Lennard,Gillease,lgillease8n@dion.ne.jp,Senior Sales Associate,3082,739,3821
2933,Druci,Bwy,dbwy8o@altervista.org,Data Coordiator,3142,276,3418
2071,Yolanthe,Tambling,ytambling8q@booking.com,Senior Sales Associate,7837,591,8428
2442,Sidonia,Lilliman,slilliman8r@cargocollective.com,Project Manager,2556,400,2956
2371,Teodora,Silverson,tsilverson8s@angelfire.com,Community Outreach Specialist,4273,633,4906
2488,Ashia,Brandreth,abrandreth8t@shop-pro.jp,Legal Assistant,3403,543,3946
2896,Nathalie,Morfett,nmorfett8u@weibo.com,Food Chemist,2274,662,2936
2967,Cicily,Drinkel,cdrinkel8w@springer.com,Quality Control Specialist,5607,688,6295
2468,Tess,Wainer,twainer8z@ebay.co.uk,Paralegal,2677,993,3670
2196,Avivah,Gobbet,agobbet90@columbia.edu,Senior Cost Accountant,6666,1003,7669
2358,Cherin,Fretson,cfretson91@ca.gov,Sales Associate,8746,484,9230
2158,Sashenka,Twist,stwist92@who.int,Assistant Media Planner,3386,1274,4660
2204,Trace,Aggs,taggs95@prlog.org,Junior Executive,6999,1605,8604
2174,Zenia,Hamper,zhamper96@indiegogo.com,Payment Adjustment Coordinator,2441,1552,3993
2667,Alic,Alexandrou,aalexandrou97@jugem.jp,Human Resources Manager,1919,276,2195
2366,Twila,Noor,tnoor98@pen.io,Paralegal,2246,261,2507
2831,Stephen,Gowers,sgowers99@tripod.com,Information Systems Manager,4711,955,5666
2545,Sherilyn,Harbar,sharbar9b@phoca.cz,Senior Quality Engineer,2347,254,2601
2646,Cris,Pernell,cpernell9c@g.co,Human Resources Assistant II,9806,291,10097
2724,Peri,Walpole,pwalpole9d@oracle.com,Account Representative III,9082,862,9944
2649,Genna,Salmoni,gsalmoni9e@simplemachines.org,Research Nurse,4464,1158,5622
2086,Cindi,Hurdis,churdis9g@dell.com,Computer Systems Analyst I,3892,1683,5575
2280,Keith,Kinastan,kkinastan9h@yahoo.com,Assistant Media Planner,9163,1327,10490
2633,Wilmer,Francklyn,wfrancklyn9i@senate.gov,Legal Assistant,4127,1951,6078
2979,Lissy,Daile,ldaile9j@icq.com,Accountant I,4522,1261,5783
2859,Vivia,Honnan,vhonnan9l@mediafire.com,Recruiter,4443,269,4712
2045,Maire,Haydock,mhaydock9n@e-recht24.de,Dental Hygienist,7585,648,8233
2172,Susana,Goane,sgoane9o@people.com.cn,Safety Technician III,6564,769,7333
2976,Hymie,Hamfleet,hhamfleet9p@craigslist.org,Help Desk Technician,2787,365,3152
2960,Judye,Chattington,jchattington9q@usnews.com,Financial Analyst,6722,443,7165
2901,Gladi,Claybourne,gclaybourne9r@lulu.com,Financial Analyst,4574,431,5005
2322,Noach,Bonas,nbonas9s@prlog.org,Occupational Therapist,8235,1660,9895
2296,Brewster,Murtimer,bmurtimer9t@latimes.com,Pharmacist,5646,1661,7307
2587,Shirl,Sorensen,ssorensen9u@last.fm,Safety Technician III,7257,1120,8377
2242,Lindsay,Storck,lstorck9x@ycombinator.com,Operator,7129,1036,8165
2082,Tarrah,MacTrustie,tmactrustie9y@dot.gov,Dental Hygienist,4016,557,4573
2772,Dalenna,Bullard,dbullard9z@wikispaces.com,Biostatistician I,1224,694,1918
2656,Aurlie,Barford,abarforda1@yelp.com,Accounting Assistant II,2851,739,3590
2241,Augustina,Carolan,acarolana2@theguardian.com,Compensation Analyst,1264,565,1829
2672,Izabel,Pietrowski,ipietrowskia3@photobucket.com,Actuary,7309,496,7805
2939,Denis,Tomney,dtomneya4@mail.ru,Community Outreach Specialist,6702,1836,8538
2971,Ellissa,Braine,ebrainea6@mapquest.com,Design Engineer,1228,767,1995
2106,Jakie,Morin,jmorina7@about.com,Information Systems Manager,9457,496,9953
2591,Arnold,Nickell,anickella8@ca.gov,Office Assistant IV,6526,1899,8425
2127,Carlina,Adcock,cadcocka9@uiuc.edu,Cost Accountant,2847,1726,4573
2278,Debbie,Dawbury,ddawburyaa@live.com,Programmer Analyst I,8386,592,8978
2344,Jonathan,Stranaghan,jstranaghanab@multiply.com,Internal Auditor,8142,1924,10066
2932,Kilian,Halliberton,khallibertonaf@gizmodo.com,Chemical Engineer,5405,694,6099
2721,Farlee,Tidgewell,ftidgewellah@altervista.org,Media Manager I,7693,1267,8960
2055,Marielle,Mattys,mmattysai@theglobeandmail.com,Graphic Designer,2089,487,2576
2316,Valentine,Kuhle,vkuhleal@statcounter.com,Senior Financial Analyst,3636,473,4109
2315,Auguste,McParlin,amcparlinam@facebook.com,Junior Executive,2604,1574,4178
2419,Francklin,Pieracci,fpieracciap@vimeo.com,Financial Analyst,5753,871,6624
2605,Olenolin,Bytheway,obythewayaq@ftc.gov,Senior Financial Analyst,8243,1707,9950
2825,Trever,Hadfield,thadfieldar@bluehost.com,Social Worker,4823,1630,6453
2194,Darlleen,Fearnyough,dfearnyoughas@paypal.com,Physical Therapy Assistant,1860,1733,3593
2907,Martainn,Hobson,mhobsonat@mozilla.org,Systems Administrator II,3039,1355,4394
2554,Aeriell,Jarley,ajarleyav@163.com,Account Coordinator,9663,869,10532
2426,Jayme,Delnevo,jdelnevoaw@skyrock.com,Desktop Support Technician,3731,897,4628
2030,Emmanuel,Swepstone,eswepstoneax@imageshack.us,Assistant Professor,6679,259,6938
2012,Felic,Thorington,fthoringtonay@mapquest.com,Operator,6358,1654,8012
2546,Gasper,Nozzolii,gnozzoliiaz@mayoclinic.com,Physical Therapy Assistant,9243,1091,10334
2328,Carrie,Terrey,cterreyb0@dion.ne.jp,Food Chemist,2070,632,2702
2077,Marya,Pearlman,mpearlmanb1@unicef.org,Web Developer III,9719,1617,11336
2780,Nike,Cattermoul,ncattermoulb2@zimbio.com,Senior Financial Analyst,7979,1021,9000
2861,Sammie,Nunes Nabarro,snunesnabarrob3@zimbio.com,Automation Specialist I,1204,633,1837
2363,Silvano,Roddick,sroddickb4@hud.gov,Teacher,7642,1626,9268
2781,Randene,Dandison,rdandisonb5@sitemeter.com,VP Marketing,9996,1859,11855
2050,Eve,Fibbens,efibbensb6@dmoz.org,Engineer IV,7281,250,7531
2631,Katleen,Goulbourn,kgoulbournb8@com.com,Research Nurse,6565,1809,8374
2480,Jeri,Ahrenius,jahreniusb9@youku.com,Structural Engineer,2823,1141,3964
2188,Brandea,Slate,bslateba@last.fm,Research Associate,3354,1018,4372
2844,Derward,Huriche,dhurichebb@dyndns.org,Assistant Manager,5810,1776,7586
2059,Jori,Frostick,jfrostickbc@posterous.com,Automation Specialist III,8806,1472,10278
2612,Fanya,Whitley,fwhitleybe@vinaora.com,Accountant I,2173,1485,3658
2092,Clayson,Flucker,cfluckerbg@nydailynews.com,Systems Administrator I,7811,674,8485
2430,Tiffani,Terren,tterrenbh@w3.org,Nurse Practicioner,7462,1750,9212
2154,Chas,Bowcock,cbowcockbi@mapy.cz,Structural Analysis Engineer,7274,203,7477
2165,Lemmie,Sidnell,lsidnellbj@deviantart.com,Assistant Professor,5626,1101,6727
2929,Elyn,Bradman,ebradmanbl@sciencedaily.com,Sales Associate,6889,679,7568
2409,Nevsa,Bruton,nbrutonbo@nih.gov,Director of Sales,9291,909,10200
2079,Tillie,Quin,tquinbr@mediafire.com,Statistician I,7990,868,8858
2213,Myrtia,Zupone,mzuponebs@ezinearticles.com,Quality Control Specialist,9308,446,9754
2890,Vassily,Scholl,vschollbt@chronoengine.com,Registered Nurse,6342,1345,7687
2615,Vannie,Viscovi,vviscovibz@spiegel.de,Software Test Engineer IV,6560,727,7287
2189,Helga,Shoebotham,hshoebothamc2@tinyurl.com,Product Engineer,5382,922,6304
2762,Seka,Bault,sbaultc3@flickr.com,Clinical Specialist,4197,1908,6105
2221,Tammi,Marmyon,tmarmyonc4@topsy.com,Help Desk Technician,2245,453,2698
2798,Randolph,Lerwell,rlerwellc6@a8.net,Human Resources Assistant III,9941,296,10237
2741,Emory,Babb,ebabbc7@tiny.cc,Geologist III,3108,847,3955
2024,Vachel,Brisson,vbrissonc9@technorati.com,Research Associate,6272,1414,7686
2323,Margeaux,Bemwell,mbemwellcb@etsy.com,Physical Therapy Assistant,2812,312,3124
2375,Kayne,Urien,kuriencc@japanpost.jp,Programmer I,8611,1889,10500
2653,Philis,Mattschas,pmattschascd@tinyurl.com,Mechanical Systems Engineer,9253,580,9833
2959,Beauregard,Jeffs,bjeffscf@google.co.jp,VP Sales,1983,754,2737
2845,Dietrich,Bednell,dbednellcg@engadget.com,Analyst Programmer,4823,569,5392
2224,Shellysheldon,Cham,schamci@bigcartel.com,General Manager,4381,872,5253
2582,Tybi,Leggs,tleggscj@sogou.com,Administrative Officer,8668,1092,9760
2182,Elston,Fowell,efowellcl@forbes.com,Web Designer II,5941,1570,7511
2847,Shaylynn,Teague,steaguecm@hhs.gov,Account Coordinator,9613,1438,11051
2625,Wallace,Jorin,wjorincn@squarespace.com,Geologist II,6627,1549,8176
2819,Lazare,Pieracci,lpieraccico@ovh.net,Electrical Engineer,6608,1285,7893
2977,Ibby,Dumblton,idumbltoncq@kickstarter.com,Electrical Engineer,4481,541,5022
2711,Estevan,Kearley,ekearleycr@fastcompany.com,Account Coordinator,5275,1090,6365
2830,Danila,Corkill,dcorkillcs@dell.com,Quality Control Specialist,3706,506,4212
2331,Trixi,Gandar,tgandarct@gravatar.com,VP Product Management,6361,781,7142
2330,Edna,Stedall,estedallcu@youtube.com,Administrative Assistant I,6157,779,6936
2923,Kelli,Sivills,ksivillscv@i2i.jp,Senior Editor,9638,1579,11217
2130,Modestine,Howbrook,mhowbrookcz@icio.us,Senior Developer,2660,1326,3986
2985,Ingra,Paliser,ipaliserd1@shutterfly.com,Quality Engineer,7973,1271,9244
2357,Taddeusz,Dark,tdarkd4@army.mil,Senior Financial Analyst,7073,1649,8722
2595,Brett,Deniscke,bdeniscked6@reverbnation.com,Project Manager,1537,1646,3183
2354,Sibby,Formigli,sformiglid7@skyrock.com,Technical Writer,6098,344,6442
2994,Daniela,Olivella,dolivellad8@engadget.com,Software Consultant,1587,1503,3090
2118,Kaitlyn,Fraine,kfrained9@sphinn.com,Research Associate,7385,1937,9322
2451,Budd,Heeran,bheeranda@tinypic.com,Teacher,3633,659,4292
2513,Darryl,Oran,dorandc@barnesandnoble.com,Human Resources Assistant IV,5659,1623,7282
2998,Bron,Hirjak,bhirjakdd@cyberchimps.com,Quality Control Specialist,2440,1903,4343
2964,Maudie,Till,mtilldi@g.co,Budget/Accounting Analyst II,4567,526,5093
2083,Anders,Wyper,awyperdj@prnewswire.com,Compensation Analyst,5705,333,6038
2303,Christan,Quantick,cquantickdo@t.co,Operator,1720,1715,3435
2395,Ronalda,Ginty,rgintydp@statcounter.com,Information Systems Manager,9289,440,9729
2396,Amelie,Geering,ageeringdq@posterous.com,VP Accounting,6047,203,6250
2408,Willy,Scurrah,wscurrahdr@multiply.com,VP Marketing,2688,380,3068
2511,Shurlock,Goscar,sgoscardu@cisco.com,Staff Accountant IV,2096,1908,4004
2951,Anatola,Kestell,akestelldw@abc.net.au,Junior Executive,6116,1474,7590
2102,Laurice,Gibke,lgibkedy@dailymotion.com,Systems Administrator IV,4637,1241,5878
2966,Claus,Ingley,cingleydz@salon.com,Media Manager IV,9916,1520,11436
2349,Bari,Annear,banneare0@stumbleupon.com,Assistant Professor,1051,723,1774
2173,Jeanine,Baison,jbaisone1@reuters.com,Assistant Manager,4699,1167,5866
2250,Mannie,Innman,minnmane3@businessweek.com,Account Coordinator,3844,326,4170
2120,Edward,Fenne,efennee6@digg.com,Actuary,8477,1231,9708
2771,Rafaela,Danshin,rdanshine9@vkontakte.ru,Desktop Support Technician,9247,775,10022
2486,Jesus,Draude,jdraudeea@php.net,Nurse,3849,756,4605
2965,Shellysheldon,Dahlback,sdahlbackeb@jimdo.com,Geological Engineer,5438,558,5996
2423,Murdoch,Andrusov,mandrusoved@huffingtonpost.com,Financial Analyst,3423,1029,4452
2179,Tomasina,Jemmison,tjemmisonef@csmonitor.com,Help Desk Operator,2692,708,3400
2051,Allen,Freezer,afreezereg@yahoo.com,Operator,8277,676,8953
2498,Shandra,Chadwin,schadwinei@nih.gov,Biostatistician IV,8673,1295,9968
2593,Halie,Wharrier,hwharrierej@bluehost.com,Dental Hygienist,4304,1687,5991
2823,Rowen,Urrey,rurreyen@hubpages.com,Payment Adjustment Coordinator,5929,912,6841
2660,Nicki,Seine,nseineep@vinaora.com,Administrative Officer,6706,870,7576
2318,Eugen,Henrionot,ehenrionoteq@discovery.com,Engineer IV,9636,928,10564
2105,Lydie,Hefforde,lheffordees@hubpages.com,Systems Administrator I,9363,641,10004
2402,Dexter,Ohlsen,dohlsenet@dyndns.org,Analog Circuit Design manager,5893,1007,6900
2124,Jaime,Dalliwater,jdalliwaterev@bandcamp.com,Marketing Assistant,1496,1456,2952
2803,Brier,Arling,barlingew@princeton.edu,VP Accounting,6550,1719,8269
2763,Lotti,Hammel,lhammeley@ucla.edu,Graphic Designer,3998,399,4397
2359,Gabriel,Reggiani,greggianif1@earthlink.net,Nuclear Power Engineer,2209,1457,3666
2508,Dodi,Waddoups,dwaddoupsf2@phpbb.com,Safety Technician II,9540,1747,11287
2983,Kirk,Wilsee,kwilseef5@rediff.com,Statistician III,7596,1068,8664
2116,Layton,Gomer,lgomerf9@zimbio.com,Clinical Specialist,2676,1871,4547
2856,Law,Figg,lfiggfa@ucoz.ru,Business Systems Development Analyst,4957,863,5820
2201,Drusie,Ellerington,delleringtonfb@goo.ne.jp,Executive Secretary,9668,1228,10896
2683,Monah,Hainge,mhaingefd@sakura.ne.jp,Account Representative III,8291,1542,9833
2538,Saxe,Mackieson,smackiesonfe@hud.gov,Financial Advisor,4098,1196,5294
2444,Berni,Ornelas,bornelasff@hc360.com,Associate Professor,1057,1031,2088
2867,Zechariah,Fagence,zfagencefh@upenn.edu,Senior Quality Engineer,2749,288,3037
2652,Charin,Condit,cconditfi@elpais.com,Sales Representative,9444,597,10041
2232,Hester,MacAllen,hmacallenfm@networksolutions.com,Occupational Therapist,9479,526,10005
2560,Tamiko,Tolchard,ttolchardfp@ucoz.ru,Assistant Media Planner,3187,1374,4561
2617,Ailee,Luckham,aluckhamfq@rakuten.co.jp,Quality Engineer,7317,1914,9231
2953,Josefa,Agnolo,jagnolofr@edublogs.org,Analog Circuit Design manager,3385,1231,4616
2572,Fanya,Godin,fgodinfs@meetup.com,Compensation Analyst,2108,212,2320
2013,Evie,Blint,eblintfw@cnet.com,Sales Representative,1680,1143,2823
2761,Sydel,Gilbank,sgilbankfx@blogtalkradio.com,Human Resources Assistant II,7156,1492,8648
2391,Lenci,Lydford,llydfordfz@tuttocitta.it,General Manager,1368,373,1741
2517,Ariel,Dumingo,adumingog3@ehow.com,Occupational Therapist,8048,1124,9172
2094,Viviana,Jalland,vjallandg5@gizmodo.com,Administrative Assistant I,4108,1637,5745
2475,Brittaney,McLaughlin,bmclaughling6@samsung.com,Financial Advisor,8331,311,8642
2714,Upton,Conrath,uconrathga@globo.com,Account Representative III,1356,518,1874
2880,Guillermo,Habert,ghabertge@unblog.fr,Community Outreach Specialist,2710,762,3472
2529,Sharia,Garretts,sgarrettsgh@so-net.ne.jp,Junior Executive,7884,634,8518
2504,Babbie,Konertz,bkonertzgk@google.com.hk,Editor,3637,1183,4820
2699,Juieta,Pollington,jpollingtongl@prweb.com,Staff Accountant I,7957,1402,9359
2367,Elise,Purbrick,epurbrickgm@army.mil,Compensation Analyst,3895,1698,5593
2671,Eileen,Dankov,edankovgn@disqus.com,Physical Therapy Assistant,5591,1906,7497
2143,Robert,Butchers,rbutchersgp@unc.edu,VP Quality Control,1952,624,2576
2642,Lynnet,Ellwell,lellwellgs@mapquest.com,Senior Quality Engineer,6829,754,7583
2614,Helsa,Halcro,hhalcrogu@drupal.org,VP Marketing,8354,1132,9486
2868,Alyosha,Wilmot,awilmotgv@godaddy.com,Junior Executive,5750,401,6151
2169,Hashim,Curwen,hcurwengy@furl.net,Electrical Engineer,4421,1549,5970
2692,Albina,Murrill,amurrillgz@skyrock.com,Senior Developer,4882,1838,6720
2501,Rick,Cunney,rcunneyh1@rakuten.co.jp,Health Coach II,6120,1520,7640
2160,Riobard,Arter,rarterh4@npr.org,Recruiting Manager,2098,1296,3394
2600,Oona,MacLeese,omacleeseh5@nps.gov,Safety Technician II,9467,1885,11352
2208,Martguerita,Menary,mmenaryh6@ft.com,Quality Engineer,7227,1713,8940
2043,Kylie,Burkart,kburkartha@youtube.com,Computer Systems Analyst I,5974,729,6703
2718,Loy,Crippen,lcrippenhe@xrea.com,Nuclear Power Engineer,4191,1049,5240
2101,Boris,Argabrite,bargabritehg@state.tx.us,Design Engineer,7755,855,8610
2516,Sherilyn,MacGraith,smacgraithhm@hao123.com,Director of Sales,3893,1201,5094
2500,Ardys,Bagley,abagleyhq@netvibes.com,Environmental Specialist,2575,1170,3745
2420,Ben,Chalcroft,bchalcrofthr@linkedin.com,Tax Accountant,1388,424,1812
2689,Kylen,O'Kerin,kokerinhs@army.mil,Senior Developer,1597,453,2050
2088,Virgil,Shiels,vshielshu@businesswire.com,Teacher,8668,1693,10361
2126,Tatiania,Kearsley,tkearsleyhv@cam.ac.uk,Product Engineer,2681,1194,3875
2522,Lorianna,Vaughan-Hughes,lvaughanhughesi0@cam.ac.uk,Structural Engineer,7802,282,8084
2791,Phylis,Tangye,ptangyei2@state.gov,Internal Auditor,1966,892,2858
2525,Jacques,Shone,jshonei5@bloglines.com,Research Assistant III,2887,1199,4086
2919,Wilhelmine,Hendrick,whendricki6@yelp.com,Structural Analysis Engineer,9974,409,10383
2584,Nancey,Adamo,nadamoi8@unesco.org,Marketing Manager,6456,430,6886
2729,Gustaf,Kaesmans,gkaesmansia@umich.edu,Financial Analyst,3542,1712,5254
2117,Mikael,Kaley,mkaleyib@cmu.edu,Administrative Assistant II,8984,461,9445
2720,Manda,Grafton,mgraftonic@aboutads.info,Environmental Specialist,3965,1368,5333
2677,Hinda,Lucks,hlucksie@plala.or.jp,General Manager,3691,1962,5653
2879,Cordula,Durnin,cdurninif@newyorker.com,Geologist IV,4601,357,4958
2961,Burch,Batchelder,bbatchelderih@theglobeandmail.com,VP Product Management,3430,1368,4798
2739,Sunshine,Lettice,sletticeij@ameblo.jp,Developer II,2661,1901,4562
2181,Winne,Gillhespy,wgillhespyik@webnode.com,Account Representative II,7051,1387,8438
2758,Nissa,Inman,ninmanim@cbsnews.com,Staff Accountant III,4758,1755,6513
2800,Gabriel,Cardinale,gcardinalein@geocities.com,Data Coordiator,5345,1712,7057
2770,Oliy,Errowe,oerroweio@friendfeed.com,Geologist I,4159,1624,5783
2069,Ash,Mariotte,amariotteip@miibeian.gov.cn,Cost Accountant,4282,873,5155
2134,Wilek,Nesbit,wnesbitiq@opensource.org,Senior Editor,2380,1755,4135
2883,Abbe,Glencrash,aglencrashir@seattletimes.com,Director of Sales,5964,253,6217
2078,Alaine,Fipp,afippis@cpanel.net,Accountant II,2214,591,2805
2103,Danica,Yegorshin,dyegorshiniu@dmoz.org,Analog Circuit Design manager,1218,1655,2873
2060,Suzann,Rego,sregoiz@google.com.br,Engineer I,1768,581,2349
2262,Gal,Spira,gspiraj0@jugem.jp,Automation Specialist III,4306,755,5061
2320,Adrea,Hudghton,ahudghtonj2@g.co,Senior Editor,5144,799,5943
2752,Deeyn,Amor,damorj3@omniture.com,Actuary,2582,1685,4267
2407,Tove,Hamblett,thamblettj6@etsy.com,Speech Pathologist,1953,1828,3781
2826,Bron,Colbrun,bcolbrunjb@ucoz.ru,Legal Assistant,5679,1091,6770
2446,Berrie,Size,bsizejc@mail.ru,Web Developer III,5300,1412,6712
2725,Laurice,Andress,landressjd@howstuffworks.com,Sales Representative,3549,1935,5484
2887,Bernita,Butter,bbutterje@stumbleupon.com,Senior Cost Accountant,9467,1853,11320
2002,Angy,Joice,ajoicejf@nymag.com,Editor,1141,736,1877
2164,Jaime,Cullivan,jcullivanjg@wsj.com,Accountant II,6439,474,6913
2938,Bentley,Barnby,bbarnbyjh@delicious.com,Recruiting Manager,9918,1659,11577
2111,Frederica,Carette,fcaretteji@scientificamerican.com,Senior Quality Engineer,6799,1609,8408
2601,Kasey,Grimmolby,kgrimmolbyjj@slideshare.net,GIS Technical Architect,5125,398,5523
2678,Jeffy,Whittam,jwhittamjk@pcworld.com,Computer Systems Analyst III,3823,1852,5675
2786,Grazia,Late,glatejl@arstechnica.com,Speech Pathologist,4144,1913,6057
2990,Adan,Sheerin,asheerinjn@cam.ac.uk,Analyst Programmer,3354,344,3698
2936,Mathew,Punyer,mpunyerjo@flavors.me,Speech Pathologist,5034,1178,6212
2801,Mendie,Wareham,mwarehamjp@123-reg.co.uk,Marketing Assistant,3679,995,4674
2096,Antonio,Titford,atitfordjq@sphinn.com,Research Nurse,8865,1938,10803
2810,Adelle,Skough,askoughjr@bbc.co.uk,Help Desk Operator,2393,1361,3754
2157,Myrtie,Vannuccinii,mvannucciniijt@t-online.de,Web Developer II,9920,1291,11211
2808,Jo-ann,Onions,jonionsju@arstechnica.com,Product Engineer,4672,1982,6654
2276,Devonne,Tremoille,dtremoillejx@arstechnica.com,VP Quality Control,3565,485,4050
2619,Maggee,Bramhall,mbramhalljz@google.es,Payment Adjustment Coordinator,3015,1267,4282
2881,Burty,Mollitt,bmollittk0@eepurl.com,Paralegal,7630,1026,8656
2935,Consuela,Dana,cdanak2@scribd.com,Clinical Specialist,3011,1310,4321
2319,Gasparo,Donaher,gdonaherk6@newyorker.com,Compensation Analyst,6665,1555,8220
2958,Lemuel,Slatten,lslattenk8@mac.com,Software Consultant,3221,704,3925
2068,Brande,Snewin,bsnewink9@sciencedaily.com,Quality Engineer,9277,1655,10932
2295,Hewett,Stoakley,hstoakleyka@bloglines.com,Occupational Therapist,4645,1230,5875
2066,Morley,Ewbanche,mewbanchekc@mac.com,General Manager,9729,1594,11323
2471,Guillemette,Dilger,gdilgerke@quantcast.com,Senior Financial Analyst,5960,1427,7387
2284,Aymer,Simonite,asimonitekj@springer.com,Senior Editor,3770,1007,4777
2813,Marguerite,Antat,mantatkl@issuu.com,Information Systems Manager,4841,1260,6101
2233,Briana,Dictus,bdictuskm@edublogs.org,Professor,7867,820,8687
2954,Trever,Chateau,tchateaukq@dmoz.org,Executive Secretary,9124,1240,10364
2926,Corenda,Rozzell,crozzellkr@hp.com,Budget/Accounting Analyst IV,1580,324,1904
2058,Ema,Barbera,ebarberaks@ed.gov,Assistant Media Planner,8064,1214,9278
2688,Emory,Brisker,ebriskerkt@list-manage.com,Office Assistant II,4500,1743,6243
2159,Ambrose,Lyddiatt,alyddiattku@amazon.co.uk,Account Coordinator,3589,1754,5343
2414,Josselyn,Rosina,jrosinakw@feedburner.com,Compensation Analyst,4222,1055,5277
2484,Christina,Brehat,cbrehatl1@youtube.com,Professor,4927,561,5488
2146,Adham,Starie,astariel3@loc.gov,Paralegal,9861,260,10121
2533,Idaline,Gazzard,igazzardl5@linkedin.com,Electrical Engineer,9175,1655,10830
2061,Penny,McKeurtan,pmckeurtanl9@biglobe.ne.jp,Chief Design Engineer,5749,1106,6855
2694,Kassi,Waby,kwabyla@acquirethisname.com,Analog Circuit Design manager,2083,563,2646
2822,Nappie,Stenson,nstensonlb@drupal.org,Community Outreach Specialist,8229,739,8968
2913,Flossy,Risen,frisenlf@chronoengine.com,Associate Professor,8897,1965,10862
2161,Tracee,Densumbe,tdensumbelg@google.ru,Research Associate,1024,1011,2035
2897,Millicent,Deverell,mdeverelllh@intel.com,VP Sales,7538,664,8202
2227,Mollie,Lequeux,mlequeuxlj@si.edu,Staff Scientist,3485,1571,5056
2659,Keir,McBryde,kmcbrydell@weibo.com,Software Test Engineer IV,7795,1926,9721
2236,Lorenza,Corsar,lcorsarlm@stanford.edu,Research Associate,1157,1606,2763
2135,Ruperto,Davitti,rdavittilo@storify.com,Software Engineer III,5181,450,5631
2776,Karlotte,Claige,kclaigelp@hp.com,Technical Writer,9805,1877,11682
2339,Rog,Filipputti,rfilipputtilq@last.fm,Automation Specialist III,8890,213,9103
2789,Caralie,Beedle,cbeedlelr@topsy.com,Administrative Officer,2099,1744,3843
2759,Arlen,Stampe,astampels@aol.com,Nuclear Power Engineer,6871,1555,8426
2317,Elfreda,Goaks,egoakslx@slideshare.net,Recruiting Manager,3333,1376,4709
2630,Gipsy,Mariotte,gmariottely@w3.org,Financial Analyst,5150,268,5418
2219,Anastasia,Stidworthy,astidworthylz@mysql.com,Graphic Designer,7343,745,8088
2125,Harman,Polye,hpolyem0@e-recht24.de,Executive Secretary,8494,1812,10306
2945,Luigi,Putland,lputlandm1@tuttocitta.it,VP Accounting,4222,1654,5876
2226,Vaclav,Poundsford,vpoundsfordm2@google.it,Research Assistant III,6831,1405,8236
2212,Laurena,Dreghorn,ldreghornm3@tumblr.com,Environmental Specialist,8167,1536,9703
2195,Beck,Hamson,bhamsonm4@nba.com,Staff Accountant I,4606,1209,5815
2787,Cindra,Popland,cpoplandm6@bbb.org,Associate Professor,4904,1493,6397
2655,Lowell,Towsie,ltowsiem7@guardian.co.uk,Mechanical Systems Engineer,3006,1754,4760
2048,Alford,Espada,aespadam8@arstechnica.com,Engineer I,8390,1491,9881
2185,Hephzibah,Landrean,hlandreanm9@ucoz.com,Developer I,4795,863,5658
2199,Ambrosi,MacDowall,amacdowallme@va.gov,Staff Accountant IV,8113,912,9025
2305,Flor,Ride,fridemf@nydailynews.com,Senior Editor,6445,552,6997
2474,Hadlee,Dunsire,hdunsiremg@mapy.cz,Pharmacist,9855,1750,11605
2502,Crin,Dunbar,cdunbarmh@blogger.com,Software Test Engineer IV,9421,803,10224
2509,Ruperto,Aleveque,ralevequemi@blogtalkradio.com,Marketing Manager,3677,1918,5595
2834,Phillipe,Dark,pdarkml@domainmarket.com,Chemical Engineer,9116,1312,10428
2991,Valry,Dodd,vdoddmm@java.com,Budget/Accounting Analyst III,9728,781,10509
2952,Yulma,Blunt,ybluntmo@theguardian.com,Computer Systems Analyst IV,8929,1137,10066
2378,Jeremy,Schuricke,jschurickemr@discovery.com,Developer III,3194,1991,5185
2355,Mariska,Standage,mstandagemv@meetup.com,VP Product Management,1581,1720,3301
2840,Christina,Bowskill,cbowskillmw@liveinternet.ru,Dental Hygienist,2386,694,3080
2255,Weidar,Chantillon,wchantillonmx@admin.ch,Librarian,4597,1907,6504
2873,Wat,Lemmanbie,wlemmanbien0@apache.org,Web Designer IV,4625,1540,6165
2085,Serena,Maitland,smaitlandn1@si.edu,Programmer Analyst I,3667,312,3979
2833,Mae,Doeg,mdoegn4@exblog.jp,Physical Therapy Assistant,4744,1762,6506
2353,Karen,Langfat,klangfatn7@wufoo.com,Actuary,7477,1185,8662
2148,Corrinne,Oddie,coddien9@cocolog-nifty.com,Account Executive,1472,1022,2494
2166,Hervey,Davis,hdavisna@e-recht24.de,Occupational Therapist,4984,555,5539
2021,Reilly,Alywen,ralywennb@google.com,Food Chemist,6523,1089,7612
2662,Cristabel,Ellacombe,cellacombenc@statcounter.com,Safety Technician II,2899,517,3416
2782,Layne,Freer,lfreernd@google.co.jp,Legal Assistant,4276,1287,5563
2074,Rodie,McVanamy,rmcvanamyng@google.ca,Media Manager IV,7232,1517,8749
2937,Kile,Dondon,kdondonni@noaa.gov,Physical Therapy Assistant,2671,1143,3814
2072,Stavros,McMeanma,smcmeanmank@mit.edu,Analyst Programmer,9617,1373,10990
2441,Janenna,Humphery,jhumpherynp@nsw.gov.au,Software Consultant,6369,259,6628
2722,Madelena,Cunde,mcundens@reuters.com,Pharmacist,3096,1806,4902
2007,Antoinette,Trunchion,atrunchionnt@wunderground.com,Assistant Media Planner,7036,1198,8234
2778,Correy,Ort,cortnv@wiley.com,Geological Engineer,1547,1597,3144
2997,Siward,Bradburne,sbradburnenw@ebay.com,Quality Engineer,5947,1810,7757
2908,Anabel,Staries,astariesnx@cargocollective.com,Director of Sales,8062,1161,9223
2799,Kelsey,Lysons,klysonsny@hexun.com,Statistician I,5688,1589,7277
2767,Jany,Coggles,jcoggleso0@cdc.gov,Research Associate,9668,1189,10857
2583,Amye,Odam,aodamo1@yale.edu,Developer II,5449,1579,7028
2370,Deni,Aberkirder,daberkirdero3@prweb.com,Electrical Engineer,7884,1329,9213
2986,Davis,Heibl,dheiblo4@squarespace.com,Senior Developer,1716,1989,3705
2853,Paulie,Sainer,psainero5@wikispaces.com,Quality Control Specialist,2843,1098,3941
2244,Mariquilla,Gwyer,mgwyero7@wix.com,GIS Technical Architect,6153,1049,7202
2611,Billye,Stansbie,bstansbieoa@dailymail.co.uk,Community Outreach Specialist,5314,754,6068
2481,Hayward,Towsie,htowsieof@dion.ne.jp,Business Systems Development Analyst,4651,1587,6238
2874,Penelope,Gittoes,pgittoesog@bloglovin.com,Librarian,8523,1274,9797
2579,Lockwood,Cavet,lcavetoh@php.net,Accounting Assistant IV,9375,980,10355
2982,Crista,Drover,cdroveroi@twitpic.com,Professor,4866,694,5560
2239,Tatiania,O' Mullan,tomullanol@yelp.com,Biostatistician I,6998,1804,8802
2466,Ange,Bloys,abloysom@guardian.co.uk,Librarian,3205,1453,4658
2269,Annabal,Folomkin,afolomkinon@go.com,Account Coordinator,5729,1739,7468
2309,Grata,Broadey,gbroadeyop@dagondesign.com,VP Product Management,8917,371,9288
2524,Jason,Hauch,jhauchoq@de.vu,Social Worker,7173,266,7439
2287,Pebrook,Braiden,pbraidenos@amazon.co.uk,Human Resources Assistant II,5157,926,6083
2863,Theobald,Durnford,tdurnfordot@jimdo.com,Programmer I,4799,1210,6009
2453,Rowan,Cotty,rcottyow@squidoo.com,Civil Engineer,1894,1967,3861
2238,Erhart,Corbishley,ecorbishleyox@linkedin.com,Media Manager III,7079,1957,9036
2286,Xavier,Gartan,xgartanoz@omniture.com,Business Systems Development Analyst,5493,1112,6605
2374,Rhonda,Meadows,rmeadowsp0@sogou.com,Professor,1286,1820,3106
2175,Sandy,Kupker,skupkerp2@cam.ac.uk,Data Coordiator,6062,1742,7804
2589,Kristos,Oxnam,koxnamp3@ftc.gov,Financial Advisor,9248,1024,10272
2793,Richie,Bemwell,rbemwellp5@prlog.org,General Manager,7932,1417,9349
2987,Cordy,Idel,cidelp6@weather.com,Office Assistant IV,2509,1090,3599
2608,Zarla,Searson,zsearsonp8@ehow.com,Account Executive,3737,505,4242
2032,Jeanine,Rodders,jroddersp9@howstuffworks.com,VP Product Management,1764,222,1986
2944,Calli,Vasenin,cvaseninpc@nyu.edu,Research Associate,6561,371,6932
2052,Erina,Gianolini,egianolinipf@yahoo.co.jp,Structural Engineer,3283,560,3843
2270,Katherine,Christofides,kchristofidespi@dyndns.org,Account Executive,1777,1065,2842
2460,Killy,Chifney,kchifneypk@amazon.com,Geological Engineer,4151,482,4633
2337,Ambrosi,Shaxby,ashaxbypq@wisc.edu,Automation Specialist IV,3360,667,4027
2785,Lenna,Frayling,lfraylingpr@google.it,Internal Auditor,3664,342,4006
2275,Rhea,Enders,renderspw@samsung.com,GIS Technical Architect,5238,354,5592
2261,Hillel,McEttigen,hmcettigenpx@ucsd.edu,Senior Cost Accountant,3566,1816,5382
2514,Olly,Gheeorghie,ogheeorghiepz@sohu.com,Desktop Support Technician,8055,463,8518
2750,Rudolph,Cudmore,rcudmoreq0@histats.com,Programmer IV,1819,1779,3598
2427,Noll,Feldmark,nfeldmarkq1@imgur.com,Paralegal,8690,318,9008
2663,Olenka,Kender,okenderq6@hubpages.com,Speech Pathologist,7800,410,8210
2918,Ashby,Tippin,atippinq7@newyorker.com,Research Associate,7925,1244,9169
2479,Nikkie,Hughland,nhughlandqc@twitter.com,Design Engineer,3601,1068,4669
2709,Joya,Evett,jevettqd@4shared.com,Human Resources Manager,1850,793,2643
2449,Cody,Purselow,cpurselowqe@technorati.com,Staff Scientist,2155,1526,3681
2202,Kimmie,Stockle,kstockleqg@mit.edu,Help Desk Operator,9300,1248,10548
2265,Doralynne,Bastable,dbastableqi@globo.com,Developer III,5573,905,6478
2891,Gibb,Parlott,gparlottqo@a8.net,Automation Specialist III,4294,1125,5419
2433,Gale,Kielt,gkieltqp@scientificamerican.com,Budget/Accounting Analyst III,1657,246,1903
2557,Aloisia,Derges,adergesqq@multiply.com,Engineer III,6817,1794,8611
2251,Serena,Toulch,stoulchqt@gizmodo.com,Account Representative IV,3954,626,4580
2229,Kimble,Cowherd,kcowherdqy@spotify.com,Human Resources Assistant III,7201,497,7698
2594,Bernarr,Haines,bhainesqz@surveymonkey.com,Human Resources Assistant II,8337,1031,9368
2368,Harvey,Morton,hmortonr3@mapy.cz,Assistant Media Planner,7044,1862,8906
2237,Moses,Haistwell,mhaistwellr4@opera.com,Quality Control Specialist,4684,735,5419
2301,Heidi,Grosier,hgrosierr5@oracle.com,Database Administrator IV,9968,838,10806
2854,Lauren,Baxter,lbaxterr8@blogs.com,Physical Therapy Assistant,7081,1273,8354
2348,Vernen,Suddards,vsuddardsrb@berkeley.edu,Tax Accountant,8142,472,8614
2401,Illa,Penticost,ipenticostrn@prweb.com,Marketing Assistant,8399,566,8965
12189,Kamilah,Priver,kpriver0@360.cn,Engineer I,8776,1763,10539
12995,Filberto,Isakov,fisakov1@walmart.com,Director of Sales,6713,413,7126
12335,Maurine,Leupold,mleupold2@adobe.com,Research Assistant II,4850,554,5404
12797,Tobias,Attle,tattle3@51.la,Accountant I,6943,1607,8550
12597,Sheff,Abrashkov,sabrashkov4@shareasale.com,General Manager,7500,1202,8702
12709,Caitrin,Spittle,cspittle6@uiuc.edu,Administrative Officer,2677,935,3612
12458,Wenona,Domenichelli,wdomenichelli7@google.es,Data Coordiator,4509,423,4932
12475,Gearard,Ream,gream8@telegraph.co.uk,Structural Analysis Engineer,5345,671,6016
12869,Rudiger,Matteini,rmatteini9@weather.com,Human Resources Manager,1204,1192,2396
12508,Fabe,Teacy,fteacya@berkeley.edu,Graphic Designer,7458,1002,8460
12116,Aeriell,Heaton,aheatonb@wired.com,Pharmacist,9617,697,10314
12174,Ava,Spraggon,aspraggonc@shinystat.com,VP Product Management,4215,940,5155
12103,Franklyn,O'Giany,fogianyd@cbc.ca,Analyst Programmer,9630,1833,11463
12320,Coreen,McCluney,cmccluneye@unblog.fr,VP Sales,8862,524,9386
12789,Deedee,Jenkerson,djenkersonf@europa.eu,Graphic Designer,9455,436,9891
12171,Eberto,Reyes,ereyesg@fc2.com,Project Manager,1420,1111,2531
12748,Hayes,Baddoe,hbaddoeh@discovery.com,Senior Financial Analyst,5481,1773,7254
12561,Nanni,Farden,nfardeni@hugedomains.com,Account Executive,1916,462,2378
12167,Aarika,Causby,acausbyj@woothemes.com,Engineer IV,4524,532,5056
12649,Harrietta,McAlarney,hmcalarneyk@chron.com,Environmental Tech,4441,1152,5593
12648,Jeniffer,Curuclis,jcuruclisl@google.de,Statistician II,2272,645,2917
12577,Phillis,Sussex,psussexm@patch.com,Quality Engineer,3143,783,3926
12909,Kirstyn,Gabbidon,kgabbidonn@goo.ne.jp,Quality Engineer,4621,285,4906
12151,Lemmy,Mallatratt,lmallatratto@yellowbook.com,Speech Pathologist,9366,1214,10580
12197,Winifred,Faustin,wfaustinp@wikispaces.com,GIS Technical Architect,9557,1723,11280
12647,Natividad,Sargood,nsargoodq@cocolog-nifty.com,Electrical Engineer,9816,668,10484
12548,Heath,Bowkett,hbowkettr@a8.net,Structural Analysis Engineer,1538,1430,2968
12621,Ivett,Figgen,ifiggens@tamu.edu,Nurse,9683,1958,11641
12803,Christian,Breadon,cbreadont@dropbox.com,Mechanical Systems Engineer,3463,1887,5350
12440,Frans,Gartside,fgartsideu@yolasite.com,Financial Advisor,9474,1380,10854
12800,Twyla,Willows,twillowsv@microsoft.com,Data Coordiator,7747,1871,9618
12065,Dougy,Olivetta,dolivettaw@gravatar.com,Structural Engineer,9266,1356,10622
12431,Mirna,Licence,mlicencex@taobao.com,Product Engineer,5431,1021,6452
12269,Tonye,Damant,tdamanty@flickr.com,Accountant IV,9761,825,10586
12053,Floyd,Kubiak,fkubiakz@who.int,Executive Secretary,3448,895,4343
12127,Danie,Haywood,dhaywood10@t-online.de,Human Resources Assistant I,2070,934,3004
12135,Venus,Blackey,vblackey11@163.com,Recruiting Manager,4590,980,5570
12314,Janette,Kobpal,jkobpal12@cornell.edu,Engineer I,5795,1849,7644
12505,Bruis,Pinnick,bpinnick13@yellowbook.com,Technical Writer,4731,584,5315
12578,Darsie,Knutsen,dknutsen14@odnoklassniki.ru,Electrical Engineer,7014,508,7522
12012,Stephine,Holtum,sholtum15@loc.gov,Data Coordiator,7495,1566,9061
12755,Joseph,Orfeur,jorfeur16@fda.gov,Assistant Media Planner,4749,748,5497
12326,Ninette,Lamprecht,nlamprecht17@aol.com,Technical Writer,7239,664,7903
12729,Wain,Friett,wfriett18@lulu.com,Quality Engineer,7212,353,7565
12076,Shem,Fleckness,sfleckness19@washington.edu,Chemical Engineer,5950,598,6548
12439,Athene,Liley,aliley1a@discovery.com,Account Coordinator,8553,975,9528
12286,Saidee,Rignoldes,srignoldes1b@wikia.com,Human Resources Assistant III,2115,1919,4034
12390,Abby,Gecke,agecke1c@nbcnews.com,Human Resources Assistant III,1593,554,2147
12462,Tracey,Iwanczyk,tiwanczyk1d@youtube.com,Payment Adjustment Coordinator,3875,1760,5635
12376,Ava,Fraine,afraine1e@liveinternet.ru,Occupational Therapist,4324,1349,5673
12532,Harlen,Cuerda,hcuerda1f@dedecms.com,Analog Circuit Design manager,9622,1056,10678
12481,Garry,Petrashov,gpetrashov1g@aol.com,Chief Design Engineer,5135,347,5482
12864,Rochell,Schruurs,rschruurs1h@vistaprint.com,Nurse Practicioner,6854,1105,7959
12958,Tonye,de Bullion,tdebullion1i@yolasite.com,Civil Engineer,5613,942,6555
12778,Lib,Barcke,lbarcke1j@arizona.edu,Financial Advisor,8357,216,8573
12321,Ann-marie,McNaughton,amcnaughton1k@google.com,Web Developer I,5142,215,5357
12168,Wayne,Kenderdine,wkenderdine1l@bing.com,Marketing Manager,5825,883,6708
12362,Suzi,Seals,sseals1m@usa.gov,Editor,6722,1241,7963
12807,Jelene,Davet,jdavet1p@ftc.gov,Internal Auditor,4463,1277,5740
12589,Chen,Lauritsen,clauritsen1q@accuweather.com,Dental Hygienist,9687,577,10264
12544,Alric,Brewer,abrewer1r@cnbc.com,Safety Technician IV,3683,1943,5626
12134,Cobby,Blamphin,cblamphin1s@topsy.com,Structural Analysis Engineer,3020,330,3350
12959,Kienan,Treeby,ktreeby1t@wired.com,Food Chemist,3171,1508,4679
12550,Elga,Brigham,ebrigham1u@samsung.com,Community Outreach Specialist,3219,1736,4955
12042,Teddi,Daymond,tdaymond1v@ask.com,Accounting Assistant I,7610,1813,9423
12744,Rosemary,Blagdon,rblagdon1w@wiley.com,Professor,5193,899,6092
12977,Benni,Bacon,bbacon1x@tiny.cc,Civil Engineer,1506,1508,3014
12077,Elroy,Forkan,eforkan1y@domainmarket.com,Community Outreach Specialist,7654,591,8245
12582,Ginny,Benesevich,gbenesevich1z@mapquest.com,General Manager,4122,1639,5761
12071,Alejandra,Stert,astert20@bing.com,Assistant Professor,4183,1708,5891
12491,Natividad,Porter,nporter21@tmall.com,Environmental Specialist,5701,1886,7587
12588,Conny,Dulling,cdulling22@time.com,Geological Engineer,4546,1585,6131
12533,Glad,Soloway,gsoloway23@fema.gov,Marketing Assistant,1655,1235,2890
12510,Blane,Spinke,bspinke24@tuttocitta.it,Sales Representative,6538,1204,7742
12046,Ranice,Micklewicz,rmicklewicz25@myspace.com,VP Accounting,1481,1023,2504
12221,Miranda,Tuff,mtuff26@bluehost.com,Mechanical Systems Engineer,9525,1147,10672
12821,Caril,Jordi,cjordi27@fotki.com,Programmer Analyst II,7420,1337,8757
12633,Valery,Bruffell,vbruffell28@epa.gov,Senior Financial Analyst,8366,1200,9566
12966,Byrann,Vasechkin,bvasechkin29@hostgator.com,Desktop Support Technician,2767,1880,4647
12765,Fannie,Dilleston,fdilleston2a@friendfeed.com,Staff Scientist,7629,1222,8851
12693,Jorry,Mellem,jmellem2b@washingtonpost.com,Staff Scientist,4433,1232,5665
12940,Jules,Meaking,jmeaking2c@dropbox.com,VP Sales,3927,1767,5694
12368,Sharia,Musico,smusico2d@npr.org,Director of Sales,6653,579,7232
12497,Hallie,Levick,hlevick2e@mediafire.com,Help Desk Operator,7542,565,8107
12711,Farley,Imos,fimos2f@aol.com,Staff Accountant III,1398,639,2037
12227,Lay,Guion,lguion2h@nsw.gov.au,Programmer I,2204,1288,3492
12587,Trever,Piatto,tpiatto2i@xrea.com,Engineer IV,4282,377,4659
12736,Celinda,Kermath,ckermath2j@businessinsider.com,VP Product Management,3773,787,4560
12430,Lou,Ivshin,livshin2k@home.pl,Analyst Programmer,5192,1026,6218
12810,Rory,Tregidga,rtregidga2l@scribd.com,Database Administrator II,6843,862,7705
12229,Maxi,McNab,mmcnab2m@smh.com.au,VP Product Management,9807,667,10474
12192,Shayla,Burnitt,sburnitt2n@cnn.com,Dental Hygienist,9746,286,10032
12987,Anthea,Traske,atraske2o@marriott.com,Product Engineer,6349,223,6572
12636,Skipper,Rowbrey,srowbrey2p@blogs.com,Systems Administrator IV,6969,553,7522
12845,Theodore,Tuckwood,ttuckwood2q@blogtalkradio.com,Computer Systems Analyst I,2083,556,2639
12602,Marge,Garment,mgarment2r@mashable.com,Chief Design Engineer,2595,426,3021
12611,Trula,Touzey,ttouzey2s@ycombinator.com,Software Engineer II,3189,1214,4403
12096,De witt,Lawly,dlawly2t@yellowpages.com,Research Nurse,2999,527,3526
12013,Reine,Olney,rolney2u@phoca.cz,Clinical Specialist,3760,440,4200
12295,Frasco,Kidde,fkidde2w@bloglines.com,Senior Editor,1264,1619,2883
12425,Jonas,Slader,jslader2x@kickstarter.com,Graphic Designer,7944,1968,9912
12991,Howie,Shynn,hshynn2y@flavors.me,Programmer III,9624,1831,11455
12724,Kaycee,Trussler,ktrussler2z@liveinternet.ru,Business Systems Development Analyst,7901,1842,9743
12859,Hamlin,Garnsworthy,hgarnsworthy30@wsj.com,Software Engineer IV,1140,987,2127
12867,Katharyn,Maxwale,kmaxwale31@multiply.com,Programmer III,1097,1055,2152
12361,Lesly,Lidgard,llidgard32@google.com.au,Actuary,2672,537,3209
12560,Arnuad,Kilkenny,akilkenny34@geocities.jp,Internal Auditor,5063,1308,6371
12753,Fidelity,Tidbury,ftidbury35@nature.com,Civil Engineer,9728,460,10188
12635,Johny,Prator,jprator36@desdev.cn,Editor,5510,1738,7248
12210,Ethelyn,Braunstein,ebraunstein37@addthis.com,Technical Writer,8678,1616,10294
12410,Stanislaw,Durnall,sdurnall38@theglobeandmail.com,VP Product Management,5320,1220,6540
12445,Fidelia,Lukovic,flukovic39@mail.ru,Health Coach I,8487,1814,10301
12258,Vincenz,Farre,vfarre3a@apache.org,General Manager,7418,580,7998
12714,Helaine,Blakeborough,hblakeborough3b@apache.org,Web Designer IV,8740,1112,9852
12306,Bryan,Reijmers,breijmers3c@ucoz.ru,Marketing Manager,5216,1517,6733
12033,Salvidor,Launder,slaunder3d@alexa.com,Business Systems Development Analyst,2096,951,3047
12746,Binni,Caillou,bcaillou3e@msu.edu,Staff Scientist,6869,563,7432
12217,Chloe,Cotgrove,ccotgrove3f@biglobe.ne.jp,Dental Hygienist,4243,283,4526
12014,Joanne,MacKill,jmackill3g@weather.com,Social Worker,2006,1942,3948
12943,Constantine,Bazely,cbazely3h@jalbum.net,Software Test Engineer II,9404,1207,10611
12213,D'arcy,Charlon,dcharlon3i@spiegel.de,Media Manager II,5076,1989,7065
12661,Dorene,Mundwell,dmundwell3j@canalblog.com,Human Resources Manager,2271,564,2835
12904,Kiel,Sapauton,ksapauton3k@printfriendly.com,Account Coordinator,3403,454,3857
12177,Ramon,Tennison,rtennison3l@bing.com,Staff Accountant IV,5447,202,5649
12080,Brunhilda,Simmank,bsimmank3n@yelp.com,Biostatistician IV,6774,1964,8738
12841,Chloe,Quesne,cquesne3o@deliciousdays.com,Budget/Accounting Analyst II,9028,1519,10547
12279,Sonny,Ferriman,sferriman3p@pbs.org,Nurse,1678,1247,2925
12011,Carmencita,Norvel,cnorvel3q@ucla.edu,Recruiter,4066,672,4738
12626,Elora,O'Kenny,eokenny3r@kickstarter.com,Research Associate,9125,277,9402
12487,Thorvald,Trinke,ttrinke3s@mit.edu,VP Product Management,3561,422,3983
12331,Eolanda,Aitken,eaitken3t@cnet.com,Programmer IV,1104,1932,3036
12973,Salem,Bradford,sbradford3u@marriott.com,Programmer Analyst III,8195,988,9183
12140,Marline,Gurling,mgurling3v@hao123.com,Web Designer I,1543,1782,3325
12816,Rowland,Quye,rquye3w@tripod.com,Quality Control Specialist,9366,947,10313
12876,Kermy,Badwick,kbadwick3x@adobe.com,Health Coach I,4919,611,5530
12688,Herbert,Wilkins,hwilkins3y@mit.edu,Health Coach IV,3390,1748,5138
12328,Bradly,Saltsberger,bsaltsberger3z@oracle.com,Health Coach IV,3116,476,3592
12250,Gunter,Joisce,gjoisce40@t.co,Computer Systems Analyst II,2548,948,3496
12345,Caterina,Sigsworth,csigsworth41@chronoengine.com,Desktop Support Technician,7162,697,7859
12900,Joelie,Drezzer,jdrezzer42@gmpg.org,Community Outreach Specialist,9286,1464,10750
12454,Webster,Maidens,wmaidens43@tiny.cc,Recruiting Manager,6103,1893,7996
12970,Kirbee,Cahey,kcahey44@wikipedia.org,Community Outreach Specialist,1619,1592,3211
12287,Clari,Tonnesen,ctonnesen45@tripadvisor.com,Biostatistician I,7125,533,7658
12565,Cecilia,Prettyjohn,cprettyjohn46@springer.com,Recruiting Manager,2628,1726,4354
12801,Cassandry,Bruty,cbruty49@reddit.com,Chemical Engineer,4234,1883,6117
12256,Ervin,Alphege,ealphege4a@fotki.com,Analog Circuit Design manager,8763,802,9565
12402,Frayda,Cowwell,fcowwell4b@gnu.org,Clinical Specialist,7445,1809,9254
12396,Burlie,Bunhill,bbunhill4d@cloudflare.com,Nuclear Power Engineer,6955,1164,8119
12894,Norri,Dyson,ndyson4e@printfriendly.com,Tax Accountant,1543,947,2490
12294,Adair,Stolli,astolli4f@stumbleupon.com,Data Coordiator,4291,1266,5557
12780,Itch,Lie,ilie4g@europa.eu,Paralegal,6242,932,7174
12191,Willi,Strothers,wstrothers4h@paypal.com,Accountant III,9054,348,9402
12341,Heda,Tille,htille4i@printfriendly.com,Executive Secretary,7020,1585,8605
12934,Gerri,Hawse,ghawse4j@google.ru,Speech Pathologist,5769,838,6607
12098,Simeon,Syms,ssyms4l@tamu.edu,Senior Developer,6912,1100,8012
12616,Christine,Anthoine,canthoine4m@bluehost.com,Tax Accountant,1544,920,2464
12480,Darcey,Taffley,dtaffley4n@geocities.com,Paralegal,4842,1422,6264
12409,Tabby,O'Neal,toneal4o@house.gov,Developer I,2642,910,3552
12769,Dwight,Hackwell,dhackwell4p@goo.gl,Technical Writer,6254,1337,7591
12525,Manda,Cocher,mcocher4q@shinystat.com,Editor,6616,1008,7624
12558,Tory,Narramor,tnarramor4r@dailymotion.com,Teacher,3293,380,3673
12819,Annetta,Ashdown,aashdown4s@godaddy.com,Quality Engineer,8432,926,9358
12058,Fletcher,Spirit,fspirit4u@cafepress.com,Quality Control Specialist,2243,264,2507
12514,Lora,Carwithim,lcarwithim4v@aboutads.info,Graphic Designer,4251,358,4609
12299,Winona,Tompkins,wtompkins4w@instagram.com,Chemical Engineer,4110,797,4907
12272,Monro,Lacasa,mlacasa4y@marketwatch.com,Assistant Media Planner,1072,593,1665
12050,Tate,Malin,tmalin50@comcast.net,Statistician III,9885,1743,11628
12137,Byron,Stallworthy,bstallworthy52@wp.com,Web Designer II,1926,492,2418
12581,Emalee,Gervaise,egervaise53@dmoz.org,GIS Technical Architect,5704,337,6041
12447,Nanci,Hullin,nhullin54@chronoengine.com,Recruiter,4568,1856,6424
12156,Hadlee,Chieco,hchieco55@nhs.uk,Payment Adjustment Coordinator,3272,324,3596
12049,Joell,Naper,jnaper56@patch.com,Health Coach II,9288,618,9906
12826,Rozalie,Ashbrook,rashbrook57@abc.net.au,Actuary,8623,1366,9989
12144,Ame,Impson,aimpson58@lycos.com,Information Systems Manager,3042,405,3447
12774,Eleen,Bartolijn,ebartolijn59@go.com,Analyst Programmer,6665,1628,8293
12225,Kermy,Craven,kcraven5a@so-net.ne.jp,Civil Engineer,6804,1832,8636
12919,Steffi,Nanson,snanson5b@nytimes.com,Account Coordinator,9499,1831,11330
12070,Hamilton,Billborough,hbillborough5c@gravatar.com,Software Consultant,6001,801,6802
12557,Zonnya,Abrey,zabrey5d@nhs.uk,Mechanical Systems Engineer,9329,1739,11068
12443,Wandie,Tootal,wtootal5e@hp.com,Recruiting Manager,9385,1782,11167
12884,Joan,Dore,jdore5f@comsenz.com,Technical Writer,1730,578,2308
12799,Nadine,Pickaver,npickaver5g@aboutads.info,Assistant Manager,3443,1307,4750
12870,Wylie,Tippings,wtippings5i@mysql.com,Junior Executive,4174,464,4638
12732,Luz,Lergan,llergan5k@mapquest.com,Compensation Analyst,8903,418,9321
12342,Adaline,Hefferon,ahefferon5l@sogou.com,General Manager,3590,1335,4925
12772,Leicester,Barnhart,lbarnhart5m@latimes.com,Librarian,3279,1747,5026
12128,Yovonnda,Mendenhall,ymendenhall5n@prweb.com,VP Accounting,5287,885,6172
12451,Bunnie,Twist,btwist5o@nymag.com,Accountant I,5485,1472,6957
12460,Inesita,Castro,icastro5p@ft.com,Professor,7802,1892,9694
12236,Berky,Crandon,bcrandon5q@hao123.com,Office Assistant II,5235,1407,6642
12163,Floria,Sellstrom,fsellstrom5r@jigsy.com,Account Coordinator,6135,658,6793
12543,Vassily,Holdren,vholdren5s@blogtalkradio.com,Community Outreach Specialist,2721,634,3355
12323,Erv,Soigne,esoigne5t@gravatar.com,Business Systems Development Analyst,6631,1955,8586
12449,Yard,Mattocks,ymattocks5u@newsvine.com,Marketing Manager,8714,939,9653
12763,Glennie,Ribeiro,gribeiro5v@webs.com,Assistant Professor,4382,1616,5998
12820,Barnebas,Livens,blivens5w@livejournal.com,VP Sales,1365,1322,2687
12848,Dorice,Mitchell,dmitchell5x@nationalgeographic.com,Statistician I,8462,1541,10003
12734,Riobard,Rushby,rrushby5y@homestead.com,Clinical Specialist,2571,248,2819
12028,Roana,Hartshorne,rhartshorne5z@shop-pro.jp,Web Designer II,4147,1528,5675
12918,Cordell,Martinie,cmartinie60@buzzfeed.com,Senior Cost Accountant,5027,1585,6612
12939,Ingelbert,Le Blond,ileblond62@behance.net,Senior Quality Engineer,7120,1664,8784
12815,Randi,McCraw,rmccraw63@craigslist.org,Marketing Assistant,2557,626,3183
12463,Packston,Pitts,ppitts64@soup.io,Database Administrator III,2757,1135,3892
12893,Jo ann,Housley,jhousley66@berkeley.edu,Electrical Engineer,1713,347,2060
12486,Stefania,Hartshorne,shartshorne67@illinois.edu,Internal Auditor,8617,757,9374
12079,Rae,Litel,rlitel68@xinhuanet.com,Senior Financial Analyst,2363,920,3283
12397,Tarah,Monnoyer,tmonnoyer69@freewebs.com,Budget/Accounting Analyst III,6486,726,7212
12437,Rani,Winscomb,rwinscomb6a@angelfire.com,Computer Systems Analyst I,4396,1220,5616
12969,Hubert,Linscott,hlinscott6b@jigsy.com,Senior Sales Associate,9962,1455,11417
12699,Trevor,Burney,tburney6c@123-reg.co.uk,Physical Therapy Assistant,3204,744,3948
12401,Shannon,Baccup,sbaccup6f@mapquest.com,VP Marketing,3233,1526,4759
12126,Bondie,Gareisr,bgareisr6i@baidu.com,Quality Engineer,4770,713,5483
12048,Nicolais,Fitchet,nfitchet6j@cnn.com,Dental Hygienist,6972,1509,8481
12935,Stephannie,Gaskall,sgaskall6l@mozilla.com,Systems Administrator III,2134,334,2468
12001,Cointon,Grocock,cgrocock6m@barnesandnoble.com,Environmental Tech,4936,1248,6184
12291,Rahal,Wolfindale,rwolfindale6n@t-online.de,Senior Financial Analyst,7239,1148,8387
12962,Odetta,Drewry,odrewry6o@godaddy.com,Account Coordinator,3963,1624,5587
12019,Alyosha,Archard,aarchard6p@so-net.ne.jp,Payment Adjustment Coordinator,3521,431,3952
12339,Baxie,Vlasyuk,bvlasyuk6q@imageshack.us,Electrical Engineer,5404,257,5661
12343,Annora,Coping,acoping6s@feedburner.com,Associate Professor,4073,1556,5629
12334,Codi,Thorouggood,cthorouggood6t@ehow.com,Payment Adjustment Coordinator,5765,549,6314
12159,Cash,Daines,cdaines6v@netvibes.com,Database Administrator II,3471,1827,5298
12770,Chrissie,Witts,cwitts6w@csmonitor.com,Staff Accountant II,1946,1421,3367
12603,Rose,Godfrey,rgodfrey6x@github.com,Quality Engineer,4486,1201,5687
12056,Giorgi,Brockie,gbrockie6z@yandex.ru,Pharmacist,7743,446,8189
12634,Grannie,Pavek,gpavek70@newyorker.com,Structural Engineer,8006,1605,9611
12473,Rollo,Everest,reverest71@google.es,GIS Technical Architect,9208,374,9582
12875,Shelby,Baglan,sbaglan73@fema.gov,Senior Quality Engineer,8665,1830,10495
12218,Eal,Macey,emacey74@google.fr,Office Assistant II,1261,323,1584
12843,Marthe,Chipperfield,mchipperfield76@upenn.edu,Registered Nurse,4767,1297,6064
12160,Giffie,Atterley,gatterley77@slate.com,Structural Engineer,7005,1829,8834
12273,Siobhan,Carlucci,scarlucci78@google.de,Software Engineer IV,6015,901,6916
12512,Junette,Wychard,jwychard79@craigslist.org,Registered Nurse,7462,1486,8948
12283,Antonietta,Hasted,ahasted7a@alibaba.com,Programmer Analyst IV,9181,1362,10543
12357,Barnabe,Afonso,bafonso7b@timesonline.co.uk,Quality Control Specialist,7602,1785,9387
12200,Alphonse,Daughtrey,adaughtrey7c@jiathis.com,Marketing Manager,3625,1303,4928
12125,Filberte,Cuskery,fcuskery7d@barnesandnoble.com,Recruiting Manager,8062,1113,9175
12852,Stepha,Happel,shappel7e@auda.org.au,Senior Editor,4123,1018,5141
12715,Lorain,Inchcomb,linchcomb7g@amazon.co.jp,GIS Technical Architect,5126,1508,6634
12153,Richardo,Moorhead,rmoorhead7h@ucsd.edu,Legal Assistant,1457,1847,3304
12289,Juana,Fend,jfend7i@yale.edu,Safety Technician II,8644,1278,9922
12176,Alfi,Jarret,ajarret7j@marketwatch.com,Marketing Assistant,3153,393,3546
12931,Johnnie,Piers,jpiers7k@bigcartel.com,Physical Therapy Assistant,8936,670,9606
12708,Gaven,Pennigar,gpennigar7l@vimeo.com,Programmer Analyst II,5143,1693,6836
12337,Wilmar,Golds,wgolds7m@163.com,Teacher,4576,1053,5629
12981,Kevina,Cocklin,kcocklin7n@google.it,VP Marketing,4925,1749,6674
12838,Lindi,Harler,lharler7o@twitter.com,Senior Sales Associate,1192,1166,2358
12029,Elladine,Vittore,evittore7p@vimeo.com,Registered Nurse,6933,1175,8108
12274,Claudetta,Vassel,cvassel7r@bing.com,Legal Assistant,3788,1847,5635
12762,Dermot,Brocking,dbrocking7s@symantec.com,VP Accounting,7176,1201,8377
12457,Arda,D'Elias,adelias7v@jimdo.com,Chief Design Engineer,1875,1086,2961
12198,Willyt,MacArdle,wmacardle7w@dedecms.com,Chemical Engineer,6003,560,6563
12275,Whittaker,Beddall,wbeddall7x@hibu.com,Administrative Officer,2760,1615,4375
12423,Robbie,Bowller,rbowller7y@squarespace.com,Senior Editor,2626,969,3595
12317,Freedman,Gully,fgully7z@businessweek.com,Developer III,8921,907,9828
12739,Faber,Simic,fsimic80@tumblr.com,VP Sales,7348,980,8328
12980,Ashleigh,Beamish,abeamish81@independent.co.uk,Financial Analyst,9982,1642,11624
12442,Joye,Jackalin,jjackalin83@baidu.com,Social Worker,3800,1668,5468
12476,Cob,Robertot,crobertot84@senate.gov,Internal Auditor,2266,1488,3754
12690,Tremain,MacKeig,tmackeig85@sourceforge.net,Professor,3761,1240,5001
12749,Jobey,Ritchard,jritchard86@bluehost.com,Business Systems Development Analyst,8043,1890,9933
12389,Ynez,Formoy,yformoy87@thetimes.co.uk,Legal Assistant,7349,1049,8398
12949,Meryl,McGrale,mmcgrale88@nps.gov,Research Nurse,4370,1298,5668
12036,Tammy,Stallworthy,tstallworthy89@cafepress.com,Financial Analyst,1218,516,1734
12067,Merrie,Moulsdall,mmoulsdall8b@dailymail.co.uk,Assistant Media Planner,5787,1127,6914
12009,Sinclare,McGonnell,smcgonnell8c@wiley.com,Automation Specialist IV,9067,941,10008
12377,Datha,Cheake,dcheake8f@webs.com,Marketing Manager,5278,237,5515
12877,Edwina,Patriche,epatriche8g@elpais.com,Information Systems Manager,5080,589,5669
12670,Zelda,Leddy,zleddy8h@reference.com,Geologist III,3351,435,3786
12373,Agatha,Rosenblum,arosenblum8j@china.com.cn,Systems Administrator IV,9491,1239,10730
12668,Cara,Reagan,creagan8k@themeforest.net,Nurse,6899,1752,8651
12833,Myrta,Treby,mtreby8m@addthis.com,Help Desk Technician,3648,836,4484
12063,Oralle,Donaghie,odonaghie8n@webnode.com,Project Manager,3631,844,4475
12914,Arnaldo,Banton,abanton8p@house.gov,VP Sales,2890,1754,4644
12612,Dreddy,Radbond,dradbond8q@toplist.cz,Quality Control Specialist,8674,1982,10656
12571,Allyn,Farbrother,afarbrother8r@typepad.com,Research Assistant IV,2336,1336,3672
12824,Bree,Leney,bleney8s@pen.io,Civil Engineer,7652,1407,9059
12375,Giff,Axup,gaxup8t@t-online.de,VP Accounting,9054,280,9334
12150,Quint,Martyntsev,qmartyntsev8u@forbes.com,Research Nurse,1197,1544,2741
12064,Minerva,Crasswell,mcrasswell8v@nbcnews.com,Analog Circuit Design manager,2639,357,2996
12081,Madge,Bristowe,mbristowe8w@wsj.com,Senior Cost Accountant,5663,966,6629
12422,Glen,Gail,ggail8y@diigo.com,Senior Cost Accountant,2644,1434,4078
12733,Daffi,Hirche,dhirche8z@linkedin.com,Staff Accountant II,1824,567,2391
12115,Helsa,McCarle,hmccarle90@yellowpages.com,Web Developer III,4435,1944,6379
12880,Jule,Bonellie,jbonellie91@nhs.uk,Registered Nurse,1789,1638,3427
12619,Darryl,Orrey,dorrey92@sciencedirect.com,Junior Executive,4525,491,5016
12961,Sigvard,Barus,sbarus93@goodreads.com,Librarian,6067,488,6555
12806,Eleanora,Rapaport,erapaport94@hexun.com,VP Quality Control,8299,1180,9479
12613,Hernando,Gadsby,hgadsby95@blog.com,Food Chemist,1669,1447,3116
12828,Mellisent,Folan,mfolan96@bandcamp.com,Human Resources Manager,2794,1166,3960
12747,Keenan,Bernardeau,kbernardeau97@china.com.cn,Programmer Analyst IV,1712,501,2213
12426,Cthrine,Smogur,csmogur98@telegraph.co.uk,Tax Accountant,9213,1959,11172
12750,Chaddie,Darnbrook,cdarnbrook99@imgur.com,Safety Technician I,6451,701,7152
12148,Dinnie,Annetts,dannetts9d@shinystat.com,Nurse,3381,845,4226
12152,Antoinette,Bernadon,abernadon9e@hibu.com,Senior Quality Engineer,5474,429,5903
12503,Orly,Wastell,owastell9g@mit.edu,Quality Engineer,7016,1831,8847
12359,Bell,McCarly,bmccarly9h@cam.ac.uk,Desktop Support Technician,2451,1143,3594
12794,Coreen,Peizer,cpeizer9i@cloudflare.com,Programmer I,1068,1095,2163
12782,Ashely,Arnold,aarnold9j@reuters.com,Software Consultant,7100,566,7666
12109,Alfred,Dawby,adawby9o@ucsd.edu,Senior Sales Associate,8057,1731,9788
12296,Petunia,Rosthorn,prosthorn9p@senate.gov,Accountant IV,3929,357,4286
12858,Gery,Abbett,gabbett9r@nyu.edu,Staff Accountant IV,1375,1117,2492
12468,Kelby,Gomer,kgomer9s@hud.gov,Staff Scientist,1840,303,2143
12999,Bambie,Norrey,bnorrey9t@china.com.cn,Paralegal,1684,1157,2841
13000,Sheffield,McHugh,smchugh9v@geocities.com,Associate Professor,6415,922,7337
12087,Maureene,Eadmeades,meadmeades9w@loc.gov,Software Consultant,8479,1360,9839
12953,Hildegaard,Farnfield,hfarnfield9y@shutterfly.com,Professor,9686,1412,11098
12484,Alfreda,Roderigo,aroderigo9z@google.com.br,Senior Quality Engineer,7200,782,7982
12267,Gay,Roome,groomea0@jigsy.com,Geologist II,6668,206,6874
12338,Gwyneth,Gryglewski,ggryglewskia2@surveymonkey.com,Clinical Specialist,7417,1547,8964
12540,Leonhard,Bullin,lbullina3@miibeian.gov.cn,Data Coordiator,5289,1785,7074
12483,Webb,Legging,wlegginga4@ifeng.com,Pharmacist,9553,1880,11433
12574,Tony,Kerne,tkernea5@4shared.com,Marketing Manager,3095,1206,4301
12106,Burg,Jone,bjonea6@unesco.org,Help Desk Operator,6948,847,7795
12278,Riannon,Knapper,rknappera7@narod.ru,Help Desk Technician,2994,1913,4907
12817,Alyse,Kenington,akeningtona8@amazon.co.jp,Information Systems Manager,4037,409,4446
12552,Finley,Sline,fslineaa@etsy.com,Senior Quality Engineer,1717,1046,2763
12546,Cullie,Mitkin,cmitkinab@mail.ru,Project Manager,4172,1024,5196
12951,Eduard,Stellino,estellinoae@nba.com,General Manager,5014,1067,6081
12365,Milo,Mateus,mmateusaf@google.fr,Analyst Programmer,4642,1326,5968
12354,Shane,Bozier,sbozierag@icio.us,Web Developer III,7545,739,8284
12898,Jackie,Wilks,jwilksai@wordpress.org,Web Designer III,3476,246,3722
12908,Shae,Lambert,slambertaj@techcrunch.com,Nurse,7871,462,8333
12771,Amalee,Gawthorp,agawthorpak@nba.com,Speech Pathologist,2949,557,3506
12333,Fulton,Diben,fdibenal@homestead.com,Financial Analyst,7516,1110,8626
12786,Kaylil,Beinke,kbeinkeam@spotify.com,Staff Accountant IV,6114,452,6566
12618,Analiese,Martugin,amartuginan@nationalgeographic.com,Librarian,6351,1935,8286
12149,Victor,Barton,vbartonaq@squarespace.com,Human Resources Assistant III,7721,1930,9651
12084,Donnamarie,Mannion,dmannionar@blogs.com,Data Coordiator,6289,280,6569
12873,Esther,Brooking,ebrookingas@google.com.br,Structural Engineer,7163,1660,8823
12681,Cori,Harmon,charmonau@cmu.edu,Junior Executive,6397,1585,7982
12527,Anjanette,Fratson,afratsonav@nationalgeographic.com,Community Outreach Specialist,9125,919,10044
12424,Kiley,Tolussi,ktolussiaw@google.ru,Teacher,9242,297,9539
12141,Kizzee,Dicks,kdicksaz@shop-pro.jp,VP Quality Control,1471,1833,3304
12259,Alain,Walkey,awalkeyb0@uol.com.br,Registered Nurse,8467,1333,9800
12332,Penni,Lautie,plautieb1@cdbaby.com,Clinical Specialist,8908,1156,10064
12751,Robinette,Geeve,rgeeveb2@irs.gov,Actuary,8019,851,8870
12313,Carter,Buncom,cbuncomb3@springer.com,Account Coordinator,3755,395,4150
12035,Nanete,Allgood,nallgoodb4@pcworld.com,Director of Sales,1802,441,2243
12521,Marleah,Sheerin,msheerinb5@123-reg.co.uk,Mechanical Systems Engineer,8902,1192,10094
12825,Selig,Rabier,srabierb9@chron.com,Nuclear Power Engineer,1689,1320,3009
12768,Velvet,Gownge,vgowngebc@technorati.com,Account Executive,5242,1231,6473
12507,Coop,Cadwaladr,ccadwaladrbd@domainmarket.com,Developer IV,4727,1354,6081
12756,Taber,Guinnane,tguinnanebe@so-net.ne.jp,Research Nurse,6706,636,7342
12158,Henriette,Forker,hforkerbf@cdc.gov,Account Executive,3352,305,3657
12520,Sandro,Swindon,sswindonbh@imgur.com,Database Administrator I,2307,1392,3699
12978,Marylinda,Mackro,mmackrobj@discuz.net,Systems Administrator II,3143,1850,4993
12849,Valene,Giacobbo,vgiacobbobl@linkedin.com,Office Assistant II,7657,960,8617
12186,Maegan,Autry,mautrybm@apache.org,Help Desk Technician,9933,1686,11619
12021,Cthrine,Cammish,ccammishbp@1688.com,Database Administrator III,3126,1083,4209
12207,Siouxie,Moth,smothbs@bloglines.com,Quality Engineer,9457,1516,10973
12785,Trumaine,Giamo,tgiamobt@sciencedaily.com,Help Desk Technician,1886,1217,3103
12202,Hunter,D'Costa,hdcostabu@webeden.co.uk,Human Resources Assistant I,7690,744,8434
12206,Nessa,Yelyashev,nyelyashevbv@nbcnews.com,Food Chemist,5207,412,5619
12710,Clemmie,Chick,cchickbw@ihg.com,Data Coordiator,8790,779,9569
12506,Delmer,Delve,ddelvebx@ocn.ne.jp,Sales Representative,5306,458,5764
12891,Minetta,Tunaclift,mtunacliftbz@thetimes.co.uk,Actuary,4559,556,5115
12883,Tildi,Ledster,tledsterc0@e-recht24.de,Systems Administrator IV,9957,1399,11356
12235,Bary,Prator,bpratorc1@bloglines.com,Physical Therapy Assistant,1754,1519,3273
12052,Margeaux,Saveall,msaveallc3@deviantart.com,Software Consultant,5930,1767,7697
12194,Elora,Stanley,estanleyc5@posterous.com,Administrative Officer,7783,794,8577
12617,Kerrin,Biers,kbiersc6@seesaa.net,Project Manager,5878,1560,7438
12398,Kelvin,Ezzy,kezzyc7@com.com,Help Desk Operator,4864,305,5169
12324,Ludovika,Wabersich,lwabersichc8@about.me,Health Coach III,2971,900,3871
12906,Erna,Munkton,emunktonc9@blogspot.com,Nurse Practicioner,8560,652,9212
12731,Udall,Steuhlmeyer,usteuhlmeyerce@google.ru,Tax Accountant,2962,843,3805
12604,Bevin,Bridgeland,bbridgelandch@imdb.com,Legal Assistant,3625,237,3862
12653,Cal,Ashard,cashardci@free.fr,Developer III,2421,555,2976
12297,Elwood,Tomaschke,etomaschkecj@elegantthemes.com,VP Marketing,9712,1693,11405
12241,Sidney,McQuilty,smcquiltycl@cnet.com,Human Resources Manager,4972,509,5481
12216,Siana,Baldacchi,sbaldacchicm@hhs.gov,Environmental Tech,9580,889,10469
12787,Bibby,Battle,bbattlecp@slashdot.org,Occupational Therapist,6137,1485,7622
12666,Maurice,Petheridge,mpetheridgecq@feedburner.com,Civil Engineer,7245,225,7470
12629,Brandy,Beardshall,bbeardshallcr@shinystat.com,Safety Technician IV,1004,1923,2927
12669,Nial,Greatrakes,ngreatrakescs@wikispaces.com,Software Consultant,5920,1909,7829
12861,Nancie,Beggin,nbegginct@linkedin.com,VP Product Management,1908,233,2141
12456,Shelby,MacAllan,smacallancu@salon.com,Legal Assistant,6699,981,7680
12882,Dayna,Huyche,dhuychecv@uol.com.br,Mechanical Systems Engineer,8476,994,9470
12226,Marlo,Restieaux,mrestieauxcw@opera.com,Operator,7018,312,7330
12444,Janina,Struther,jstruthercy@walmart.com,Analyst Programmer,4020,1517,5537
12720,Stella,Giacovelli,sgiacovellicz@dyndns.org,Web Developer I,3726,1497,5223
12997,Mable,Syalvester,msyalvesterd0@alibaba.com,Human Resources Assistant II,3993,401,4394
12165,Carlynn,Carvill,ccarvilld2@goodreads.com,VP Marketing,7829,1495,9324
12553,Madelin,Hendin,mhendind3@smugmug.com,Marketing Assistant,1834,1653,3487
12863,Ashien,Maryott,amaryottd4@engadget.com,Geological Engineer,2270,1254,3524
12292,Clerkclaude,Kingsworth,ckingsworthd5@timesonline.co.uk,Programmer IV,2649,510,3159
12066,Christiana,Mugford,cmugfordd6@hao123.com,Account Executive,5096,1295,6391
12404,Dede,Harford,dharfordd8@pcworld.com,Quality Control Specialist,3616,1262,4878
12536,Marion,Hexam,mhexamd9@statcounter.com,Design Engineer,2998,849,3847
12330,Wallie,Duetsche,wduetschedb@t-online.de,VP Accounting,9764,1769,11533
12022,Thaddus,Punch,tpunchdc@newyorker.com,Web Developer III,2437,1252,3689
12282,Leigha,Gruszczak,lgruszczakde@qq.com,Account Coordinator,7229,1034,8263
12114,Marrissa,Clemo,mclemodg@lulu.com,Chemical Engineer,4341,1160,5501
12412,Gregoor,Guilbert,gguilbertdj@posterous.com,Librarian,2621,1787,4408
12566,Gabbie,Tyler,gtylerdk@drupal.org,Automation Specialist III,7164,459,7623
12672,Teressa,Ortmann,tortmanndl@cbslocal.com,Systems Administrator III,6859,735,7594
12367,Harlene,Tandy,htandydm@furl.net,Information Systems Manager,2530,533,3063
12610,Marlin,O'Crigan,mocrigandn@netscape.com,GIS Technical Architect,1933,1473,3406
12260,Faina,Laundon,flaundondp@studiopress.com,Help Desk Technician,4746,1920,6666
12143,Lynnell,Body,lbodydq@goodreads.com,Marketing Manager,2034,929,2963
12692,Ferd,Saddington,fsaddingtondt@addthis.com,Physical Therapy Assistant,5248,490,5738
12545,Roobbie,Tinkler,rtinklerdw@dagondesign.com,Director of Sales,5681,1313,6994
12728,Berny,Manwell,bmanwelldx@google.nl,Environmental Tech,7524,1907,9431
12986,Cordy,Over,coverdy@myspace.com,Food Chemist,8734,435,9169
12190,Aggy,Loughran,aloughrandz@last.fm,Financial Advisor,9000,1669,10669
12971,Alexandros,Baigrie,abaigriee0@bluehost.com,Editor,9196,1068,10264
12656,Angie,Pownall,apownalle3@sina.com.cn,Senior Developer,4489,794,5283
12853,Poul,Weben,pwebene4@g.co,Quality Control Specialist,1410,994,2404
12754,Calli,Shatliffe,cshatliffee5@tinyurl.com,Librarian,6393,346,6739
12779,Kerwinn,Linnell,klinnelle7@google.com,Staff Scientist,3424,1408,4832
12310,Leandra,Astill,lastilleb@eventbrite.com,Software Consultant,8145,784,8929
12767,Jerome,Rany,jranyee@berkeley.edu,Occupational Therapist,5607,1501,7108
12638,Ailis,Nannizzi,anannizzieg@sina.com.cn,Quality Control Specialist,5644,370,6014
12340,Doralyn,Cattermull,dcattermullei@fastcompany.com,Administrative Assistant IV,2779,613,3392
12568,Kiel,Crenage,kcrenageek@whitehouse.gov,Help Desk Technician,8238,1688,9926
12697,Cindee,Barbie,cbarbieel@infoseek.co.jp,Web Designer II,1110,527,1637
12879,Constantine,Powis,cpowisem@ameblo.jp,Systems Administrator IV,6121,1120,7241
12625,Gayle,Cavee,gcaveeen@prlog.org,Occupational Therapist,9890,1162,11052
12303,Debor,Biddiss,dbiddisseo@blogs.com,Actuary,8328,591,8919
12379,Damiano,Longdon,dlongdoneq@reverbnation.com,Programmer IV,6087,1217,7304
12967,Alan,Shoute,ashoutees@omniture.com,Software Test Engineer III,1356,1320,2676
12712,Bertie,Drewry,bdrewryet@about.me,Actuary,7539,659,8198
12322,Arri,Smissen,asmissenev@howstuffworks.com,Human Resources Assistant II,1654,448,2102
12752,Nonna,Stanett,nstanettex@comcast.net,Office Assistant I,9769,1714,11483
12924,Scotty,Rapi,srapiey@pagesperso-orange.fr,Internal Auditor,7698,691,8389
12501,Marthena,Horsburgh,mhorsburghez@hexun.com,Financial Advisor,9485,879,10364
12502,Constance,Calvard,ccalvardf0@comsenz.com,Recruiter,1546,267,1813
12090,Andriana,Kliemchen,akliemchenf5@eepurl.com,Analyst Programmer,9577,269,9846
12614,Alden,Urch,aurchf6@cdbaby.com,Chief Design Engineer,7206,1724,8930
12555,Eugenius,Colecrough,ecolecroughf7@phoca.cz,Assistant Manager,4189,962,5151
12301,Lyndell,Coutts,lcouttsf8@netvibes.com,Account Representative IV,2031,1196,3227
12511,Humfrey,Rickeard,hrickeardf9@digg.com,Help Desk Technician,9470,638,10108
12311,Brande,Faircley,bfaircleyfa@marriott.com,Account Coordinator,3449,1715,5164
12164,Clara,Drakeley,cdrakeleyfb@reference.com,Environmental Tech,5398,874,6272
12305,Bridget,Loble,bloblefc@blogger.com,Pharmacist,7808,1497,9305
12007,Amandi,Neate,aneatefe@umich.edu,Design Engineer,7200,1382,8582
12716,Bar,Elnaugh,belnaughfg@bravesites.com,Registered Nurse,9468,1624,11092
12132,Yasmin,Cabral,ycabralfi@smh.com.au,Automation Specialist I,8021,1149,9170
12888,Ariel,Hrinishin,ahrinishinfk@ebay.com,Project Manager,7694,1478,9172
12129,Rickie,Bentley,rbentleyfm@hexun.com,VP Quality Control,3360,747,4107
12350,Duke,Crimin,dcriminfo@jalbum.net,Graphic Designer,8576,1523,10099
12231,Shamus,Coxall,scoxallfp@lycos.com,Staff Accountant I,6653,238,6891
12413,Seth,Fauning,sfauningfq@clickbank.net,Biostatistician IV,9944,882,10826
12117,Glennie,Brecon,gbreconfs@ask.com,Occupational Therapist,5229,472,5701
12436,Erena,Everist,eeveristfu@reuters.com,Database Administrator III,9746,651,10397
12524,Logan,Skellington,lskellingtonfv@oakley.com,Speech Pathologist,5447,1849,7296
12642,Steffane,Weddeburn,sweddeburnfx@mysql.com,Structural Analysis Engineer,6991,976,7967
12764,Charmian,Owain,cowaing0@barnesandnoble.com,Recruiting Manager,1412,1627,3039
12093,Livvy,Donnell,ldonnellg1@vistaprint.com,Analyst Programmer,3749,318,4067
12161,Dion,Cardenosa,dcardenosag3@answers.com,Help Desk Technician,9877,1220,11097
12363,Barr,Henriksson,bhenrikssong5@themeforest.net,Statistician II,6717,1258,7975
12590,Neile,Lawrie,nlawrieg6@technorati.com,Biostatistician I,5433,962,6395
12005,Bryna,Ranvoise,branvoiseg8@senate.gov,Health Coach III,1910,1807,3717
12704,Dov,Yerill,dyerillga@jimdo.com,Financial Analyst,9149,229,9378
12759,Elmira,Slad,esladgc@slideshare.net,Senior Quality Engineer,2136,704,2840
12886,Stanislaw,Tolerton,stolertongd@bloglovin.com,Administrative Officer,2279,1389,3668
12573,Judas,Pigot,jpigotgg@elpais.com,Web Developer II,3077,1265,4342
12254,Blane,Ruff,bruffgi@ovh.net,Recruiter,3278,1275,4553
12446,Gerrie,Bromhead,gbromheadgv@bloglovin.com,Staff Accountant III,1367,534,1901
12917,Gradeigh,Pedlow,gpedlowgx@mozilla.org,Marketing Manager,2341,1137,3478
12706,Berni,McCutcheon,bmccutcheonh0@list-manage.com,Business Systems Development Analyst,2198,1900,4098
12329,Shirline,Denington,sdeningtonh3@over-blog.com,GIS Technical Architect,2242,281,2523
12075,Jamal,Charrington,jcharringtonh7@photobucket.com,General Manager,2179,1127,3306
12902,Joelie,Rizzone,jrizzoneh8@un.org,Web Designer IV,7256,1303,8559
12383,Nichols,Murrhaupt,nmurrhaupth9@admin.ch,Community Outreach Specialist,9802,687,10489
12016,Yardley,Hilland,yhillandhc@virginia.edu,Web Developer III,6561,1268,7829
12678,Lonee,Culshaw,lculshawhd@comsenz.com,Electrical Engineer,7356,806,8162
12358,Agnes,Roxby,aroxbyhh@bandcamp.com,Information Systems Manager,7301,347,7648
12570,Luigi,Duce,lducehl@businesswire.com,Geologist II,8343,508,8851
12353,Corabella,Cayzer,ccayzerhp@fotki.com,Developer II,2098,1614,3712
12257,Dorrie,Berrygun,dberrygunhq@gnu.org,Analyst Programmer,9737,1537,11274
12097,Raimondo,Tulloch,rtullochhs@europa.eu,Geologist IV,3905,1362,5267
12276,Rudd,Leat,rleatht@newsvine.com,Environmental Specialist,8999,805,9804
12598,Annetta,Silvester,asilvesterhu@china.com.cn,Senior Cost Accountant,4008,1817,5825
12298,Washington,Ruusa,wruusahv@engadget.com,Web Developer III,8026,1592,9618
12795,Cheslie,Niesel,cnieselhw@discuz.net,Assistant Media Planner,1897,660,2557
12485,Charmaine,Liverseege,cliverseegehx@e-recht24.de,Software Test Engineer II,9043,234,9277
12268,Beatrisa,Laybourne,blaybournehz@nps.gov,Help Desk Operator,7916,1956,9872
12441,Remy,Pendred,rpendredi1@merriam-webster.com,Assistant Manager,5279,1799,7078
12530,Edi,Terbrugge,eterbruggei4@abc.net.au,Software Consultant,9074,1267,10341
12645,Benjamen,Strelitzki,bstrelitzkii5@msn.com,Assistant Media Planner,8804,805,9609
12862,Euell,Vardey,evardeyi6@usgs.gov,Actuary,5157,1163,6320
12576,Zarah,Henke,zhenkei7@skype.com,Chief Design Engineer,7861,1494,9355
12453,Odelle,Ochterlony,oochterlonyia@aboutads.info,Computer Systems Analyst III,5593,1613,7206
12646,Batsheva,Farthin,bfarthinib@ycombinator.com,Database Administrator I,1608,1445,3053
12388,Inge,Godsil,igodsilic@economist.com,Financial Advisor,7407,457,7864
12885,Rosemarie,Goundsy,rgoundsyid@mozilla.org,Assistant Media Planner,9357,297,9654
12938,Sandye,Crew,screwif@domainmarket.com,Safety Technician I,3600,1181,4781
12766,Adolphus,Hacard,ahacardii@vkontakte.ru,Assistant Manager,2844,1800,4644
12660,Even,Mummery,emummeryik@pagesperso-orange.fr,Recruiting Manager,3178,1250,4428
12922,Euell,Crickmoor,ecrickmoorio@globo.com,Computer Systems Analyst IV,7260,644,7904
12673,Audry,Wigg,awiggip@hc360.com,Computer Systems Analyst I,3064,1093,4157
12529,Nonnah,Grimsey,ngrimseyir@sciencedirect.com,Speech Pathologist,1013,1000,2013
12599,Bondon,Asplin,basplinis@abc.net.au,Administrative Assistant III,6226,1085,7311
12232,Trixi,Lowndsborough,tlowndsboroughix@dedecms.com,Chemical Engineer,3125,1487,4612
12691,Noland,Panas,npanasiy@house.gov,Human Resources Assistant I,4326,1031,5357
12842,Ricki,Batts,rbattsj3@icq.com,Media Manager IV,2932,765,3697
12735,Lisabeth,Beller,lbellerj4@yellowbook.com,Occupational Therapist,8003,1133,9136
12802,Clair,Stirrip,cstirripjc@arizona.edu,Geologist IV,1930,1411,3341
12775,Gussi,Drayn,gdraynjd@google.ru,Tax Accountant,7184,557,7741
12515,Georgina,Atcherley,gatcherleyjf@themeforest.net,Automation Specialist IV,6913,1419,8332
12266,Bertina,Maric,bmaricjk@yale.edu,Graphic Designer,6810,495,7305
12374,Royal,Arnatt,rarnattjl@guardian.co.uk,Editor,1467,1727,3194
12450,Murry,Eastcott,meastcottjo@printfriendly.com,Staff Scientist,2294,786,3080
12929,Arabele,Ganders,agandersjq@hugedomains.com,Librarian,5375,1225,6600
12564,Moria,Ost,mostjr@psu.edu,Data Coordiator,7358,885,8243
12844,Fabio,Dmisek,fdmisekjs@icio.us,Information Systems Manager,7741,1417,9158
12325,Isidore,MacCallum,imaccallumjz@washingtonpost.com,Assistant Media Planner,9586,836,10422
12723,Gayle,Bitterton,gbittertonk1@hc360.com,Web Designer II,2860,1658,4518
12760,Berenice,Stonnell,bstonnellk2@sina.com.cn,Payment Adjustment Coordinator,7898,229,8127
12027,Gerry,Maltster,gmaltsterk5@nytimes.com,Web Designer IV,7745,942,8687
12302,Addie,Elgie,aelgiek7@twitter.com,Senior Sales Associate,8096,396,8492
12783,Corey,Mathis,cmathisk9@ucla.edu,GIS Technical Architect,7169,302,7471
12370,Bartholomeus,Northgraves,bnorthgraveskc@privacy.gov.au,Compensation Analyst,3194,549,3743
12351,Bjorn,Coddrington,bcoddringtonke@i2i.jp,Structural Analysis Engineer,1317,1613,2930
12954,Prisca,Lownds,plowndskg@flavors.me,Biostatistician III,5763,882,6645
12517,Natalee,Skirrow,nskirrowkh@etsy.com,GIS Technical Architect,2186,1480,3666
12382,Garvin,Hendren,ghendrenkj@networkadvertising.org,Physical Therapy Assistant,6579,1996,8575
12220,Sasha,Ponnsett,sponnsettko@cbc.ca,Internal Auditor,2406,816,3222
12866,Valentijn,Gildersleeve,vgildersleevekp@technorati.com,Office Assistant III,2825,494,3319
12057,Mariejeanne,Tottle,mtottlekq@shareasale.com,VP Accounting,6429,477,6906
12243,Meade,Corser,mcorserks@hhs.gov,Structural Engineer,9619,1087,10706
12964,Marni,De Freyne,mdefreynekt@mashable.com,Executive Secretary,8463,644,9107
12118,Nye,Moogan,nmoogankv@china.com.cn,GIS Technical Architect,2489,1037,3526
12247,Renell,Rawls,rrawlskw@pcworld.com,Human Resources Assistant III,5185,1889,7074
12438,Frederik,De Beauchamp,fdebeauchampkx@icio.us,Database Administrator II,5801,1036,6837
12467,Arman,Speeding,aspeedingl1@altervista.org,Recruiting Manager,1297,1608,2905
12911,Eudora,Boules,eboulesl2@topsy.com,Developer IV,1385,710,2095
12975,Kaylyn,Vela,kvelal8@fema.gov,Marketing Assistant,7264,1916,9180
12721,Abraham,Huard,ahuardla@homestead.com,Staff Scientist,3863,1822,5685
12380,Paloma,Blatcher,pblatcherlb@constantcontact.com,General Manager,9510,314,9824
12808,Olenolin,Lyne,olyneld@yale.edu,Quality Control Specialist,4703,682,5385
12674,Benn,Cheesley,bcheesleyle@zdnet.com,Staff Accountant III,7117,1642,8759
12923,Melba,Grinyakin,mgrinyakinlk@bbb.org,Marketing Manager,4998,272,5270
12542,Corry,Di Biasio,cdibiasioll@fda.gov,Senior Financial Analyst,9024,1669,10693
12702,Patience,Brash,pbrashlm@ucsd.edu,Software Consultant,8441,1654,10095
12145,Umberto,Arends,uarendslp@fema.gov,Software Test Engineer III,2085,870,2955
12101,Salli,Bredee,sbredeelr@sohu.com,Clinical Specialist,8134,792,8926
12738,Vitoria,Ogdahl,vogdahllt@yolasite.com,Account Executive,8367,655,9022
12394,Osbert,Demcik,odemciklu@epa.gov,VP Quality Control,5926,1668,7594
12671,Sarena,Lapsley,slapsleylw@cmu.edu,Mechanical Systems Engineer,1491,1433,2924
12584,Free,Brundall,fbrundalllx@accuweather.com,Staff Accountant I,8960,1589,10549
12620,Johannes,Challens,jchallensm0@oakley.com,Teacher,8292,818,9110
12051,Jude,Titta,jtittam4@merriam-webster.com,Assistant Media Planner,9191,308,9499
12605,Arch,Gligori,agligorim6@reddit.com,Editor,1152,783,1935
12526,Karil,Ryves,kryvesmi@ovh.net,Social Worker,3442,1904,5346
12031,Alvan,Vesco,avescomj@multiply.com,Software Test Engineer II,7853,1238,9091
12519,Hynda,Frankland,hfranklandmk@hp.com,Research Associate,9116,1918,11034
12805,Melanie,Daveran,mdaveranml@bravesites.com,Software Consultant,7930,802,8732
12823,Perry,Lamburn,plamburnmm@t-online.de,Chemical Engineer,6961,259,7220
12989,Genovera,Heiton,gheitonmn@imageshack.us,Budget/Accounting Analyst III,4080,1692,5772
12061,Germain,Formby,gformbymp@flickr.com,Design Engineer,5121,1194,6315
12534,Kissee,Hinchshaw,khinchshawmr@taobao.com,Geologist II,3161,1756,4917
12100,Marthe,Whiskin,mwhiskinmu@stumbleupon.com,Senior Developer,1616,809,2425
12976,Rosita,Russilll,rrussilllmy@sun.com,Actuary,2498,1596,4094
12492,Haze,Sankey,hsankeyn2@unicef.org,Senior Sales Associate,2561,789,3350
12606,Tracy,Murdy,tmurdyn6@meetup.com,General Manager,1830,704,2534
12657,Graehme,Karlicek,gkarlicekn7@webeden.co.uk,Research Assistant I,8289,1355,9644
12757,Justin,Glennon,jglennonna@geocities.jp,Registered Nurse,8503,793,9296
12131,Roderigo,Welchman,rwelchmanne@bandcamp.com,Database Administrator III,3207,1383,4590
12996,Darrick,Kelshaw,dkelshawnf@pen.io,Structural Analysis Engineer,4526,748,5274
12209,Ketty,Demcik,kdemcikng@tinypic.com,Sales Associate,4248,433,4681
12072,Harman,Mongeot,hmongeotnh@delicious.com,Systems Administrator IV,4334,1590,5924
12846,Alister,Few,afewni@mysql.com,Programmer Analyst III,9853,1668,11521
12230,Herold,Slowan,hslowannm@nsw.gov.au,Operator,3697,1856,5553
12105,Kendre,Stegel,kstegelno@forbes.com,Developer III,4515,926,5441
12695,Neddie,Krolman,nkrolmannq@wikipedia.org,Speech Pathologist,9477,883,10360
12224,Ashlan,Dulinty,adulintynr@bluehost.com,Budget/Accounting Analyst I,6326,1173,7499
12496,Shell,Mulcock,smulcockns@bloglines.com,Staff Accountant III,3292,866,4158
12253,Tadeo,Forton,tfortonnv@indiegogo.com,Assistant Manager,3518,1170,4688
12169,Ernestus,Reide,ereidenw@tripod.com,Registered Nurse,7217,678,7895
12099,Nananne,Donner,ndonnero0@studiopress.com,Software Test Engineer IV,1810,550,2360
12155,Irvin,Baty,ibatyo2@dagondesign.com,Librarian,9423,680,10103
12086,Corrine,Shields,cshieldso3@etsy.com,Recruiting Manager,4298,787,5085
12839,Ina,Canete,icaneteo9@foxnews.com,GIS Technical Architect,6341,1705,8046
12073,Allin,Fendley,afendleyoa@chicagotribune.com,Environmental Tech,2633,1075,3708
12857,Atalanta,Tight,atightob@samsung.com,Clinical Specialist,8431,786,9217
12261,Talbot,Sinkins,tsinkinsoe@patch.com,Software Test Engineer IV,9468,1247,10715
12630,Petronia,Murie,pmurieof@jimdo.com,Technical Writer,1568,1967,3535
12327,Ashley,Simioni,asimioniog@php.net,Product Engineer,2451,892,3343
12593,Alexis,Gabbidon,agabbidonoh@tumblr.com,Dental Hygienist,9061,1168,10229
12758,Lonnard,Hazleton,lhazletonon@dot.gov,Operator,6670,586,7256
12489,Angelia,Sammut,asammutoo@newsvine.com,Administrative Assistant IV,1642,1539,3181
12416,Wileen,Stennet,wstennetoq@php.net,Administrative Officer,4547,305,4852
12406,Maggy,Canellas,mcanellasor@independent.co.uk,Environmental Specialist,4736,1593,6329
12907,Edwin,Sedgeworth,esedgeworthos@ed.gov,Editor,9992,1886,11878
12504,Cam,Lindro,clindroou@edublogs.org,Mechanical Systems Engineer,4486,533,5019
12124,Tybi,Noel,tnoeloz@dot.gov,Payment Adjustment Coordinator,9060,364,9424
12791,Shellysheldon,Petricek,spetricekp0@pagesperso-orange.fr,Research Nurse,7679,1488,9167
12490,Willard,Ackerman,wackermanp3@youku.com,Editor,3808,693,4501
12319,Anthony,Bullimore,abullimorep5@parallels.com,Account Representative I,2371,1860,4231
12255,Marve,Harlow,mharlowp6@independent.co.uk,Geologist I,8479,467,8946
12643,Tilda,Fulmen,tfulmenp7@bluehost.com,Project Manager,7680,734,8414
12740,Gail,Schirok,gschirokp8@examiner.com,Senior Editor,6354,1869,8223
12122,Berkley,McCann,bmccannp9@usa.gov,Biostatistician II,4297,962,5259
12348,Gerri,Nehl,gnehlpe@ehow.com,Clinical Specialist,7849,1826,9675
12204,Valentina,Annable,vannablepg@i2i.jp,Help Desk Operator,8231,782,9013
12238,Pearce,Zielinski,pzielinskipj@linkedin.com,Account Executive,7886,1380,9266
12696,Mabel,Draxford,mdraxfordpk@mysql.com,Executive Secretary,1020,806,1826
12583,Hewie,Audiss,haudisspl@reference.com,Occupational Therapist,1684,1233,2917
12675,Berti,Bambury,bbamburypm@house.gov,Media Manager III,4852,486,5338
12872,Lee,Abberley,labberleypo@admin.ch,Web Developer IV,1623,1434,3057
12154,Colby,Sneezum,csneezumpp@ucoz.ru,Graphic Designer,2884,1260,4144
12990,Guthry,Normabell,gnormabellpq@friendfeed.com,Sales Representative,1225,885,2110
12694,Mirabella,Fieldsend,mfieldsendpr@utexas.edu,Cost Accountant,8348,1697,10045
12180,Ruggiero,Bradly,rbradlyps@msu.edu,Geological Engineer,8273,758,9031
12776,Nananne,Cricket,ncricketpu@amazon.co.jp,Product Engineer,2475,1612,4087
12133,Wheeler,Silver,wsilverpw@sina.com.cn,Product Engineer,9233,1498,10731
12262,Arly,Farrand,afarrandpy@unesco.org,Senior Financial Analyst,7423,979,8402
12037,Cherida,Ummfrey,cummfreyq1@delicious.com,Research Nurse,2852,1567,4419
12781,Vale,Hothersall,vhothersallq4@icio.us,Senior Quality Engineer,9488,807,10295
12639,Prescott,Leadbitter,pleadbitterq5@usatoday.com,Payment Adjustment Coordinator,2654,499,3153
12627,Tammy,Rogge,troggeq6@toplist.cz,Mechanical Systems Engineer,2854,1972,4826
12470,Gabriel,Eggers,geggersq9@europa.eu,Health Coach I,8177,1782,9959
12926,Francisco,Reide,freideqd@sogou.com,GIS Technical Architect,5971,1288,7259
12281,Nils,MacVicar,nmacvicarqf@apache.org,Director of Sales,2330,1320,3650
12912,Lindsay,Dwelling,ldwellingqh@pcworld.com,Compensation Analyst,3256,496,3752
12658,Allyn,Picardo,apicardoqk@histats.com,Operator,6941,891,7832
12263,Axel,Dillistone,adillistoneql@miibeian.gov.cn,Senior Developer,8806,1237,10043
12068,Eddy,Espinel,eespinelqm@friendfeed.com,Recruiter,2164,1554,3718
12655,Nye,Crufts,ncruftsqn@hubpages.com,Business Systems Development Analyst,6435,1783,8218
12120,Dylan,Lanston,dlanstonqq@blogtalkradio.com,Data Coordiator,1458,1011,2469
12899,Penrod,Tebbit,ptebbitqr@nhs.uk,Clinical Specialist,6859,1866,8725
12405,Jayme,Gaudin,jgaudinqw@slashdot.org,Assistant Manager,8031,957,8988
12030,Hedvig,Batchelor,hbatchelorqx@elegantthemes.com,Cost Accountant,8240,1775,10015
12957,Keenan,Barrowcliffe,kbarrowcliffeqy@canalblog.com,Quality Control Specialist,1676,1130,2806
12890,Davine,Salle,dsalleqz@springer.com,Database Administrator IV,8123,1637,9760
12948,Tyson,Winterbotham,twinterbothamr0@irs.gov,Financial Advisor,5628,928,6556
12386,Dory,Fitzsymons,dfitzsymonsr1@reference.com,Senior Financial Analyst,2139,1945,4084
12032,Philippa,Ruddock,pruddockr2@tiny.cc,Research Associate,3094,894,3988
12147,Vance,Emmanuel,vemmanuelr4@time.com,Compensation Analyst,2521,1866,4387
12651,Stanleigh,Kirke,skirker5@abc.net.au,Dental Hygienist,8432,269,8701
12203,Paul,Hadgkiss,phadgkissrb@simplemachines.org,Executive Secretary,2553,869,3422
12798,Phelia,Coie,pcoierc@berkeley.edu,Administrative Officer,7707,286,7993
12836,Bronny,Chettle,bchettlerd@github.io,Cost Accountant,3774,918,4692
12038,Gayleen,Gribble,ggribblerf@addtoany.com,Dental Hygienist,5624,1165,6789
12364,Denna,Merrilees,dmerrileesri@xrea.com,Data Coordiator,6430,599,7029
12023,Kaitlin,Ducker,kduckerrj@livejournal.com,Assistant Media Planner,1390,1487,2877
12945,Arlana,Byford,abyfordrl@gnu.org,Electrical Engineer,5165,793,5958
12528,Kylie,Mila,kmilaro@odnoklassniki.ru,Information Systems Manager,6814,1191,8005
12461,Laverna,Hunsworth,lhunsworthrq@cisco.com,Registered Nurse,6635,503,7138
12895,Quinn,Antonognoli,qantonognolirr@reuters.com,Computer Systems Analyst III,1931,761,2692
13129,Ellie,Kraut,ekraut0@imgur.com,Account Representative IV,4952,1198,6150
13650,Carny,Rosa,crosa1@barnesandnoble.com,Data Coordiator,5598,1028,6626
13015,Danielle,Jager,djager2@slate.com,Product Engineer,2868,1285,4153
13256,Marlowe,Rossant,mrossant3@sakura.ne.jp,VP Quality Control,8823,709,9532
13694,Brit,Nials,bnials4@cmu.edu,Quality Control Specialist,1107,1730,2837
13831,Conrad,Rabbage,crabbage5@cnet.com,Occupational Therapist,5359,458,5817
13097,Brit,Coates,bcoates6@blogs.com,Technical Writer,8582,1495,10077
13303,Wait,Heggison,wheggison7@cloudflare.com,Automation Specialist IV,5797,1448,7245
13741,Brittan,Mackelworth,bmackelworth8@vk.com,Information Systems Manager,8810,583,9393
13729,Catha,Faltin,cfaltin9@oakley.com,Nuclear Power Engineer,8924,1631,10555
13093,Virge,Bosworth,vboswortha@time.com,Research Nurse,2479,339,2818
13042,Adeline,Philpotts,aphilpottsb@salon.com,Internal Auditor,4953,994,5947
13623,Kristi,Flynn,kflynnc@linkedin.com,Help Desk Technician,4625,1346,5971
13077,Cathy,Date,cdated@sitemeter.com,Tax Accountant,2269,1231,3500
13456,Quintana,Orrey,qorreye@fema.gov,Quality Engineer,2796,1113,3909
13315,Marquita,Arnke,marnkef@multiply.com,Senior Sales Associate,1465,614,2079
13899,Nevins,Davie,ndavieg@ox.ac.uk,Structural Engineer,7040,589,7629
13399,Rabbi,Dorey,rdoreyh@elpais.com,Web Developer II,4853,243,5096
13652,Chrissie,Hansill,chansilli@photobucket.com,Analog Circuit Design manager,3260,1222,4482
13238,Giacobo,Hadlington,ghadlingtonj@chicagotribune.com,Web Developer IV,8575,1953,10528
13217,Alfie,Deners,adenersk@edublogs.org,Community Outreach Specialist,1484,281,1765
13482,Damita,Hannaford,dhannafordl@pagesperso-orange.fr,Dental Hygienist,6088,1709,7797
13270,Dolley,Andreasson,dandreassonm@microsoft.com,GIS Technical Architect,9032,605,9637
13516,Beth,Davoren,bdavorenn@infoseek.co.jp,Editor,3454,1545,4999
13273,Fidelity,Sautter,fsauttero@nps.gov,Human Resources Assistant IV,9007,1062,10069
13968,Ondrea,Brearley,obrearleyp@webeden.co.uk,Software Consultant,7502,965,8467
13488,Astrix,Saipy,asaipyq@cyberchimps.com,Project Manager,3267,1859,5126
13326,Darren,Sacaze,dsacazer@arstechnica.com,Recruiter,7782,1188,8970
13592,Myrtice,Britch,mbritchs@usa.gov,Web Designer IV,4630,1937,6567
13296,Ambrosio,Abley,aableyt@mac.com,Associate Professor,5322,1697,7019
13765,Francesca,Ellick,fellicku@bbc.co.uk,Financial Advisor,1384,1518,2902
13137,Margareta,MacKenney,mmackenneyv@google.pl,Recruiter,8322,1008,9330
13549,Korry,Trusler,ktruslerw@blogger.com,Environmental Tech,1720,1868,3588
13186,Tyrus,Luigi,tluigix@businesswire.com,Staff Accountant IV,2372,1398,3770
13851,Demetris,Cranmere,dcranmerey@imgur.com,Accounting Assistant IV,1489,1946,3435
13463,Ernst,Louden,eloudenz@123-reg.co.uk,VP Sales,8645,1434,10079
13126,Georgia,Merrigan,gmerrigan10@ihg.com,Staff Accountant IV,7375,798,8173
13044,Marja,Hempel,mhempel12@hexun.com,Paralegal,6056,2000,8056
13509,Tiffie,Isaksson,tisaksson13@shinystat.com,GIS Technical Architect,3893,1011,4904
13184,Kirstyn,Gaytor,kgaytor14@google.de,Help Desk Operator,9105,273,9378
13807,Roberto,Levings,rlevings15@bing.com,Safety Technician III,1024,1573,2597
13680,Jemimah,Reeme,jreeme16@godaddy.com,Senior Cost Accountant,6919,886,7805
13049,Rance,Massy,rmassy17@dailymotion.com,Biostatistician III,1698,1777,3475
13156,Moise,Cypler,mcypler18@nymag.com,Senior Financial Analyst,4825,1023,5848
13649,Colene,Mitrovic,cmitrovic19@fastcompany.com,Research Nurse,5379,619,5998
13829,Cory,Howson,chowson1a@wired.com,Social Worker,4257,1854,6111
13472,Trevor,Mattioli,tmattioli1b@cloudflare.com,Web Developer III,8547,1568,10115
13755,Ferd,Piatkow,fpiatkow1c@businessweek.com,Senior Editor,5560,1555,7115
13962,Gayleen,Jendas,gjendas1d@themeforest.net,Chemical Engineer,4704,1980,6684
13526,Birgit,Francesconi,bfrancesconi1e@ihg.com,Staff Accountant III,7078,1842,8920
13903,Katherine,Weavill,kweavill1f@sbwire.com,Senior Editor,1490,1179,2669
13287,Renaldo,Mepham,rmepham1g@t-online.de,GIS Technical Architect,7230,419,7649
13498,Antone,Michiel,amichiel1h@acquirethisname.com,Help Desk Technician,5697,1875,7572
13705,Hendrika,Quested,hquested1i@is.gd,Safety Technician I,9248,1399,10647
13109,Lissi,Wiggett,lwiggett1j@instagram.com,Research Associate,6416,591,7007
13328,Sharline,Whatham,swhatham1k@arizona.edu,Sales Representative,6575,686,7261
13843,Antonio,Sherwill,asherwill1l@uol.com.br,Senior Quality Engineer,4690,1477,6167
13260,Oona,Goley,ogoley1m@msn.com,Assistant Professor,4904,1162,6066
13841,Dix,Royle,droyle1n@xinhuanet.com,Speech Pathologist,8922,548,9470
13497,Noby,Jedrzejczak,njedrzejczak1o@examiner.com,VP Accounting,6566,336,6902
13999,Tally,Bathurst,tbathurst1p@csmonitor.com,Web Designer I,7092,800,7892
13209,Celesta,Blumsom,cblumsom1q@behance.net,Nuclear Power Engineer,6959,1885,8844
13657,Keslie,Danett,kdanett1r@oaic.gov.au,Media Manager III,7609,868,8477
13759,Murry,Khristoforov,mkhristoforov1s@nbcnews.com,Staff Scientist,3675,546,4221
13153,Arch,Hulles,ahulles1t@devhub.com,Marketing Manager,8801,1491,10292
13844,Liza,Bockh,lbockh1u@wikia.com,Internal Auditor,1255,654,1909
13654,Jess,Hedden,jhedden1v@webeden.co.uk,Environmental Specialist,6585,1627,8212
13043,Viola,Cheng,vcheng1w@cocolog-nifty.com,Statistician IV,6697,619,7316
13902,Hetty,Elgram,helgram1x@vk.com,Tax Accountant,1852,519,2371
13158,Eachelle,Dehm,edehm1y@gravatar.com,VP Marketing,5029,300,5329
13635,Beatrisa,McSweeney,bmcsweeney1z@kickstarter.com,Geologist I,7158,1957,9115
13920,Alden,Cowthard,acowthard20@state.tx.us,Food Chemist,3693,930,4623
13408,Dorey,Clarkin,dclarkin21@ucoz.com,Tax Accountant,9215,1016,10231
13292,Lester,Mibourne,lmibourne22@typepad.com,General Manager,1287,1554,2841
13458,Emmott,Bisterfeld,ebisterfeld24@alibaba.com,Social Worker,9669,475,10144
13937,Ansley,Stamps,astamps25@mozilla.com,Programmer Analyst III,5148,497,5645
13304,Cesar,Mauditt,cmauditt26@census.gov,Biostatistician IV,3021,381,3402
13743,Olwen,Kyd,okyd27@dailymotion.com,Pharmacist,3516,897,4413
13377,Rogerio,Farthin,rfarthin28@nature.com,Analyst Programmer,4112,1932,6044
13751,Welsh,Bruton,wbruton29@printfriendly.com,Paralegal,2130,867,2997
13379,Vanessa,Morse,vmorse2a@biglobe.ne.jp,Cost Accountant,2394,965,3359
13047,Moss,Sowerby,msowerby2b@tinyurl.com,Staff Accountant I,8181,1549,9730
13033,Suzie,Brosi,sbrosi2c@diigo.com,Analyst Programmer,4309,1530,5839
13225,Juan,Le Batteur,jlebatteur2d@harvard.edu,Clinical Specialist,1310,749,2059
13517,Laurel,Radage,lradage2e@free.fr,Quality Engineer,6480,424,6904
13396,Allistir,Hubbock,ahubbock2f@seattletimes.com,Physical Therapy Assistant,8462,376,8838
13704,Si,Folder,sfolder2g@earthlink.net,Executive Secretary,6206,1102,7308
13030,Jedediah,Lethbridge,jlethbridge2h@ihg.com,Safety Technician II,2623,1145,3768
13587,Camey,Hebborn,chebborn2i@mysql.com,Help Desk Technician,2540,950,3490
13874,Vinny,Gillibrand,vgillibrand2j@geocities.jp,Product Engineer,8682,834,9516
13421,Vick,Halford,vhalford2k@cargocollective.com,Payment Adjustment Coordinator,8569,1041,9610
13582,Rochella,Ubsdell,rubsdell2l@homestead.com,Tax Accountant,7263,1533,8796
13251,Turner,Serrurier,tserrurier2m@delicious.com,Legal Assistant,1948,1836,3784
13451,Lorne,Petrozzi,lpetrozzi2n@discuz.net,Staff Accountant IV,1766,1151,2917
13905,Addy,Tyt,atyt2o@over-blog.com,Web Designer II,1732,823,2555
13319,Hildegarde,Swinburn,hswinburn2q@weebly.com,Desktop Support Technician,5083,1631,6714
13395,Aviva,Merryfield,amerryfield2r@nba.com,Environmental Specialist,4747,1732,6479
13989,Yves,Gubbin,ygubbin2s@patch.com,Operator,1961,1191,3152
13325,Myrtia,Anthona,manthona2t@1und1.de,Software Test Engineer II,2577,890,3467
13072,Eric,Bentke,ebentke2u@cam.ac.uk,Editor,7991,771,8762
13584,Kiah,Page,kpage2v@imgur.com,Paralegal,9699,1347,11046
13886,Archibaldo,Kelloway,akelloway2w@de.vu,Payment Adjustment Coordinator,1875,1216,3091
13352,Ardyce,Janc,ajanc2y@japanpost.jp,Senior Quality Engineer,5695,828,6523
13144,Martynne,Spellacy,mspellacy2z@blogger.com,Research Nurse,8542,527,9069
13604,Romeo,Bundey,rbundey30@ocn.ne.jp,Nuclear Power Engineer,9442,1238,10680
13442,Dorthea,Coare,dcoare31@purevolume.com,Analog Circuit Design manager,1728,1238,2966
13266,Tory,Kubal,tkubal32@moonfruit.com,Financial Advisor,8636,1195,9831
13425,Petronille,Spain-Gower,pspaingower33@biblegateway.com,Administrative Assistant III,4042,1795,5837
13404,Rancell,Richmont,rrichmont34@cmu.edu,Registered Nurse,6164,1195,7359
13159,Louis,Bartle,lbartle35@mit.edu,Director of Sales,9092,558,9650
13359,Sigfrid,Shawley,sshawley36@webmd.com,Pharmacist,6225,1637,7862
13795,Kat,McGinlay,kmcginlay39@wisc.edu,Graphic Designer,7567,1181,8748
13554,Shaun,Doreward,sdoreward3a@friendfeed.com,Staff Accountant III,2167,1999,4166
13521,Hammad,Dobel,hdobel3b@uol.com.br,Quality Engineer,7046,1014,8060
13279,Dulcy,Keeltagh,dkeeltagh3c@latimes.com,Community Outreach Specialist,3471,652,4123
13227,Ilysa,Roylance,iroylance3d@e-recht24.de,Database Administrator IV,8081,680,8761
13323,Zandra,Teliga,zteliga3e@mail.ru,Recruiting Manager,2767,947,3714
13483,Harold,Tetla,htetla3g@boston.com,Community Outreach Specialist,1284,1256,2540
13638,Norrie,Leavry,nleavry3h@paginegialle.it,Assistant Professor,1755,886,2641
13519,Elspeth,Kubach,ekubach3i@naver.com,Senior Quality Engineer,4273,205,4478
13265,Berni,Ebbles,bebbles3j@youtu.be,Graphic Designer,9999,1083,11082
13346,Cherlyn,Newlove,cnewlove3m@sogou.com,Structural Analysis Engineer,8109,933,9042
13620,Gabriela,Cardon,gcardon3n@bigcartel.com,Associate Professor,8659,489,9148
13071,Eirena,Barrar,ebarrar3o@i2i.jp,Help Desk Technician,8491,1326,9817
13927,Sissie,Whipple,swhipple3p@ebay.com,Payment Adjustment Coordinator,4108,460,4568
13229,Wilie,Bednall,wbednall3q@forbes.com,Cost Accountant,8391,787,9178
13397,Myranda,M'Barron,mmbarron3r@netvibes.com,Help Desk Operator,6265,878,7143
13006,Chris,Madgwick,cmadgwick3s@zimbio.com,Accountant III,8741,1230,9971
13031,Gilly,Huffer,ghuffer3t@mapy.cz,VP Product Management,8339,204,8543
13994,Helenka,Kebell,hkebell3u@booking.com,Assistant Manager,4773,1048,5821
13314,Mandie,McDuffy,mmcduffy3v@cloudflare.com,Cost Accountant,5065,1403,6468
13988,Erskine,Klimmek,eklimmek3w@51.la,Accounting Assistant III,1922,815,2737
13803,Whitby,Plascott,wplascott3x@moonfruit.com,Senior Quality Engineer,4354,624,4978
13459,Carly,Blader,cblader3z@amazon.com,Operator,9233,613,9846
13478,Kristan,Betonia,kbetonia41@rambler.ru,Software Consultant,9183,1128,10311
13441,Pippy,Shevlin,pshevlin43@gmpg.org,Human Resources Manager,9093,1376,10469
13812,Merrel,Ferretti,mferretti44@icq.com,Director of Sales,3184,1569,4753
13792,Ced,Macon,cmacon45@va.gov,Dental Hygienist,7829,263,8092
13921,Avril,Mozzetti,amozzetti46@moonfruit.com,Chemical Engineer,6870,969,7839
13667,Gunar,Leftwich,gleftwich47@yolasite.com,Professor,6471,300,6771
13965,Beilul,Boij,bboij48@g.co,Associate Professor,9107,1194,10301
13651,Fax,Bucky,fbucky49@arizona.edu,Business Systems Development Analyst,9026,714,9740
13707,Antonia,Spohr,aspohr4a@bbc.co.uk,Senior Financial Analyst,9078,993,10071
13870,Dulcinea,Chavez,dchavez4b@cdc.gov,Environmental Specialist,3405,433,3838
13808,Saudra,Symon,ssymon4c@t-online.de,Clinical Specialist,6886,1513,8399
13735,Brigham,Lissimore,blissimore4d@elegantthemes.com,Account Coordinator,1557,538,2095
13471,Jeana,Sorrel,jsorrel4e@shinystat.com,Desktop Support Technician,6054,833,6887
13480,Maurise,Merricks,mmerricks4f@multiply.com,Database Administrator III,1440,1848,3288
13114,Gayler,Cazalet,gcazalet4g@alibaba.com,Chemical Engineer,7477,292,7769
13880,Winona,Gallardo,wgallardo4h@imdb.com,Assistant Media Planner,4146,1433,5579
13504,Carrie,Adnams,cadnams4i@furl.net,Clinical Specialist,5829,275,6104
13288,Damaris,Olyff,dolyff4j@bigcartel.com,Account Executive,4138,808,4946
13250,Vladamir,Batman,vbatman4k@livejournal.com,Clinical Specialist,6875,1929,8804
13187,Wyn,Carrington,wcarrington4l@twitter.com,Chief Design Engineer,1802,1133,2935
13508,Fremont,Drewe,fdrewe4m@theglobeandmail.com,Nurse,8158,746,8904
13487,Winona,Mattin,wmattin4o@furl.net,Administrative Assistant II,7967,547,8514
13272,Biddie,Cartledge,bcartledge4p@unc.edu,VP Sales,5547,2000,7547
13721,Ulrikaumeko,Edison,uedison4q@foxnews.com,Statistician II,2576,1964,4540
13111,Dyna,Ramsted,dramsted4r@barnesandnoble.com,Accounting Assistant II,4170,441,4611
13531,Jervis,Spriggin,jspriggin4s@elegantthemes.com,Software Engineer II,1479,1399,2878
13772,Alie,Sollas,asollas4t@apple.com,Developer I,6961,855,7816
13170,Christi,Carbine,ccarbine4u@merriam-webster.com,Environmental Tech,5948,1339,7287
13922,Bentley,Tortice,btortice4v@house.gov,Pharmacist,8737,771,9508
13357,Sammie,Lestrange,slestrange4x@acquirethisname.com,Health Coach II,1307,1594,2901
13244,Christian,Barstowk,cbarstowk4y@ftc.gov,Web Designer I,6382,1501,7883
13373,Jamaal,Strutt,jstrutt4z@mysql.com,Clinical Specialist,2869,1306,4175
13192,Alic,Clery,aclery50@latimes.com,Research Assistant IV,3814,635,4449
13090,Barrie,Baiss,bbaiss51@bloglines.com,Tax Accountant,9232,446,9678
13634,Chickie,McNiff,cmcniff52@tmall.com,Engineer IV,5918,407,6325
13533,Shalna,Tegeller,stegeller53@feedburner.com,Cost Accountant,8411,1283,9694
13294,Rozele,Humpherson,rhumpherson54@storify.com,Community Outreach Specialist,2803,722,3525
13481,Antonia,Houseman,ahouseman55@acquirethisname.com,Business Systems Development Analyst,6452,355,6807
13798,Vi,Wynne,vwynne56@google.co.uk,Community Outreach Specialist,5844,1423,7267
13570,Gino,Milmith,gmilmith58@businessinsider.com,Design Engineer,6298,350,6648
13858,Gabriele,Chazette,gchazette59@bloglovin.com,Financial Analyst,1944,1654,3598
13579,Godart,Strelitz,gstrelitz5a@bluehost.com,Nuclear Power Engineer,9637,1828,11465
13754,Vinson,Amps,vamps5b@delicious.com,Nurse Practicioner,6464,1120,7584
13474,Brynn,Bomb,bbomb5c@apple.com,GIS Technical Architect,7038,598,7636
13422,Yardley,Ettery,yettery5d@pen.io,Electrical Engineer,4490,622,5112
13414,Vassily,Blandamore,vblandamore5e@paypal.com,Director of Sales,9999,1844,11843
13465,Kylynn,Margett,kmargett5f@blog.com,Human Resources Manager,1691,463,2154
13239,Filmore,Becke,fbecke5g@tripod.com,Human Resources Manager,8073,245,8318
13208,Greggory,Spillman,gspillman5i@technorati.com,Environmental Tech,8069,416,8485
13436,Gracia,Raunds,graunds5j@usatoday.com,Help Desk Operator,4999,1348,6347
13976,Antonie,Widmoor,awidmoor5k@twitpic.com,Paralegal,6538,1059,7597
13514,Aubine,Hefferon,ahefferon5l@g.co,Product Engineer,7799,1983,9782
13616,Mart,O'Neill,moneill5q@theguardian.com,Developer IV,4846,1148,5994
13910,Angelico,Oxx,aoxx5r@freewebs.com,Software Engineer IV,8318,1131,9449
13732,Adolpho,Cavolini,acavolini5s@tripadvisor.com,Web Designer II,3335,1654,4989
13877,Christoph,Francis,cfrancis5t@unblog.fr,Pharmacist,6309,685,6994
13157,Janey,Evamy,jevamy5v@digg.com,Operator,4161,576,4737
13811,Guilbert,St. Quintin,gstquintin5w@goo.ne.jp,VP Sales,4075,1187,5262
13611,Leola,Langtry,llangtry5x@symantec.com,Product Engineer,7175,1545,8720
13417,Adoree,Caccavale,acaccavale5y@loc.gov,VP Product Management,3122,1615,4737
13025,Sallyanne,Althrope,salthrope5z@bloglovin.com,Senior Financial Analyst,2273,320,2593
13618,Jobey,Keighley,jkeighley60@last.fm,Human Resources Assistant IV,6141,933,7074
13923,Zebulon,Michiel,zmichiel61@php.net,Analyst Programmer,8508,1097,9605
13957,Fionna,Shuttle,fshuttle62@redcross.org,Speech Pathologist,1004,1129,2133
13827,Emmy,Thorlby,ethorlby63@soup.io,VP Quality Control,5025,1254,6279
13889,Joelle,Sargeant,jsargeant64@newsvine.com,Tax Accountant,3579,412,3991
13449,Charlot,Skyppe,cskyppe65@drupal.org,Senior Cost Accountant,9905,990,10895
13438,Allys,Hasard,ahasard66@nbcnews.com,Engineer III,4851,1014,5865
13871,Issi,Brecher,ibrecher67@bloomberg.com,Operator,8162,721,8883
13907,Katleen,Brace,kbrace68@amazon.de,Recruiter,4311,1782,6093
13628,Christabel,Missenden,cmissenden69@themeforest.net,Tax Accountant,7191,1009,8200
13122,Lucio,Jukubczak,ljukubczak6a@1und1.de,Web Designer II,6024,1861,7885
13864,Albertina,Yonge,ayonge6b@live.com,Cost Accountant,2509,1067,3576
13409,Gnni,Duplock,gduplock6c@ted.com,Structural Analysis Engineer,7615,1504,9119
13455,Faustine,Bourner,fbourner6d@geocities.com,Senior Sales Associate,8670,1927,10597
13108,Blake,Pimbley,bpimbley6e@dyndns.org,VP Sales,6472,1997,8469
13371,Gates,Fruish,gfruish6f@goodreads.com,Financial Advisor,9353,1414,10767
13053,Hilton,Jose,hjose6g@bluehost.com,Account Executive,3700,747,4447
13682,Violet,Pulsford,vpulsford6h@homestead.com,Software Engineer I,4230,1778,6008
13128,Carter,Minithorpe,cminithorpe6i@dyndns.org,Environmental Tech,1610,718,2328
13500,Mason,Kernaghan,mkernaghan6k@pagesperso-orange.fr,Financial Advisor,2013,371,2384
13476,Aveline,Varcoe,avarcoe6m@ocn.ne.jp,Operator,7160,1198,8358
13666,Dukie,Pech,dpech6n@fotki.com,Compensation Analyst,6844,957,7801
13929,Dyanne,Guise,dguise6o@nsw.gov.au,Recruiting Manager,4257,1798,6055
13154,Brewer,Freezor,bfreezor6p@marketwatch.com,Research Nurse,9457,653,10110
13271,Collen,Haggarth,chaggarth6r@weebly.com,Product Engineer,8953,1120,10073
13890,Jock,Cunney,jcunney6s@noaa.gov,Social Worker,8983,1602,10585
13857,Joline,Cubley,jcubley6t@moonfruit.com,Business Systems Development Analyst,5953,1933,7886
13363,Ryun,Riggeard,rriggeard6u@csmonitor.com,Senior Financial Analyst,5069,967,6036
13423,Carmel,Alliband,calliband6v@patch.com,Editor,4487,1304,5791
13824,Eldridge,Kopisch,ekopisch6w@ebay.co.uk,Teacher,4507,764,5271
13689,Brendin,Hazelhurst,bhazelhurst6x@wikispaces.com,Mechanical Systems Engineer,4071,1330,5401
13915,Gwennie,Beare,gbeare6y@squidoo.com,Dental Hygienist,1092,1371,2463
13933,Jacobo,Luckcuck,jluckcuck70@posterous.com,Legal Assistant,6186,1210,7396
13020,Mureil,Mardlin,mmardlin71@yale.edu,Chief Design Engineer,3249,1488,4737
13869,Una,Fetter,ufetter72@wix.com,GIS Technical Architect,1150,928,2078
13102,Petronia,Costanza,pcostanza74@taobao.com,Chemical Engineer,2454,1377,3831
13887,Erik,Garrett,egarrett79@pen.io,Research Assistant III,6664,705,7369
13040,Gilberte,Allston,gallston7a@buzzfeed.com,Web Designer I,7577,558,8135
13506,Deane,O'Cannan,docannan7b@sohu.com,Nurse Practicioner,2732,927,3659
13993,Alasteir,Jaggi,ajaggi7c@slashdot.org,Marketing Assistant,8657,1767,10424
13041,Karlotte,Heckney,kheckney7d@twitter.com,Financial Advisor,7058,414,7472
13324,Tedd,Chadderton,tchadderton7e@wordpress.org,Systems Administrator I,7560,278,7838
13894,Gabi,Dight,gdight7f@hao123.com,Research Assistant IV,5792,250,6042
13701,Deanna,Benbough,dbenbough7h@marriott.com,Senior Financial Analyst,2497,214,2711
13586,Marcela,O'Glessane,moglessane7i@virginia.edu,Speech Pathologist,9687,1450,11137
13145,Ximenez,Haythorn,xhaythorn7j@bloglovin.com,Analog Circuit Design manager,7035,1112,8147
13160,Remus,Windows,rwindows7k@typepad.com,Paralegal,9362,681,10043
13663,Darrick,Storrier,dstorrier7l@histats.com,Tax Accountant,8264,793,9057
13224,Helaina,Sinnett,hsinnett7m@behance.net,Sales Representative,1321,1938,3259
13219,Tony,Giacomo,tgiacomo7n@bloglines.com,Marketing Assistant,8258,330,8588
13973,Mike,Carvil,mcarvil7o@slideshare.net,Staff Scientist,5141,1323,6464
13810,Tony,Fearby,tfearby7p@squidoo.com,Quality Control Specialist,5270,1842,7112
13990,Babara,Issit,bissit7q@alibaba.com,Graphic Designer,5269,1205,6474
13120,Stephan,Robeson,srobeson7r@auda.org.au,Senior Developer,7717,1285,9002
13149,Arel,Lade,alade7s@chron.com,Web Developer II,3507,1492,4999
13486,Balduin,Burgane,bburgane7t@naver.com,Biostatistician IV,9928,1243,11171
13291,Natalina,Flaune,nflaune7u@adobe.com,Teacher,1112,520,1632
13200,Josefina,Crewdson,jcrewdson7v@cornell.edu,Engineer III,6797,1724,8521
13569,Cully,Grossman,cgrossman7w@addthis.com,Senior Developer,6493,595,7088
13633,Olvan,Kienl,okienl7x@bigcartel.com,Financial Advisor,3922,837,4759
13726,Olivie,Nannini,onannini7y@yolasite.com,Biostatistician I,7832,1971,9803
13848,Kittie,Bowers,kbowers7z@epa.gov,Junior Executive,6318,1734,8052
13770,Archibold,Murdoch,amurdoch81@nytimes.com,Research Associate,6054,823,6877
13443,Margarethe,Apedaile,mapedaile82@sciencedaily.com,Business Systems Development Analyst,6295,1647,7942
13737,Bert,Wainman,bwainman83@wordpress.com,Data Coordiator,6479,1192,7671
13243,Sallyanne,Bestman,sbestman85@forbes.com,Product Engineer,9662,233,9895
13567,Ora,Kull,okull88@cam.ac.uk,Senior Quality Engineer,4881,1624,6505
13775,Corbin,Boycott,cboycott89@privacy.gov.au,Technical Writer,5728,471,6199
13045,Andeee,Chalke,achalke8a@prlog.org,Database Administrator IV,8215,1218,9433
13372,Giulietta,Keasy,gkeasy8d@washington.edu,Help Desk Operator,7349,953,8302
13174,Karalee,Skoof,kskoof8f@samsung.com,Web Designer II,5633,621,6254
13354,Pammy,Bullick,pbullick8h@kickstarter.com,Financial Analyst,5006,352,5358
13119,Rivy,Langeren,rlangeren8j@apache.org,Senior Sales Associate,1098,1870,2968
13505,Ola,Ray,oray8k@nba.com,Staff Accountant I,2124,1232,3356
13206,Bobbette,Stonebanks,bstonebanks8l@washington.edu,Software Test Engineer IV,2844,1888,4732
13748,Corrine,Henkens,chenkens8m@vinaora.com,Actuary,7360,1509,8869
13794,Lou,Flowerden,lflowerden8n@geocities.jp,Staff Scientist,2430,427,2857
13896,Mariya,Donhardt,mdonhardt8o@reddit.com,Recruiting Manager,2838,958,3796
13820,Bessie,Frostdicke,bfrostdicke8p@telegraph.co.uk,Librarian,6042,1099,7141
13855,Audi,Worsnop,aworsnop8q@t.co,Nuclear Power Engineer,8479,581,9060
13594,Teodoor,Maccrie,tmaccrie8r@timesonline.co.uk,VP Marketing,1955,592,2547
13859,Ruby,Hawton,rhawton8s@sphinn.com,Analyst Programmer,6389,1783,8172
13688,Dennie,Sibbe,dsibbe8t@amazon.co.uk,Structural Analysis Engineer,5323,1077,6400
13940,Ilysa,Ccomini,iccomini8u@irs.gov,Community Outreach Specialist,9228,1639,10867
13412,Worthington,Dearnley,wdearnley8w@digg.com,Human Resources Assistant III,4808,1285,6093
13142,Elka,Bricham,ebricham8y@issuu.com,Sales Associate,3265,1388,4653
13302,Jenn,Beckson,jbeckson8z@nps.gov,Social Worker,2995,1849,4844
13374,Fanchon,Van den Hof,fvandenhof90@ft.com,Research Associate,4126,1230,5356
13580,Kirbee,Ible,kible91@blinklist.com,Clinical Specialist,8829,586,9415
13815,Feliks,Forrington,fforrington92@g.co,Budget/Accounting Analyst II,9253,425,9678
13679,Faye,Dur,fdur94@salon.com,Systems Administrator II,2471,1042,3513
13245,Rabi,Seaborne,rseaborne95@baidu.com,Senior Cost Accountant,5269,1811,7080
13875,Vivia,Jostan,vjostan97@marketwatch.com,Sales Representative,3325,1819,5144
13418,Cristionna,Buzek,cbuzek98@dailymail.co.uk,Accounting Assistant II,8158,1130,9288
13008,Evyn,Goddman,egoddman9a@sogou.com,Staff Accountant IV,8826,1010,9836
13490,Ham,Dunnico,hdunnico9d@google.com.au,Research Nurse,2583,841,3424
13180,Garold,Warters,gwarters9e@a8.net,Nurse Practicioner,3346,935,4281
13057,Dirk,Millson,dmillson9g@paypal.com,Actuary,3602,1169,4771
13782,Elbertina,Konke,ekonke9h@oracle.com,Developer IV,2020,1560,3580
13837,Melisse,Dixsee,mdixsee9j@amazon.co.uk,Geologist I,6025,1950,7975
13642,Vito,Mattiato,vmattiato9l@google.com.br,Data Coordiator,6646,1467,8113
13544,Mikel,Stango,mstango9o@bravesites.com,Quality Control Specialist,4158,1550,5708
13268,Peter,Domerc,pdomerc9p@dell.com,Design Engineer,1980,932,2912
13908,Basil,Sherwen,bsherwen9t@xing.com,Mechanical Systems Engineer,3062,664,3726
13802,Esme,Bennike,ebennike9u@360.cn,Quality Control Specialist,4827,1549,6376
13971,Lorenza,De Mattia,ldemattia9v@statcounter.com,Database Administrator II,8499,1026,9525
13966,Oliver,Spedroni,ospedroni9y@google.com.hk,Staff Accountant II,5216,819,6035
13897,Myrilla,Vickerstaff,mvickerstaff9z@ftc.gov,Civil Engineer,3718,944,4662
13021,Lock,Collomosse,lcollomossea0@angelfire.com,Quality Engineer,7255,228,7483
13687,Helyn,Frigot,hfrigota2@about.com,Web Developer I,3505,1493,4998
13845,Iseabal,Dall,idalla3@slideshare.net,Nurse Practicioner,4461,1441,5902
13494,Griffin,Randell,grandella4@desdev.cn,Cost Accountant,1400,1339,2739
13818,Vanda,Airton,vairtona7@1und1.de,Assistant Professor,8328,252,8580
13389,Ganny,Padginton,gpadgintona8@netlog.com,Budget/Accounting Analyst III,7193,1482,8675
13123,Billy,Blenkinsop,bblenkinsopa9@feedburner.com,Tax Accountant,5536,693,6229
13849,Collie,Johann,cjohannaa@ft.com,Human Resources Assistant III,1832,1046,2878
13984,Stefanie,Sturch,ssturchab@elegantthemes.com,VP Marketing,2115,1001,3116
13597,Marga,Castle,mcastleac@flickr.com,Administrative Officer,6866,1426,8292
13384,Carolyn,Brigdale,cbrigdalead@amazonaws.com,Operator,4125,550,4675
13882,Camala,Beckitt,cbeckittaf@geocities.jp,Research Associate,3764,1544,5308
13286,Paco,Scutter,pscutterag@theatlantic.com,Environmental Tech,1664,378,2042
13552,Stephanie,Hallford,shallfordah@usa.gov,Professor,9246,716,9962
13535,Klarika,Hallas,khallasai@apple.com,Staff Scientist,8940,1254,10194
13218,Siouxie,Pickring,spickringal@deliciousdays.com,Financial Advisor,5641,1004,6645
13333,Yanaton,Sutcliff,ysutcliffam@about.me,VP Product Management,8012,508,8520
13768,Wakefield,Egre,wegrean@nature.com,Environmental Tech,2242,509,2751
13614,Ddene,Bishell,dbishellao@yelp.com,Chemical Engineer,8206,274,8480
13171,Shirline,Randell,srandellap@ebay.com,Compensation Analyst,7626,513,8139
13784,Ethelred,Sprake,esprakear@symantec.com,Assistant Professor,8493,887,9380
13402,Dew,Spittles,dspittlesat@plala.or.jp,Registered Nurse,3176,1079,4255
13982,Misti,Godson,mgodsonau@bloglines.com,Senior Sales Associate,7206,1285,8491
13009,Xenia,Bolesworth,xbolesworthax@yandex.ru,Design Engineer,6195,789,6984
13764,Lizzy,Sherry,lsherryay@github.io,Information Systems Manager,3688,1826,5514
13113,Bartlett,Fermer,bfermeraz@blog.com,Editor,9525,461,9986
13358,Haslett,Herity,hherityb0@indiatimes.com,Nuclear Power Engineer,4164,1481,5645
13641,Prudi,Ferrick,pferrickb1@skype.com,Senior Quality Engineer,6360,1890,8250
13816,Ivonne,Scyone,iscyoneb2@java.com,Chemical Engineer,6269,631,6900
13037,Vitoria,Jaumet,vjaumetb3@hud.gov,Financial Advisor,7746,392,8138
13167,Lina,Turfitt,lturfittb5@jimdo.com,Media Manager III,6300,1498,7798
13838,Diana,Atwool,datwoolb7@people.com.cn,Staff Accountant II,8088,905,8993
13955,Jewel,Ketteridge,jketteridgeb8@seesaa.net,Administrative Officer,3625,1065,4690
13660,Johnnie,Roumier,jroumierb9@loc.gov,Help Desk Operator,2767,361,3128
13353,Delora,Rutter,drutterbb@slideshare.net,Sales Representative,9981,737,10718
13429,Normie,Venton,nventonbd@icio.us,Librarian,3462,987,4449
13340,Carmina,Lewsy,clewsybe@examiner.com,Actuary,5656,1337,6993
13335,Esme,Brede,ebredebf@about.me,Administrative Officer,2273,1953,4226
13685,Pail,Hawkswell,phawkswellbg@domainmarket.com,Nuclear Power Engineer,9623,458,10081
13366,Mallorie,Cantillon,mcantillonbh@com.com,Occupational Therapist,1111,1109,2220
13658,Stevy,Wipfler,swipflerbj@epa.gov,Project Manager,6790,1340,8130
13017,Grazia,Helleker,ghellekerbl@squidoo.com,Web Developer IV,8543,318,8861
13285,Sharl,Latham,slathambm@printfriendly.com,Account Executive,1856,1304,3160
13401,Shaylyn,O'Dea,sodeabo@scribd.com,Senior Developer,3737,1867,5604
13558,Carie,Breens,cbreensbp@123-reg.co.uk,VP Product Management,9857,1633,11490
13116,Jeralee,Bamling,jbamlingbq@archive.org,Information Systems Manager,3012,1133,4145
13424,Mufi,Syres,msyresbr@nyu.edu,Payment Adjustment Coordinator,2861,1908,4769
13833,Berrie,Springate,bspringatebs@dion.ne.jp,Financial Advisor,6089,228,6317
13538,Stefania,Dunk,sdunkbt@devhub.com,Nurse Practicioner,8916,737,9653
13316,Hedvig,Tother,htotherbv@abc.net.au,Computer Systems Analyst IV,8575,610,9185
13924,Sharyl,Vassman,svassmanbx@netscape.com,Data Coordiator,2352,1577,3929
13711,Ulla,Jedrzejewicz,ujedrzejewiczby@oakley.com,Software Test Engineer II,7943,860,8803
13237,Nichol,Bird,nbirdc0@shop-pro.jp,Pharmacist,4163,230,4393
13541,Aloise,Povey,apoveyc1@wufoo.com,Structural Engineer,6018,496,6514
13573,Remus,Sharma,rsharmac2@indiegogo.com,Human Resources Manager,9463,964,10427
13826,Erina,MacAughtrie,emacaughtriec3@nature.com,Nuclear Power Engineer,8221,610,8831
13083,Sorcha,Stoate,sstoatec8@google.es,Marketing Manager,5158,1671,6829
13469,Lorette,Vaugham,lvaughamc9@yellowbook.com,Engineer IV,7436,240,7676
13489,Wyatt,Parkin,wparkinca@columbia.edu,VP Quality Control,5137,998,6135
13162,Kalina,Quade,kquadecc@ovh.net,Account Coordinator,3139,413,3552
13036,Candy,Gillebride,cgillebridecd@ucoz.ru,Account Executive,1800,809,2609
13786,Daniele,Trevon,dtrevonce@bbc.co.uk,Staff Scientist,2751,710,3461
13963,Kevina,Lynde,klyndecg@pinterest.com,Registered Nurse,6291,1353,7644
13448,Yvor,Ingall,yingallci@t.co,Librarian,6415,1060,7475
13050,Gothart,Frayn,gfrayncj@auda.org.au,Electrical Engineer,9223,1696,10919
13104,Cam,Sandyford,csandyfordck@irs.gov,Statistician I,6059,1911,7970
13836,Karisa,Champ,kchampcm@independent.co.uk,Nurse,7976,1389,9365
13906,Sarene,Bakewell,sbakewellcn@t.co,Executive Secretary,7782,1569,9351
13985,Kelcey,Royle,kroylecs@dion.ne.jp,Senior Developer,9154,1214,10368
13860,Eloise,Uwins,euwinsct@drupal.org,Senior Cost Accountant,9281,948,10229
13709,Carlina,Durgan,cdurgancy@is.gd,Assistant Media Planner,4842,1747,6589
13445,Urban,Jackman,ujackmand0@quantcast.com,Analyst Programmer,1984,1081,3065
13259,Shayla,Vardey,svardeyd1@tinyurl.com,Environmental Tech,3808,357,4165
13177,Wes,Attenburrow,wattenburrowd2@dion.ne.jp,Structural Engineer,3243,961,4204
13545,Aubert,Drysdall,adrysdalld3@flickr.com,Computer Systems Analyst III,3535,618,4153
13789,Caprice,Minogue,cminogued5@guardian.co.uk,Administrative Assistant IV,2422,351,2773
13204,Clio,Demchen,cdemchend7@bravesites.com,Clinical Specialist,1260,1004,2264
13632,Jdavie,Elks,jelksd8@mapquest.com,VP Accounting,4957,529,5486
13830,Shellie,Gercke,sgercked9@acquirethisname.com,Social Worker,1442,923,2365
13763,Lorri,Quogan,lquoganda@adobe.com,Financial Analyst,7827,1828,9655
13406,Alidia,Wyles,awylesdb@exblog.jp,Graphic Designer,1688,1485,3173
13603,Seana,Merrilees,smerrileesdd@surveymonkey.com,Legal Assistant,8483,1439,9922
13621,Erek,Lymbourne,elymbournede@state.gov,Software Engineer I,6136,1441,7577
13032,Oswell,Fermoy,ofermoydf@homestead.com,Media Manager III,3987,1670,5657
13742,Finley,Bletsor,fbletsordg@elegantthemes.com,Data Coordiator,1400,1268,2668
13502,Robin,Fanner,rfannerdh@gov.uk,Senior Editor,3083,1648,4731
13767,Dinnie,McCumesky,dmccumeskydi@fc2.com,Legal Assistant,2987,473,3460
13562,Natalina,Mendonca,nmendoncadl@g.co,Electrical Engineer,7883,1971,9854
13873,Correy,Pittendreigh,cpittendreighdm@berkeley.edu,Computer Systems Analyst IV,1228,1838,3066
13427,Josy,Graeber,jgraeberdp@mozilla.com,Computer Systems Analyst II,3552,764,4316
13056,Electra,Pressdee,epressdeeds@acquirethisname.com,Teacher,3209,1011,4220
13846,Elvira,Elman,eelmandt@sciencedaily.com,Compensation Analyst,9593,1966,11559
13785,Sergent,Savory,ssavorydw@indiegogo.com,Account Representative III,9294,1937,11231
13730,Rustin,Batram,rbatramdz@bravesites.com,Media Manager I,4460,579,5039
13607,Karrie,Rhead,krheade0@hud.gov,General Manager,8001,1855,9856
13722,Martie,Stirrup,mstirrupe3@facebook.com,Accountant IV,9483,394,9877
13758,Cherilynn,Pembery,cpemberye4@wikia.com,Budget/Accounting Analyst II,3974,1400,5374
13997,Brockie,Hunton,bhuntone5@dion.ne.jp,Staff Accountant II,1884,401,2285
13669,Bessie,Ripon,bripone6@seattletimes.com,Environmental Specialist,4115,505,4620
13757,Nevin,Benettelli,nbenettellie7@patch.com,VP Sales,7907,1451,9358
13883,Ulrikaumeko,Courtliff,ucourtliffe9@odnoklassniki.ru,Senior Developer,3326,512,3838
13911,Jacklyn,Laraway,jlarawayea@cocolog-nifty.com,Design Engineer,7755,290,8045
13892,Catherin,Dopson,cdopsoneb@squarespace.com,Geological Engineer,5901,1444,7345
13791,Tibold,Cawson,tcawsoned@jalbum.net,Desktop Support Technician,4512,1604,6116
13842,Garfield,Yukhin,gyukhinee@gov.uk,Assistant Media Planner,5377,1828,7205
13979,Suellen,Cavanagh,scavanaghei@sun.com,Operator,2676,788,3464
13413,Thor,Lalonde,tlalondeej@deviantart.com,Environmental Tech,2028,901,2929
13248,Barrett,Wallentin,bwallentinem@taobao.com,Pharmacist,5552,1608,7160
13321,Gerald,Keetley,gkeetleyeq@hostgator.com,Pharmacist,8153,860,9013
13555,Rafaelia,Gavaghan,rgavaghaner@umich.edu,Teacher,5024,1031,6055
13327,Olympia,Risbridger,orisbridgeres@tripadvisor.com,Professor,9914,1270,11184
13626,Caril,Honywill,chonywillet@discuz.net,Office Assistant III,7767,914,8681
13804,Redford,Iacomini,riacominiev@huffingtonpost.com,Senior Developer,4175,888,5063
13952,Christophorus,Pressnell,cpressnellex@opensource.org,Budget/Accounting Analyst III,7820,773,8593
13388,Carmine,Parzizek,cparzizekey@soup.io,Software Engineer I,3677,1310,4987
13222,Stephenie,Vennings,svenningsez@nyu.edu,Project Manager,2580,518,3098
13444,Eugenie,Radborn,eradbornf0@google.de,GIS Technical Architect,3709,837,4546
13941,Stacy,Oldridge,soldridgef2@github.com,Systems Administrator III,2348,715,3063
13400,Rubin,Fake,rfakef4@homestead.com,Payment Adjustment Coordinator,7855,1643,9498
13416,Rosaleen,Candwell,rcandwellf5@latimes.com,Administrative Assistant I,5427,910,6337
13776,Kippie,Noton,knotonf6@mozilla.com,Clinical Specialist,8540,1636,10176
13953,Britney,Fonzone,bfonzonef7@google.fr,Nuclear Power Engineer,6307,409,6716
13019,Farlee,McIlhone,fmcilhonef8@mayoclinic.com,Software Consultant,1983,850,2833
13332,Linc,Emson,lemsonf9@ucoz.ru,Food Chemist,1704,743,2447
13986,Kenyon,Munnis,kmunnisfb@paginegialle.it,Senior Developer,6601,1694,8295
13698,Chrisy,Southwick,csouthwickfe@4shared.com,Assistant Professor,8261,1114,9375
13656,Josey,Cristea,jcristeaff@scientificamerican.com,Analyst Programmer,5095,772,5867
13546,Rossy,Riggert,rriggertfi@tinyurl.com,Account Coordinator,4799,1782,6581
13796,Rab,Cuseick,rcuseickfj@shutterfly.com,Paralegal,9725,1361,11086
13697,Hugh,Sigg,hsiggfm@joomla.org,Senior Developer,2845,1959,4804
13625,Sibyl,Skuce,sskucefn@aboutads.info,Legal Assistant,8779,852,9631
13289,Davide,Attenburrow,dattenburrowfo@cdc.gov,Senior Financial Analyst,9319,1403,10722
13912,Nadia,Josse,njossefp@over-blog.com,Sales Representative,6255,1500,7755
13387,Tandie,Mansel,tmanselfq@walmart.com,Quality Control Specialist,1465,1839,3304
13511,Lizbeth,Spyvye,lspyvyefr@eventbrite.com,General Manager,6844,1433,8277
13175,Alfreda,Undy,aundyfw@vinaora.com,Nuclear Power Engineer,3884,1887,5771
13852,Louie,Witcher,lwitcherfz@vistaprint.com,Recruiting Manager,5021,995,6016
13110,Abbey,Fortun,afortung0@un.org,Recruiting Manager,6208,1915,8123
13002,Harriot,Tratton,htrattong5@time.com,Associate Professor,8297,1094,9391
13534,Friedrich,Itzhaiek,fitzhaiekg7@youku.com,Staff Scientist,8046,1483,9529
13695,Nanete,Eagar,neagarg9@furl.net,Nuclear Power Engineer,8563,270,8833
13282,Nelia,Jays,njaysgd@mail.ru,Research Associate,4320,254,4574
13223,Mike,MacAlees,mmacaleesgf@timesonline.co.uk,Data Coordiator,2531,599,3130
13381,Jenica,McLugaish,jmclugaishgj@yelp.com,Senior Cost Accountant,8720,1993,10713
13228,Winnah,Cardno,wcardnogk@nba.com,Physical Therapy Assistant,6739,1940,8679
13310,Ingaborg,Villar,ivillargo@forbes.com,Structural Analysis Engineer,3613,1794,5407
13240,Jedidiah,Kolakovic,jkolakovicgt@jimdo.com,Analog Circuit Design manager,8239,679,8918
13263,Kingston,Carder,kcardergv@illinois.edu,Systems Administrator II,9655,512,10167
13714,Tome,Samme,tsammegy@unblog.fr,Assistant Media Planner,9987,1699,11686
13762,Goraud,Pidcock,gpidcockgz@sogou.com,Editor,6900,1230,8130
13305,Madelin,Pearce,mpearceh1@google.co.uk,Sales Representative,8443,451,8894
13094,Sophia,Barthel,sbarthelh2@harvard.edu,Editor,3699,1103,4802
13777,Brear,Mulqueeny,bmulqueenyh3@bluehost.com,Senior Quality Engineer,3668,1932,5600
13089,Pansie,Arnall,parnallh5@salon.com,Internal Auditor,6191,614,6805
13468,Talbert,Hendriks,thendriksh6@posterous.com,VP Accounting,7082,1178,8260
13283,Connor,Yarwood,cyarwoodh7@myspace.com,VP Accounting,6336,269,6605
13523,Henry,McVaugh,hmcvaughh8@apple.com,Environmental Specialist,4844,1425,6269
13152,Randene,Botham,rbothamh9@e-recht24.de,Environmental Specialist,2487,624,3111
13364,Massimo,Spilling,mspillingha@infoseek.co.jp,Engineer IV,5094,982,6076
13076,Demetris,Hinckesman,dhinckesmanhc@prlog.org,Information Systems Manager,1994,1929,3923
13893,Abbey,Caro,acarohd@engadget.com,Nuclear Power Engineer,7675,360,8035
13369,Richmond,Stafford,rstaffordhe@spotify.com,Data Coordiator,4532,504,5036
13130,Linnet,Wadman,lwadmanhf@spiegel.de,Account Coordinator,1695,1172,2867
13746,Agatha,Bottrell,abottrellhh@deliciousdays.com,Electrical Engineer,3486,1187,4673
13311,Horacio,Guyet,hguyethj@furl.net,Administrative Assistant III,3951,1831,5782
13609,Dell,Boarder,dboarderhk@uol.com.br,Quality Control Specialist,5078,1919,6997
13970,Steffen,Di Pietro,sdipietrohl@about.com,VP Product Management,4175,896,5071
13210,Tait,Callendar,tcallendarhp@google.com.hk,Statistician II,6242,243,6485
13805,Margarete,Seabrooke,mseabrookehr@freewebs.com,Actuary,7074,1172,8246
13330,Clarisse,Nowaczyk,cnowaczykhs@oracle.com,Project Manager,3032,1721,4753
13520,Kasper,Rush,krushht@msn.com,Quality Engineer,1501,1115,2616
13727,Gaylor,Kovelmann,gkovelmannhw@unblog.fr,Teacher,6462,1253,7715
13343,Elisabeth,Lightewood,elightewoodhz@i2i.jp,Computer Systems Analyst II,2616,1101,3717
13234,Lynette,Hostan,lhostani2@cnbc.com,Quality Engineer,4866,634,5500
13590,Karoly,Stowers,kstowersi5@washingtonpost.com,Business Systems Development Analyst,4899,1792,6691
13862,Doretta,Byres,dbyresi6@addtoany.com,Marketing Manager,1472,876,2348
13147,Marguerite,Andresser,mandresseri9@mail.ru,Accountant III,7853,363,8216
13744,Taffy,Grolmann,tgrolmannid@goodreads.com,Civil Engineer,4016,1813,5829
13016,Patton,Martensen,pmartensenif@ibm.com,Software Test Engineer IV,2392,873,3265
13630,Baird,Balaam,bbalaamig@myspace.com,VP Accounting,5929,1206,7135
13932,Katharine,Habden,khabdenik@amazon.com,Chemical Engineer,7752,1346,9098
13308,Noby,Woodhead,nwoodheadir@is.gd,Social Worker,1763,418,2181
13738,Bernie,Lotherington,blotheringtonis@cyberchimps.com,Web Designer I,8822,342,9164
13916,Georgy,Molloy,gmolloyiv@ucoz.ru,Business Systems Development Analyst,6401,959,7360
13867,Kahlil,Kobpa,kkobpaiw@sbwire.com,General Manager,4146,443,4589
13060,Mikel,Redwall,mredwalliz@nhs.uk,Environmental Specialist,2835,222,3057
13070,Darleen,Goodee,dgoodeej0@nydailynews.com,Professor,5031,306,5337
13863,Hedi,Mahaffey,hmahaffeyj1@icio.us,Recruiting Manager,3177,611,3788
13959,Cecelia,De Few,cdefewj2@wikispaces.com,Project Manager,2775,1756,4531
13605,Calvin,Arrigucci,carriguccij3@tripod.com,Safety Technician III,2003,1285,3288
13825,Tommie,Minghetti,tminghettij4@archive.org,Account Executive,6970,1604,8574
13760,Ephrayim,Vaadeland,evaadelandj5@instagram.com,Help Desk Technician,2718,1066,3784
13293,Arabela,Cypler,acyplerj6@csmonitor.com,Research Associate,1760,1911,3671
13806,Maridel,Chaney,mchaneyj8@fotki.com,Sales Associate,4469,1933,6402
13195,Nike,Aland,nalandja@guardian.co.uk,VP Product Management,6492,1055,7547
13163,Jakob,Mughal,jmughaljb@ed.gov,Office Assistant IV,7063,1109,8172
13947,Jojo,Coonan,jcoonanje@123-reg.co.uk,VP Product Management,3652,1187,4839
13112,Lucia,Pierro,lpierrojf@amazonaws.com,Senior Editor,1158,490,1648
13495,Krystalle,Bowkett,kbowkettjh@unc.edu,Recruiter,8284,921,9205
13850,Hannie,Rieme,hriemejl@usatoday.com,Social Worker,7516,1777,9293
13005,Gawen,Jarnell,gjarnelljm@mashable.com,Senior Sales Associate,7456,1982,9438
13079,Evangelia,Fouldes,efouldesjn@newsvine.com,Administrative Assistant IV,4122,969,5091
13226,Marcellus,Knapman,mknapmanjo@deviantart.com,Office Assistant I,3368,818,4186
13139,Phillipe,Rayburn,prayburnjq@paypal.com,Business Systems Development Analyst,6941,1034,7975
13351,Padraig,Stangroom,pstangroomjr@symantec.com,Environmental Specialist,8130,326,8456
13723,Yuma,Mieville,ymievillejt@devhub.com,Senior Sales Associate,8600,1082,9682
13258,Dilly,Stripling,dstriplingju@usda.gov,Account Coordinator,2692,1970,4662
13676,Adorne,Biggadike,abiggadikejy@google.fr,Senior Editor,6919,1180,8099
13501,Mitchael,O'Doghesty,modoghestyk0@barnesandnoble.com,Quality Engineer,2552,1951,4503
13368,Layton,Gurnett,lgurnettk1@topsy.com,Physical Therapy Assistant,4368,240,4608
13800,Natty,Lewcock,nlewcockk4@pinterest.com,Tax Accountant,9264,396,9660
13566,Scot,O'Brollachain,sobrollachaink9@techcrunch.com,Engineer III,4043,1352,5395
13668,Janna,Sherrell,jsherrellkc@altervista.org,Recruiter,9696,1497,11193
13405,Margarette,Blaisdale,mblaisdalekd@sina.com.cn,Dental Hygienist,7153,835,7988
13164,Violette,Betje,vbetjekf@walmart.com,Senior Quality Engineer,9861,1496,11357
13435,Florentia,Teacy,fteacykj@biglobe.ne.jp,Graphic Designer,3631,1317,4948
13964,Kamillah,Aloway,kalowaykk@usnews.com,Teacher,5748,715,6463
13888,Isac,Edmondson,iedmondsonkl@usatoday.com,Structural Analysis Engineer,3540,966,4506
13084,Diandra,Drewell,ddrewellkm@jigsy.com,Food Chemist,9492,295,9787
13715,Lucas,Nowaczyk,lnowaczykkn@mayoclinic.com,Civil Engineer,8990,1482,10472
13252,Freddie,Andrieux,fandrieuxkp@loc.gov,Accountant III,9554,1257,10811
13492,Hayward,Hurd,hhurdkq@ibm.com,Accountant II,5435,314,5749
13434,Tedda,Fishe,tfisheku@wsj.com,VP Marketing,7000,1573,8573
13565,Mabelle,Slaight,mslaightkw@clickbank.net,Information Systems Manager,6931,955,7886
13230,Babb,Mournian,bmourniankx@sciencedaily.com,Research Assistant IV,2038,1951,3989
13215,Jacinta,Dean,jdeanl3@cyberchimps.com,Assistant Manager,1905,296,2201
13790,Davine,Duchart,dduchartl6@auda.org.au,Nurse Practicioner,1789,1501,3290
13349,Whitman,Bosma,wbosmal7@bigcartel.com,Statistician I,5103,1810,6913
13138,Mylo,Preddle,mpreddlel9@moonfruit.com,Programmer Analyst I,3094,1161,4255
13018,Franny,Feares,ffearesla@cnet.com,Account Representative III,6642,1887,8529
13948,Gunter,Sackey,gsackeylc@bloglovin.com,Systems Administrator II,5945,1105,7050
13593,Lyndel,Portress,lportressld@xinhuanet.com,Associate Professor,8771,1263,10034
13181,Lila,Mewha,lmewhale@fastcompany.com,Sales Associate,9205,1988,11193
13087,Melantha,Priestland,mpriestlandlf@ameblo.jp,Internal Auditor,3874,571,4445
13954,Nikaniki,Allworthy,nallworthylg@feedburner.com,Account Executive,6709,936,7645
13853,Elsworth,Scarfe,escarfeli@army.mil,Administrative Officer,7555,1595,9150
13639,Franz,Morston,fmorstonln@livejournal.com,Environmental Tech,9315,1131,10446
13542,Antonin,Allison,aallisonlo@bloglovin.com,Help Desk Technician,6062,1380,7442
13473,Nikki,Berrington,nberringtonlq@oracle.com,Business Systems Development Analyst,7280,1603,8883
13007,Rani,Trusslove,rtrusslovels@cpanel.net,Civil Engineer,6085,905,6990
13510,Abey,Mordy,amordyly@topsy.com,Structural Analysis Engineer,6268,284,6552
13046,Clevie,Edden,ceddenlz@xrea.com,Software Engineer IV,8815,1773,10588
13576,Mamie,Choppin,mchoppinm2@tuttocitta.it,Occupational Therapist,2637,401,3038
13132,Bondon,Fann,bfannm4@dedecms.com,Pharmacist,5201,346,5547
13834,Brocky,Bruckman,bbruckmanm6@ftc.gov,Food Chemist,6829,888,7717
13334,Yelena,Urridge,yurridgem7@scribd.com,Automation Specialist III,5036,564,5600
13610,Lucien,Jillis,ljillism9@marketwatch.com,Software Engineer I,1189,491,1680
13885,Ronnie,Flippelli,rflippellima@imdb.com,Administrative Assistant IV,5827,1976,7803
13938,Illa,Road,iroadmb@e-recht24.de,Technical Writer,9305,666,9971
13881,Karlotta,Vasilmanov,kvasilmanovmd@elegantthemes.com,Director of Sales,9190,1749,10939
13107,Wallache,Tandey,wtandeymh@go.com,Operator,7124,1399,8523
13919,Vanni,Braz,vbrazmi@unicef.org,Safety Technician I,5069,1269,6338
13236,Rudolph,Yglesia,ryglesiaml@irs.gov,Account Representative I,3313,1469,4782
13931,Eugene,Robertelli,erobertellimp@china.com.cn,Biostatistician III,5597,462,6059
13783,Kinna,Jeannot,kjeannotmq@privacy.gov.au,Nurse,4840,1730,6570
13636,Daphene,Gallo,dgallomr@google.it,Environmental Tech,3211,782,3993
13799,Klarrisa,Strathdee,kstrathdeemv@geocities.com,Developer III,7690,937,8627
13092,Vida,Spurling,vspurlingmw@pbs.org,Payment Adjustment Coordinator,2504,1334,3838
13690,Filippo,Jennaroy,fjennaroymx@utexas.edu,Nurse Practicioner,1639,772,2411
13398,Dulsea,Tunney,dtunneymz@springer.com,Information Systems Manager,9571,1752,11323
13197,Katherina,Ourry,kourryn0@dedecms.com,Structural Engineer,6860,1239,8099
13313,Ingaborg,Real,irealn6@merriam-webster.com,Sales Representative,4868,1880,6748
13392,Bertram,Moens,bmoensn9@bbb.org,Chief Design Engineer,8504,1451,9955
13515,Dolley,De La Hay,ddelahaync@ucla.edu,Senior Developer,2962,1340,4302
13686,Dorey,Liebrecht,dliebrechtne@flavors.me,Sales Representative,5808,455,6263
13771,King,Peasby,kpeasbynf@who.int,Programmer IV,5945,1055,7000
13684,Ethe,Heaphy,eheaphynh@cbslocal.com,Chief Design Engineer,6406,382,6788
13724,Clarita,Chamberlain,cchamberlainnk@omniture.com,Safety Technician I,5588,1158,6746
13320,Dorie,Dorrell,ddorrellnm@imdb.com,Senior Editor,6174,1189,7363
13172,Tynan,Wykes,twykesnn@reddit.com,Associate Professor,8776,479,9255
13376,Barnabe,Veque,bvequenq@princeton.edu,Compensation Analyst,3409,588,3997
13524,Lizzy,Janca,ljancans@netvibes.com,Account Coordinator,9773,845,10618
13529,Eldin,Turtle,eturtlent@squidoo.com,Budget/Accounting Analyst III,4734,1192,5926
13100,Lenore,MacCaffery,lmaccafferynv@miitbeian.gov.cn,Software Consultant,4365,787,5152
13337,Moshe,Bartolomivis,mbartolomivisnw@macromedia.com,Accountant II,8864,1540,10404
13342,Jonis,Howgate,jhowgatenx@intel.com,Senior Developer,1895,509,2404
13081,Nickolai,Czajkowska,nczajkowskao1@tripod.com,Sales Associate,8381,713,9094
13166,Nata,Creevy,ncreevyo4@guardian.co.uk,Environmental Tech,4530,1976,6506
13034,Guinna,Miskin,gmiskino6@opera.com,Assistant Media Planner,5451,1773,7224
13300,Antony,Witherden,awitherdeno7@shinystat.com,Registered Nurse,3406,985,4391
13052,Thorpe,Holbury,tholburyob@fc2.com,VP Product Management,9623,1891,11514
13613,Irita,Saynor,isaynorof@gov.uk,Electrical Engineer,2479,210,2689
13024,Bette,Bwy,bbwyoh@live.com,Programmer Analyst IV,9314,1640,10954
13190,Ashli,Stutard,astutardoj@bbc.co.uk,Business Systems Development Analyst,9768,627,10395
13440,Fair,Boobyer,fboobyerol@nymag.com,Project Manager,8289,1067,9356
13600,Cchaddie,Melior,cmelioron@seesaa.net,Project Manager,7957,260,8217
13696,Sholom,Giggie,sgiggieos@wunderground.com,Systems Administrator III,1492,690,2182
13797,Toby,Siss,tsissot@over-blog.com,Professor,8294,1882,10176
13066,Skipton,Gateman,sgatemanou@discovery.com,Editor,3237,1916,5153
13023,Ailina,Haddy,ahaddyov@yellowpages.com,Staff Accountant III,8915,258,9173
13930,Daffy,Andrasch,dandraschoz@so-net.ne.jp,Software Test Engineer I,2504,1112,3616
13691,Rivi,Moakes,rmoakesp1@behance.net,Programmer Analyst IV,1904,1609,3513
13809,Philomena,Tallach,ptallachp4@google.cn,Mechanical Systems Engineer,1310,598,1908
13681,Boone,Lestrange,blestrangep7@google.com.hk,Analyst Programmer,2289,1330,3619
13331,Tedman,Hawlgarth,thawlgarthp9@networkadvertising.org,Staff Scientist,3431,834,4265
13949,Reeva,Yurkevich,ryurkevichpe@nifty.com,Professor,4286,405,4691
13064,Nolie,Hatfull,nhatfullpo@cbsnews.com,Recruiter,1650,590,2240
13221,Windham,Vedmore,wvedmorepp@fc2.com,VP Accounting,7551,341,7892
13336,Clementine,Kunath,ckunathpr@blog.com,Software Engineer IV,9494,220,9714
13991,Jenni,Grooby,jgroobypt@scientificamerican.com,Quality Engineer,3965,1393,5358
13673,Elisha,McConnulty,emcconnultypu@edublogs.org,Environmental Specialist,2053,401,2454
13380,Edna,Meriguet,emeriguetpv@wp.com,Clinical Specialist,5839,984,6823
13942,Gaven,Cumpton,gcumptonpy@nbcnews.com,Account Coordinator,8533,1464,9997
13367,Marjy,Graveney,mgraveneypz@4shared.com,Compensation Analyst,2728,723,3451
13745,Mona,Challener,mchallenerq2@soundcloud.com,Design Engineer,2040,601,2641
13029,Maggee,Jantot,mjantotq4@economist.com,Nurse Practicioner,8977,1882,10859
13281,Mead,Poxon,mpoxonq5@economist.com,Automation Specialist IV,9370,1263,10633
13617,Sydel,Eggleson,segglesonq6@cornell.edu,Structural Analysis Engineer,4531,1051,5582
13601,Raimundo,Venditto,rvendittoq9@seattletimes.com,Senior Cost Accountant,5884,1156,7040
13950,Arlin,Fabbro,afabbroqc@parallels.com,Product Engineer,4842,1841,6683
13338,Kass,Scotchbrook,kscotchbrookqf@yale.edu,Senior Cost Accountant,8291,1423,9714
13178,Kiley,Thornton-Dewhirst,kthorntondewhirstqh@sun.com,Speech Pathologist,7909,1220,9129
13793,Hashim,Luckman,hluckmanqi@mashable.com,Tax Accountant,7638,1574,9212
13710,Joelly,Farington,jfaringtonqo@oaic.gov.au,Junior Executive,5752,827,6579
13596,Virge,Gunningham,vgunninghamqp@nasa.gov,Graphic Designer,1316,361,1677
13299,Agnese,Ingyon,aingyonqq@about.me,Sales Associate,2766,1398,4164
13974,Whitney,Orknay,worknayqy@sourceforge.net,Associate Professor,9235,618,9853
13232,Eirena,Bowdery,ebowderyr4@sciencedaily.com,Structural Analysis Engineer,2007,1439,3446
13672,Arabela,Cruickshanks,acruickshanksr5@imageshack.us,Geologist IV,1246,964,2210
13675,Allen,Yockney,ayockneyrb@weather.com,Cost Accountant,2868,592,3460
13606,Rozamond,McGourty,rmcgourtyrf@cargocollective.com,Director of Sales,7577,639,8216
13878,Tallulah,Yexley,tyexleyrj@xing.com,Pharmacist,2489,1831,4320
13958,Bette-ann,Feria,bferiark@nih.gov,Structural Engineer,4678,1354,6032
13513,Bianca,de Voiels,bdevoielsrm@cnet.com,Programmer II,9759,1834,11593
13761,Frederik,Pedroni,fpedronirq@chicagotribune.com,Assistant Manager,3050,1586,4636
14470,Nathan,Milnes,nmilnes0@cisco.com,Account Coordinator,3948,797,4745
14244,Lenci,Todarini,ltodarini1@sitemeter.com,Staff Accountant IV,5771,357,6128
14872,Drugi,Quodling,dquodling2@drupal.org,Tax Accountant,4340,659,4999
14764,Vivia,Maw,vmaw3@nsw.gov.au,Recruiter,4289,1290,5579
14183,Dore,Clappison,dclappison4@who.int,VP Sales,4164,678,4842
14373,Alicea,Garnsworth,agarnsworth5@cornell.edu,Staff Accountant IV,2988,571,3559
14735,Rosalind,Worgen,rworgen6@marriott.com,Community Outreach Specialist,4174,1568,5742
14816,Dolph,Treffry,dtreffry7@mozilla.org,Budget/Accounting Analyst III,8933,1200,10133
14356,Mora,Twatt,mtwatt8@dyndns.org,Project Manager,8531,1102,9633
14162,Saraann,Hanburry,shanburry9@huffingtonpost.com,Food Chemist,2101,1327,3428
14185,Sibley,Garraway,sgarrawaya@parallels.com,Speech Pathologist,5979,948,6927
14506,Gene,Paddingdon,gpaddingdonb@ycombinator.com,Media Manager IV,1630,591,2221
14607,Sena,Phil,sphilc@oakley.com,GIS Technical Architect,6236,957,7193
14617,Papageno,Felton,pfeltond@youtube.com,Statistician III,6236,449,6685
14772,Caresa,Pascho,cpaschoe@msn.com,Compensation Analyst,7523,1662,9185
14088,Stanleigh,Blaisdale,sblaisdalef@gmpg.org,Desktop Support Technician,7167,1578,8745
14723,Paolo,Gate,pgateg@sitemeter.com,Speech Pathologist,3852,606,4458
14441,Gabbie,Skelhorn,gskelhornh@wix.com,Software Test Engineer I,4445,333,4778
14078,Odell,Petzold,opetzoldi@trellian.com,Sales Associate,5047,559,5606
14365,Rahel,Idiens,ridiensj@amazon.co.uk,Health Coach I,5420,1301,6721
14130,Ozzie,Blayd,oblaydk@mozilla.org,Senior Cost Accountant,2519,1971,4490
14598,Van,Bruster,vbrusterl@timesonline.co.uk,Operator,4283,687,4970
14908,Mel,Liggens,mliggensm@reverbnation.com,Senior Quality Engineer,2339,766,3105
14951,Estelle,Burmaster,eburmastern@tuttocitta.it,Structural Engineer,5374,1666,7040
14239,Thomas,Astlet,tastleto@netscape.com,Mechanical Systems Engineer,3469,331,3800
14898,Regan,Titmarsh,rtitmarshp@a8.net,Electrical Engineer,5234,979,6213
14762,Myrlene,Meffin,mmeffinq@addthis.com,Financial Analyst,2344,1107,3451
14710,Corissa,Really,creallyr@yelp.com,Graphic Designer,5461,1973,7434
14295,Andy,Dunhill,adunhills@indiegogo.com,Systems Administrator II,9118,324,9442
14081,Raeann,Francescuccio,rfrancescucciou@si.edu,Account Coordinator,9327,1584,10911
14688,Viviana,Muncer,vmuncerv@exblog.jp,Compensation Analyst,7419,1655,9074
14580,Vicky,Ilbert,vilbertw@un.org,Structural Engineer,3111,703,3814
14526,Willie,Guinness,wguinnessx@goo.gl,Biostatistician I,5288,1322,6610
14792,Orelia,Hawken,ohawkeny@nba.com,Assistant Media Planner,3938,1705,5643
14246,Lucy,Schoffel,lschoffelz@google.co.jp,Junior Executive,1356,220,1576
14722,Beverie,Oxx,boxx10@adobe.com,GIS Technical Architect,6855,714,7569
14917,Ysabel,Nock,ynock11@cdc.gov,Speech Pathologist,1432,1993,3425
14300,Bren,Wharrier,bwharrier12@time.com,Office Assistant IV,7591,1487,9078
14660,Markus,Jocic,mjocic13@japanpost.jp,Occupational Therapist,1453,1993,3446
14319,Vernor,Childs,vchilds14@moonfruit.com,Director of Sales,9220,416,9636
14606,Mignon,Borgars,mborgars15@dot.gov,Nurse,6365,712,7077
14047,Marlena,Dyhouse,mdyhouse16@oaic.gov.au,Desktop Support Technician,5851,440,6291
14880,Blinnie,Janicijevic,bjanicijevic17@lycos.com,Human Resources Assistant III,5625,1169,6794
14372,Abelard,Dalla,adalla18@jiathis.com,Media Manager IV,7155,1444,8599
14119,Barnie,Probate,bprobate19@google.fr,Administrative Officer,8032,1191,9223
14900,Consuelo,Curnokk,ccurnokk1a@storify.com,Environmental Tech,9915,1042,10957
14435,Gunilla,Androli,gandroli1b@ebay.com,Business Systems Development Analyst,4177,1187,5364
14957,Davine,Minichillo,dminichillo1c@phoca.cz,Automation Specialist IV,2222,538,2760
14326,Laureen,Halvosen,lhalvosen1d@gmpg.org,Web Developer IV,5706,1629,7335
14667,Freddy,Fillary,ffillary1e@rediff.com,Pharmacist,6240,502,6742
14321,Robenia,Garrique,rgarrique1f@baidu.com,Chief Design Engineer,3966,635,4601
14776,Jarret,Fairleigh,jfairleigh1g@rediff.com,Food Chemist,8597,1644,10241
14973,Sophronia,Rudsdell,srudsdell1h@godaddy.com,Director of Sales,8954,1637,10591
14796,Stu,Soaper,ssoaper1i@symantec.com,Safety Technician II,6273,403,6676
14976,Nissie,Redolfi,nredolfi1j@yale.edu,Senior Editor,9644,1586,11230
14020,Joan,Tinson,jtinson1k@twitter.com,Senior Cost Accountant,6014,233,6247
14858,Morgen,Guye,mguye1l@indiegogo.com,Financial Advisor,5005,1163,6168
14641,Dulsea,Vyse,dvyse1m@fotki.com,Actuary,2572,968,3540
14574,Ryun,Renad,rrenad1n@qq.com,Programmer IV,5461,1022,6483
14049,Hetty,Hambridge,hhambridge1o@ftc.gov,Office Assistant II,4159,1500,5659
14542,Sileas,Menham,smenham1p@thetimes.co.uk,Human Resources Assistant IV,4107,438,4545
14711,Morganica,Shelley,mshelley1q@desdev.cn,Recruiter,3226,1888,5114
14473,Bary,Stack,bstack1r@wikia.com,Financial Advisor,9802,1673,11475
14623,Lucian,Milksop,lmilksop1s@examiner.com,Nurse Practicioner,3740,1437,5177
14931,Mab,Dax,mdax1u@gmpg.org,Senior Financial Analyst,3904,1318,5222
14770,Ossie,Dorrell,odorrell1w@narod.ru,Professor,2525,1168,3693
14007,Gisela,Suttill,gsuttill1x@cnbc.com,Paralegal,8245,1710,9955
14393,Patrice,Barme,pbarme1y@hibu.com,Data Coordiator,8906,1786,10692
14440,Neil,Buckthorp,nbuckthorp1z@google.it,Senior Quality Engineer,8958,725,9683
14610,Gertrud,Yvens,gyvens20@fc2.com,Programmer Analyst III,1482,1117,2599
14724,Coleen,Trusse,ctrusse21@jimdo.com,Account Coordinator,4457,511,4968
14680,Hector,Britian,hbritian22@hc360.com,Geologist III,3656,1332,4988
14773,Westleigh,Ridgedell,wridgedell23@cnn.com,Physical Therapy Assistant,8663,1701,10364
14637,Dorisa,Askwith,daskwith24@mail.ru,Analog Circuit Design manager,6905,706,7611
14715,Brady,Kitlee,bkitlee25@shinystat.com,Editor,8427,1805,10232
14794,Tyson,Wisson,twisson26@reverbnation.com,Sales Representative,7113,1123,8236
14345,Edita,Kliement,ekliement27@sitemeter.com,Internal Auditor,6406,1729,8135
14428,Chick,Hanaby,chanaby28@biblegateway.com,Software Engineer I,4789,278,5067
14378,Marchelle,Klimowski,mklimowski29@nymag.com,Technical Writer,3739,1407,5146
14026,Derek,Really,dreally2a@arstechnica.com,Senior Financial Analyst,2425,659,3084
14454,Crystie,Bentson,cbentson2b@apple.com,Nuclear Power Engineer,7986,324,8310
14865,Brenn,Shera,bshera2c@g.co,Electrical Engineer,6258,802,7060
14662,Crosby,Beccero,cbeccero2d@dailymail.co.uk,Budget/Accounting Analyst IV,7604,1026,8630
14746,Hanna,Rubens,hrubens2e@amazon.co.jp,Senior Financial Analyst,2660,496,3156
14404,Rosana,Poulsom,rpoulsom2f@latimes.com,Assistant Media Planner,6476,932,7408
14175,Janis,O'Carran,jocarran2g@usnews.com,Accountant I,2558,1105,3663
14059,Egbert,McMurdo,emcmurdo2h@rediff.com,VP Marketing,8319,1217,9536
14493,Siward,Fanton,sfanton2j@latimes.com,Nurse Practicioner,3052,749,3801
14498,Leodora,Tuxwell,ltuxwell2k@bluehost.com,Research Associate,1386,358,1744
14188,Bernette,Hamner,bhamner2l@hexun.com,Developer I,9024,1158,10182
14456,Stephana,Beyne,sbeyne2m@taobao.com,Nurse,3481,514,3995
14893,Alix,Anan,aanan2n@buzzfeed.com,Senior Editor,4522,1290,5812
14033,Wit,Tapton,wtapton2o@foxnews.com,VP Accounting,2092,1842,3934
14585,Brion,Nagle,bnagle2p@dell.com,Geological Engineer,6983,874,7857
14686,Florence,Dine-Hart,fdinehart2q@tiny.cc,Senior Cost Accountant,1584,1701,3285
14554,Brendon,Doddridge,bdoddridge2r@theatlantic.com,Senior Editor,5221,935,6156
14159,Ax,Meritt,ameritt2s@hatena.ne.jp,Editor,9276,1630,10906
14831,Lefty,Druhan,ldruhan2t@un.org,Marketing Manager,8861,781,9642
14732,Winna,Bursell,wbursell2u@wunderground.com,Paralegal,8250,1569,9819
14412,Ernst,Elgie,eelgie2v@t.co,Sales Representative,9377,825,10202
14431,Cobb,Talmadge,ctalmadge2w@weibo.com,Tax Accountant,5549,248,5797
14060,Sharon,Illingsworth,sillingsworth2x@dell.com,Help Desk Operator,6235,1414,7649
14754,Waylan,Manuello,wmanuello2y@uol.com.br,Web Designer II,3609,1388,4997
14949,Bidget,Wadforth,bwadforth2z@huffingtonpost.com,Statistician I,9377,1644,11021
14212,Grayce,O'Regan,goregan30@aboutads.info,Director of Sales,3996,1934,5930
14996,Celia,Gunthorpe,cgunthorpe31@webnode.com,Geological Engineer,7409,1484,8893
14974,Vassili,Salzen,vsalzen32@bbb.org,GIS Technical Architect,4838,1208,6046
14837,Jacinta,Oyley,joyley33@last.fm,Technical Writer,5393,1674,7067
14481,Ardyce,Hellewell,ahellewell34@china.com.cn,Biostatistician I,3710,738,4448
14652,Lutero,Will,lwill35@forbes.com,VP Marketing,6183,982,7165
14144,Worden,Alexandrescu,walexandrescu36@ucoz.com,Civil Engineer,8579,261,8840
14099,Selene,Hogben,shogben37@t.co,Data Coordiator,3343,1585,4928
14251,Parry,Wiffield,pwiffield38@xrea.com,Biostatistician I,4898,1720,6618
14207,Viva,Renahan,vrenahan39@theglobeandmail.com,Pharmacist,5393,864,6257
14632,Beatriz,Goodwyn,bgoodwyn3b@alibaba.com,Senior Editor,8648,631,9279
14563,Antonino,Jewise,ajewise3c@google.com.au,Systems Administrator IV,1579,1514,3093
14868,Klara,Bront,kbront3d@surveymonkey.com,Recruiter,1937,1182,3119
14843,Benjamin,Strathern,bstrathern3h@toplist.cz,VP Quality Control,1843,759,2602
14221,Munmro,Marran,mmarran3i@aol.com,Biostatistician II,4818,1838,6656
14123,Batholomew,Busain,bbusain3j@gizmodo.com,Nurse Practicioner,4631,1926,6557
14992,Saraann,Rantoul,srantoul3k@webeden.co.uk,Accounting Assistant I,5680,893,6573
14730,Oona,Cursey,ocursey3l@php.net,Social Worker,7623,235,7858
14004,Frederik,Cudd,fcudd3m@alibaba.com,Assistant Media Planner,7250,512,7762
14445,Mahala,Clardge,mclardge3o@fotki.com,Environmental Tech,8968,1465,10433
14023,Layne,Conigsby,lconigsby3q@furl.net,Sales Associate,9699,370,10069
14841,Hatti,Giral,hgiral3s@epa.gov,Internal Auditor,5795,1442,7237
14884,Hurlee,Radke,hradke3t@google.com,Analog Circuit Design manager,6907,1943,8850
14071,Vivi,Tinston,vtinston3u@acquirethisname.com,Quality Control Specialist,9984,1332,11316
14644,Thane,Orwin,torwin3v@army.mil,Financial Advisor,9887,1878,11765
14010,Ethelin,Berdale,eberdale3y@sakura.ne.jp,General Manager,9825,1798,11623
14102,Tove,Rapson,trapson3z@furl.net,Media Manager I,7437,956,8393
14122,Estrellita,Mousby,emousby40@flickr.com,Technical Writer,3397,1274,4671
14780,Barnard,Tunnick,btunnick41@nymag.com,Pharmacist,6785,339,7124
14703,Stanislaw,Hollow,shollow43@booking.com,Civil Engineer,1961,1011,2972
14150,Karlyn,Davers,kdavers44@yellowbook.com,Director of Sales,2110,1059,3169
14601,Marillin,Lurcock,mlurcock45@netvibes.com,Software Test Engineer II,7553,1615,9168
14988,Cornelle,McCambrois,cmccambrois46@cisco.com,GIS Technical Architect,1218,1134,2352
14406,Antoine,Bexley,abexley47@ebay.co.uk,Occupational Therapist,2466,1366,3832
14678,Kacie,Sinkings,ksinkings49@devhub.com,Physical Therapy Assistant,5366,382,5748
14458,Theobald,Dobel,tdobel4a@ucsd.edu,Actuary,7275,689,7964
14036,Holly-anne,Minster,hminster4b@example.com,Registered Nurse,8221,825,9046
14879,Olimpia,Huyton,ohuyton4c@mtv.com,Research Associate,8367,1403,9770
14734,Cristy,Orkney,corkney4d@comcast.net,Nurse,1212,569,1781
14459,Pepito,Cordes,pcordes4e@samsung.com,Teacher,5251,1337,6588
14929,Byrom,Cheverton,bcheverton4f@google.ca,Environmental Specialist,2475,275,2750
14752,Web,Howles,whowles4g@bizjournals.com,Research Associate,5054,724,5778
14690,Ebba,Siverns,esiverns4h@clickbank.net,Senior Cost Accountant,1394,1626,3020
14514,Imogen,Morad,imorad4i@posterous.com,Nurse,8415,1768,10183
14220,Dolli,Trenouth,dtrenouth4j@hhs.gov,Biostatistician IV,5818,1826,7644
14823,Trey,Dunford,tdunford4l@va.gov,Senior Developer,7846,775,8621
14433,Jaymie,Jearum,jjearum4m@sakura.ne.jp,Recruiting Manager,5414,1178,6592
14311,Noll,Lambell,nlambell4n@wp.com,Community Outreach Specialist,3678,1958,5636
14544,Wildon,Woodfine,wwoodfine4o@columbia.edu,Tax Accountant,4022,225,4247
14650,Lane,Feaks,lfeaks4q@artisteer.com,Software Engineer I,6811,1300,8111
14368,Amberly,Hollows,ahollows4r@loc.gov,Environmental Specialist,3665,1486,5151
14304,Annalise,Glaister,aglaister4s@webmd.com,Librarian,7822,1588,9410
14174,Jack,Reape,jreape4t@addtoany.com,Design Engineer,5713,1973,7686
14146,Tally,Levington,tlevington4u@fema.gov,Data Coordiator,1244,497,1741
14842,Roseanna,Packer,rpacker4v@intel.com,Programmer II,5154,586,5740
14252,Stanton,Antham,santham4w@nasa.gov,Programmer II,3189,489,3678
14716,Madelina,Bowkett,mbowkett4x@goo.ne.jp,Paralegal,7660,405,8065
14455,Stepha,Perring,sperring4y@gmpg.org,Software Consultant,4821,1670,6491
14374,Justin,Seine,jseine4z@sbwire.com,Senior Editor,8224,1276,9500
14048,Lari,Renackowna,lrenackowna50@ameblo.jp,Clinical Specialist,3136,1200,4336
14945,Cynthia,Davenhill,cdavenhill51@google.fr,Assistant Media Planner,4520,445,4965
14757,Pat,Richin,prichin52@dot.gov,Senior Developer,4909,421,5330
14353,Erny,Roze,eroze53@utexas.edu,Tax Accountant,1478,1572,3050
14883,Quintilla,Everil,qeveril54@ox.ac.uk,Research Nurse,8405,1226,9631
14250,Deana,Drache,ddrache55@illinois.edu,Software Consultant,7047,1326,8373
14958,Georgina,Macourek,gmacourek56@salon.com,VP Quality Control,4203,1658,5861
14332,Elmo,Dahlgren,edahlgren57@ezinearticles.com,Electrical Engineer,7346,1489,8835
14272,Annabelle,Alabaster,aalabaster58@spotify.com,Software Engineer I,7732,996,8728
14325,Charita,Daykin,cdaykin59@over-blog.com,Research Associate,4749,962,5711
14838,Harmon,Cranny,hcranny5a@flickr.com,Nuclear Power Engineer,3516,1643,5159
14565,Angie,Buff,abuff5b@aboutads.info,Marketing Assistant,3106,290,3396
14363,Meghann,Maxwaile,mmaxwaile5c@comcast.net,Clinical Specialist,1249,1412,2661
14955,Ingemar,Nussey,inussey5d@harvard.edu,Software Engineer II,5252,1478,6730
14581,Morry,Scoggan,mscoggan5e@eventbrite.com,Research Associate,9932,1255,11187
14864,Antoni,Rowles,arowles5f@google.co.jp,Assistant Professor,8621,1077,9698
14548,Elvyn,Haggleton,ehaggleton5g@about.me,Nurse,5607,562,6169
14847,Latrina,Jakubiak,ljakubiak5i@dyndns.org,Data Coordiator,2409,574,2983
14909,Kile,Gipps,kgipps5j@cbc.ca,Accounting Assistant I,5070,1178,6248
14959,Patricio,Copelli,pcopelli5l@networkadvertising.org,Research Assistant III,8909,798,9707
14656,Farrah,Grimsdike,fgrimsdike5m@mac.com,Accounting Assistant III,1832,1618,3450
14522,Tove,Baudon,tbaudon5n@omniture.com,Chief Design Engineer,3350,661,4011
14566,Leola,Fellini,lfellini5o@t-online.de,Paralegal,2061,1142,3203
14836,Marisa,Gritsaev,mgritsaev5p@infoseek.co.jp,Web Developer III,9872,567,10439
14573,Nadiya,Huckle,nhuckle5q@wikimedia.org,Design Engineer,3356,1855,5211
14760,Renault,Lathe,rlathe5r@tripod.com,Statistician III,7761,1070,8831
14529,Maura,Fickling,mfickling5s@berkeley.edu,Accounting Assistant I,7493,349,7842
14859,Mack,Prate,mprate5t@ustream.tv,Actuary,6021,1270,7291
14297,Flora,McCrachen,fmccrachen5u@is.gd,Automation Specialist II,7659,417,8076
14237,Dale,Kilkenny,dkilkenny5v@economist.com,Professor,5444,493,5937
14342,Happy,Pedgrift,hpedgrift5w@pen.io,Executive Secretary,5448,244,5692
14683,Rutger,Duckworth,rduckworth5x@goo.ne.jp,Biostatistician IV,7889,1145,9034
14418,Brigitte,Azema,bazema5y@netscape.com,Nuclear Power Engineer,8257,1614,9871
14938,Zorana,Gisburn,zgisburn5z@infoseek.co.jp,Junior Executive,4415,1175,5590
14362,Sheila,Potbury,spotbury60@discovery.com,Human Resources Assistant I,3103,1051,4154
14558,Parke,McKeaney,pmckeaney62@walmart.com,Research Nurse,5605,316,5921
14765,Salomi,Bice,sbice64@bloglines.com,Software Engineer IV,2302,919,3221
14257,Lindi,Stonestreet,lstonestreet65@walmart.com,VP Accounting,4458,1924,6382
14296,Dunc,Targe,dtarge66@gmpg.org,Accountant IV,2687,1202,3889
14432,Clo,Duddell,cduddell67@washingtonpost.com,Internal Auditor,3284,672,3956
14657,Nanice,Bartomeu,nbartomeu68@last.fm,Human Resources Manager,8838,680,9518
14093,Ella,Morgon,emorgon69@cdbaby.com,General Manager,8153,578,8731
14738,Filberto,Gorse,fgorse6e@mashable.com,General Manager,9628,264,9892
14979,Stefania,Iorio,siorio6f@toplist.cz,Community Outreach Specialist,2275,396,2671
14882,Clevie,Dummigan,cdummigan6h@instagram.com,Research Associate,3944,1283,5227
14559,Klarrisa,Quaintance,kquaintance6i@apple.com,Project Manager,4654,1275,5929
14333,Shermie,Grimsdell,sgrimsdell6j@soundcloud.com,Business Systems Development Analyst,6665,1500,8165
14383,Parke,Chessun,pchessun6l@who.int,Environmental Specialist,4606,1755,6361
14961,Jasmin,Kinsett,jkinsett6m@topsy.com,Dental Hygienist,4520,1806,6326
14895,Janith,Astle,jastle6n@jimdo.com,Marketing Assistant,3799,363,4162
14594,Jason,Maciejak,jmaciejak6p@soundcloud.com,Nuclear Power Engineer,4998,352,5350
14266,Leonhard,Edsell,ledsell6q@vimeo.com,Software Engineer II,2607,1384,3991
14595,Daloris,Glanert,dglanert6r@4shared.com,Health Coach II,5181,1728,6909
14462,Hermione,Budgen,hbudgen6s@imageshack.us,Computer Systems Analyst II,3103,444,3547
14789,Sandro,Izzett,sizzett6t@last.fm,Design Engineer,7009,1022,8031
14249,Anthiathia,Margerison,amargerison6v@tripod.com,Payment Adjustment Coordinator,9534,688,10222
14151,Gretna,Philipart,gphilipart6w@moonfruit.com,Community Outreach Specialist,6437,1599,8036
14968,Claudelle,Casaccio,ccasaccio6x@mtv.com,Software Engineer I,6363,640,7003
14761,Amii,Leydon,aleydon6y@nasa.gov,Systems Administrator III,3915,336,4251
14704,Harris,Fain,hfain6z@usa.gov,Sales Associate,6876,297,7173
14447,Rafaelia,Hanselman,rhanselman70@reverbnation.com,Software Engineer II,4135,688,4823
14057,Tonnie,Bussons,tbussons71@artisteer.com,Nurse Practicioner,6795,728,7523
14138,Meyer,Osorio,mosorio72@cloudflare.com,Help Desk Technician,4904,678,5582
14222,Corty,Gilsthorpe,cgilsthorpe73@mysql.com,Administrative Assistant III,7215,991,8206
14320,Nata,Maneylaws,nmaneylaws74@feedburner.com,Research Assistant III,8548,1570,10118
14241,Earle,Anderton,eanderton75@ucla.edu,Marketing Assistant,4794,823,5617
14327,Ula,Kunz,ukunz76@51.la,Quality Control Specialist,6184,1740,7924
14586,Callean,Fowlston,cfowlston77@un.org,Payment Adjustment Coordinator,2378,1890,4268
14855,Finn,Edgler,fedgler7a@intel.com,Clinical Specialist,4276,1158,5434
14487,Coralyn,Jerrom,cjerrom7b@vk.com,VP Sales,4751,1204,5955
14907,Conny,Alexsandrev,calexsandrev7c@addtoany.com,Human Resources Assistant I,6888,1085,7973
14921,Temp,Sargent,tsargent7d@psu.edu,Software Engineer IV,5492,573,6065
14217,Helena,Stembridge,hstembridge7e@utexas.edu,Dental Hygienist,6829,256,7085
14055,Raquela,Mellanby,rmellanby7f@storify.com,Payment Adjustment Coordinator,4060,945,5005
14591,Tiffie,Capner,tcapner7g@shinystat.com,Administrative Assistant II,5926,1654,7580
14779,Noelani,Fruchon,nfruchon7h@va.gov,Engineer II,8123,1926,10049
14031,Jeanne,Verman,jverman7j@epa.gov,Dental Hygienist,5699,810,6509
14076,Adah,Tockell,atockell7k@java.com,Financial Advisor,2147,1782,3929
14953,Valida,Custy,vcusty7l@reverbnation.com,Research Nurse,5434,1456,6890
14648,Siegfried,Berrigan,sberrigan7m@clickbank.net,Operator,1718,769,2487
14804,Leoline,Dowrey,ldowrey7p@harvard.edu,VP Product Management,8383,1156,9539
14112,Bailey,Plumer,bplumer7q@slate.com,Project Manager,5793,904,6697
14578,Angelia,Stanford,astanford7r@chron.com,Marketing Assistant,4727,640,5367
14562,Jeniffer,Cullington,jcullington7s@technorati.com,Legal Assistant,5119,673,5792
14030,Bidget,Dymick,bdymick7t@bloomberg.com,Actuary,8362,221,8583
14675,Eugen,Mapplebeck,emapplebeck7u@sina.com.cn,Internal Auditor,8003,253,8256
14448,Uriah,Croisier,ucroisier7v@feedburner.com,Senior Sales Associate,8233,839,9072
14692,Abby,McClosh,amcclosh7w@discovery.com,Mechanical Systems Engineer,1788,1110,2898
14148,Garrott,Spilstead,gspilstead7x@loc.gov,Structural Analysis Engineer,5981,1224,7205
14351,Lilli,Mocquer,lmocquer7y@aol.com,VP Marketing,2696,1227,3923
14809,Kain,Oakley,koakley80@webnode.com,Speech Pathologist,6339,1827,8166
14096,Huntlee,Yonnie,hyonnie81@pcworld.com,VP Marketing,2461,506,2967
14313,Stoddard,Taillard,staillard82@reddit.com,Senior Developer,6984,1860,8844
14115,Eadith,Lening,elening83@icq.com,Junior Executive,6261,561,6822
14330,Ferguson,Paz,fpaz84@gmpg.org,Programmer IV,5615,852,6467
14176,Kris,Pee,kpee85@hatena.ne.jp,Actuary,1323,1179,2502
14203,Claus,Yallowley,cyallowley86@baidu.com,Engineer II,3668,1252,4920
14417,Danit,Obray,dobray88@wikispaces.com,Programmer Analyst IV,3509,1954,5463
14791,Gwendolen,Reely,greely89@businessinsider.com,Biostatistician III,4845,886,5731
14274,Veronique,Kelsell,vkelsell8a@yale.edu,Administrative Officer,3239,516,3755
14109,Wes,Slatter,wslatter8b@timesonline.co.uk,Marketing Manager,9292,975,10267
14943,Lynett,Reeme,lreeme8c@yandex.ru,Environmental Specialist,9976,1455,11431
14103,Clerkclaude,Madders,cmadders8d@soup.io,Registered Nurse,5728,585,6313
14611,Gene,Gingle,ggingle8e@ca.gov,Senior Financial Analyst,7433,787,8220
14530,Elisabet,Buesnel,ebuesnel8f@slideshare.net,Actuary,2416,544,2960
14556,Staci,MacPharlain,smacpharlain8g@gnu.org,Recruiter,2029,693,2722
14535,Dicky,Deniscke,ddeniscke8h@creativecommons.org,Graphic Designer,8208,1958,10166
14869,Leigha,Streets,lstreets8i@whitehouse.gov,Desktop Support Technician,6195,1950,8145
14977,Bearnard,Winning,bwinning8j@walmart.com,Account Representative I,9297,1968,11265
14041,Shalna,Oldroyde,soldroyde8m@vistaprint.com,Business Systems Development Analyst,1979,1363,3342
14278,Bertine,Anthon,banthon8n@hexun.com,Social Worker,1952,701,2653
14082,Perl,McVee,pmcvee8o@macromedia.com,Professor,2592,1654,4246
14141,Travus,Jewar,tjewar8p@t-online.de,Administrative Assistant IV,1088,1339,2427
14105,Tamiko,O'Scannill,toscannill8q@cargocollective.com,Speech Pathologist,4087,1028,5115
14822,Leta,Osorio,losorio8r@rediff.com,Health Coach III,4318,705,5023
14956,Fedora,Kures,fkures8s@rakuten.co.jp,Assistant Professor,9707,1389,11096
14211,Quincey,Brierly,qbrierly8t@newsvine.com,Senior Sales Associate,6930,633,7563
14845,Quint,Sandercock,qsandercock8u@senate.gov,Research Nurse,7774,620,8394
14425,Rosaleen,Stanman,rstanman8w@wikipedia.org,Registered Nurse,2179,1654,3833
14172,Honoria,Rydings,hrydings8x@ibm.com,VP Quality Control,2714,1265,3979
14954,Stavro,Kilbourn,skilbourn8y@businessweek.com,Software Test Engineer IV,5404,1474,6878
14198,Jonell,Coie,jcoie8z@samsung.com,Nuclear Power Engineer,4199,582,4781
14196,Melody,Melvin,mmelvin90@europa.eu,Financial Analyst,5541,993,6534
14364,Merrie,Pascho,mpascho93@irs.gov,Senior Sales Associate,4324,1272,5596
15000,Gwennie,Hoyland,ghoyland94@noaa.gov,Junior Executive,8452,1273,9725
14001,Shermy,Grishakin,sgrishakin95@google.es,Desktop Support Technician,6863,859,7722
14818,Carrissa,Boyland,cboyland96@exblog.jp,Human Resources Assistant III,2915,425,3340
14029,Joelie,Josefs,jjosefs97@springer.com,Data Coordiator,2918,357,3275
14238,Sax,Dutt,sdutt98@blogspot.com,VP Marketing,8222,1816,10038
14453,Addia,Sprakes,asprakes9a@theatlantic.com,Operator,7461,298,7759
14014,Kiele,Ansett,kansett9b@mlb.com,Design Engineer,1262,655,1917
14552,Deedee,Earwicker,dearwicker9c@yelp.com,Senior Editor,8197,1765,9962
14190,Claiborn,De Vaan,cdevaan9e@tripod.com,Design Engineer,5841,683,6524
14341,Bobby,Jiggen,bjiggen9f@archive.org,Desktop Support Technician,5486,1927,7413
14381,Laurena,FitzGibbon,lfitzgibbon9g@mlb.com,Senior Sales Associate,7729,281,8010
14533,Fredric,Gillivrie,fgillivrie9h@altervista.org,VP Accounting,8966,929,9895
14022,Mureil,Shavel,mshavel9i@abc.net.au,Software Test Engineer I,6784,1046,7830
14323,Erinna,Brea,ebrea9j@fda.gov,Internal Auditor,6751,1769,8520
14784,Neila,Rohloff,nrohloff9k@tripadvisor.com,Help Desk Technician,9513,1642,11155
14225,Elsworth,Jarvie,ejarvie9l@arstechnica.com,Professor,1492,1536,3028
14593,Rem,Dani,rdani9n@sohu.com,Administrative Officer,1808,1814,3622
14499,Ninnetta,Straniero,nstraniero9p@ted.com,Junior Executive,7070,1353,8423
14416,Robbert,Ingyon,ringyon9q@va.gov,Research Nurse,6983,470,7453
14993,Eldredge,Gentry,egentry9r@sourceforge.net,Internal Auditor,7116,976,8092
14812,Sherill,Pidgeley,spidgeley9u@moonfruit.com,Research Associate,6213,1830,8043
14387,Calley,Espinet,cespinet9x@meetup.com,Help Desk Operator,2628,1697,4325
14962,Jonie,Dubber,jdubber9z@free.fr,Operator,8102,584,8686
14689,Chic,Cherrie,ccherriea0@usda.gov,Social Worker,8931,1214,10145
14108,Urson,Triggel,utriggela2@ted.com,GIS Technical Architect,9337,1043,10380
14636,Monro,Juszczyk,mjuszczyka4@ftc.gov,Senior Quality Engineer,3593,739,4332
14555,Kaitlin,Trevena,ktrevenaa5@tinypic.com,Legal Assistant,4036,325,4361
14309,Parrnell,Digman,pdigmana6@tuttocitta.it,Health Coach III,4910,980,5890
14206,Auberon,Patman,apatmana8@biglobe.ne.jp,Nuclear Power Engineer,6384,1790,8174
14075,Aurel,Yeude,ayeudeaa@domainmarket.com,VP Marketing,4791,1133,5924
14277,Desiri,Pember,dpemberab@oracle.com,Safety Technician III,3005,1788,4793
14670,Roxine,Mufford,rmuffordac@a8.net,Research Nurse,7477,903,8380
14142,Pattin,Janzen,pjanzenad@theglobeandmail.com,Staff Accountant III,5610,881,6491
14599,Portia,Eldredge,peldredgeae@gizmodo.com,Environmental Tech,1424,554,1978
14803,Millisent,Sousa,msousaaf@addthis.com,Database Administrator III,2233,1677,3910
14107,Jecho,Cull,jcullag@tmall.com,Clinical Specialist,1531,228,1759
14158,Galvin,Matous,gmatousai@google.de,Marketing Manager,7839,714,8553
14280,Barnabe,Grestye,bgrestyeaj@google.ca,Help Desk Technician,6774,332,7106
14143,Haven,Sedworth,hsedworthak@deviantart.com,Programmer II,4252,1914,6166
14258,Alexandrina,Huxham,ahuxhaman@gravatar.com,Marketing Assistant,3192,1455,4647
14940,Teodoor,Pacitti,tpacittiaq@51.la,Internal Auditor,3207,996,4203
14167,Miriam,Darlison,mdarlisonas@theglobeandmail.com,Senior Editor,7184,1073,8257
14633,Dode,Uttley,duttleyat@friendfeed.com,Associate Professor,6079,1652,7731
14901,Merissa,Simionescu,msimionescuav@irs.gov,Sales Associate,9340,481,9821
14415,Tripp,Gromley,tgromleyaw@google.fr,Clinical Specialist,5238,665,5903
14240,Carlin,Tudge,ctudgeay@exblog.jp,Safety Technician II,8086,1667,9753
14502,Jarib,Nabbs,jnabbsb0@dailymail.co.uk,Cost Accountant,2612,1334,3946
14813,Malvina,Clewer,mclewerb1@adobe.com,Statistician III,3299,1097,4396
14519,Dori,Smorthwaite,dsmorthwaiteb2@networksolutions.com,Technical Writer,1454,1586,3040
14053,Shaylynn,Gyde,sgydeb3@eepurl.com,Office Assistant I,3927,1070,4997
14279,Em,Doig,edoigb5@jimdo.com,Physical Therapy Assistant,9823,693,10516
14334,Florie,Attril,fattrilb7@blogger.com,Health Coach II,7822,1142,8964
14545,Packston,Fearns,pfearnsb8@studiopress.com,Financial Analyst,6552,1965,8517
14019,Sherlocke,Domerc,sdomercbb@blog.com,Help Desk Operator,1061,1316,2377
14051,Rebekah,Lipyeat,rlipyeatbc@digg.com,Programmer Analyst III,2488,911,3399
14156,Zorina,Coles,zcolesbd@narod.ru,Computer Systems Analyst I,1245,1845,3090
14248,Kelsey,Erb,kerbbe@liveinternet.ru,Chemical Engineer,6397,1498,7895
14970,Mirabel,Keslake,mkeslakebf@fc2.com,Mechanical Systems Engineer,5799,999,6798
14832,Adora,Baalham,abaalhambg@biblegateway.com,Budget/Accounting Analyst I,6308,810,7118
14003,Bibbie,Ibotson,bibotsonbi@zimbio.com,Senior Cost Accountant,3152,1507,4659
14726,Anastasie,Dorkin,adorkinbj@xinhuanet.com,Human Resources Manager,6681,782,7463
14769,Sharl,Klaus,sklausbk@patch.com,Environmental Tech,1028,1719,2747
14318,Merrily,Clears,mclearsbl@freewebs.com,Senior Financial Analyst,3316,1727,5043
14877,Petr,De Beneditti,pdebenedittibm@smugmug.com,Safety Technician II,3580,1592,5172
14673,Lyndel,Norvill,lnorvillbn@bloglines.com,Information Systems Manager,6854,393,7247
14550,Eunice,Moult,emoultbo@oakley.com,Human Resources Assistant IV,2179,933,3112
14209,Patty,Cuvley,pcuvleybp@gizmodo.com,GIS Technical Architect,8173,302,8475
14786,Marion,Draayer,mdraayerbt@google.co.jp,Accounting Assistant IV,4367,820,5187
14577,Erhart,Brantzen,ebrantzenbu@businessinsider.com,Health Coach IV,4296,1757,6053
14017,Tristam,McPhillimey,tmcphillimeybv@istockphoto.com,Database Administrator III,7970,1263,9233
14694,Collette,Minchi,cminchibw@squidoo.com,Compensation Analyst,3503,1460,4963
14543,Felice,Ciccetti,fciccettibx@hud.gov,Sales Associate,7378,752,8130
14627,Faydra,Urvoy,furvoybz@utexas.edu,Sales Representative,6300,1521,7821
14604,Mathew,Ricards,mricardsc2@ehow.com,Editor,1477,927,2404
14402,Craggie,Heustice,cheusticec5@sciencedaily.com,VP Quality Control,6091,1618,7709
14268,Florence,Dargue,fdarguec7@who.int,Food Chemist,1472,927,2399
14590,Tyrus,Laden,tladenc8@buzzfeed.com,Health Coach III,5154,272,5426
14999,Cecelia,Ahearne,cahearnec9@quantcast.com,Senior Sales Associate,8583,1586,10169
14224,Byron,Cheak,bcheakca@wufoo.com,Software Engineer III,9904,658,10562
14985,Biddie,Rennock,brennockcc@smugmug.com,Quality Engineer,9993,997,10990
14539,Corbin,Pfertner,cpfertnercd@webmd.com,Design Engineer,5744,409,6153
14661,Basil,Southard,bsouthardce@google.es,Chief Design Engineer,6661,589,7250
14233,Sigvard,Praundlin,spraundlinch@skyrock.com,Librarian,6604,1219,7823
14596,Callean,Enga,cengacj@sakura.ne.jp,Engineer IV,7418,1048,8466
14766,Jazmin,McCullouch,jmccullouchcm@tripod.com,VP Marketing,8504,988,9492
14389,Dare,Jutson,djutsoncn@furl.net,Environmental Tech,8558,801,9359
14263,Jasmin,Clinch,jclinchco@netvibes.com,VP Product Management,6770,1027,7797
14517,Odelle,Scarce,oscarcecp@t-online.de,Account Representative IV,2824,451,3275
14286,Patrizio,Dominighi,pdominighicq@abc.net.au,Budget/Accounting Analyst II,2955,1851,4806
14782,Amanda,Wrout,awroutcs@shop-pro.jp,Software Consultant,1940,1735,3675
14510,Analise,Gauche,agauchecu@forbes.com,Food Chemist,5491,1913,7404
14346,Rochelle,Shillitoe,rshillitoecx@ft.com,Analog Circuit Design manager,1666,1596,3262
14802,Sorcha,Vandrill,svandrillcy@biglobe.ne.jp,Legal Assistant,8081,1407,9488
14429,Biddie,Buckett,bbuckettcz@unblog.fr,Director of Sales,8937,1924,10861
14584,Berny,Heathorn,bheathornd0@meetup.com,Business Systems Development Analyst,2330,1682,4012
14915,Lazare,Tideswell,ltideswelld1@dailymail.co.uk,Safety Technician I,9401,1261,10662
14570,Annie,Cossem,acossemd2@oakley.com,Marketing Manager,7316,1526,8842
14492,Far,Noir,fnoird6@themeforest.net,Librarian,6021,303,6324
14191,Mindy,O' Hanvey,mohanveyd7@g.co,Clinical Specialist,9253,1412,10665
14106,Arv,Hulse,ahulsed8@hatena.ne.jp,Teacher,2063,267,2330
14200,Hardy,Johanssen,hjohanssend9@umich.edu,Paralegal,7143,1113,8256
14984,Melody,Derdes,mderdesdc@histats.com,Structural Analysis Engineer,6936,1057,7993
14700,Janek,Membry,jmembrydd@cornell.edu,Human Resources Assistant III,4455,434,4889
14131,Gladys,Humphries,ghumphriesdf@sakura.ne.jp,Information Systems Manager,5169,1265,6434
14127,Nannette,Guilayn,nguilayndh@dell.com,Assistant Professor,5865,646,6511
14871,Blake,Stoeckle,bstoeckledi@ezinearticles.com,Sales Representative,9862,705,10567
14292,Benoite,Grisard,bgrisarddj@mapquest.com,Chief Design Engineer,6643,642,7285
14086,Bernie,McAughtry,bmcaughtrydk@harvard.edu,Geologist I,6227,390,6617
14896,Caz,Janata,cjanatadl@cargocollective.com,Assistant Media Planner,8787,1371,10158
14693,Ashlie,Rettie,arettiedn@bloglines.com,Librarian,2476,692,3168
14983,Casper,Telfer,ctelferdo@state.tx.us,Professor,9948,1890,11838
14186,Barby,Puttick,bputtickdp@archive.org,Cost Accountant,9470,1521,10991
14848,Sandye,Korpolak,skorpolakdq@globo.com,Programmer II,6911,1702,8613
14737,Tiffany,Faier,tfaierdu@fema.gov,Software Consultant,4593,871,5464
14946,Hatti,Le Jean,hlejeandv@shinystat.com,Internal Auditor,8399,1264,9663
14005,Cesaro,Cagan,ccagandw@accuweather.com,Geological Engineer,9448,793,10241
14336,Sissie,Strathdee,sstrathdeedz@unc.edu,Staff Accountant I,8605,779,9384
14937,Ortensia,Patient,opatiente0@list-manage.com,Internal Auditor,1564,1265,2829
14696,Othilie,Korous,okorouse1@csmonitor.com,Community Outreach Specialist,7484,1565,9049
14173,Donovan,Norster,dnorstere2@wunderground.com,Librarian,9034,1546,10580
14805,Holt,Spoors,hspoorse6@about.me,Graphic Designer,6299,717,7016
14651,Tessi,Prozescky,tprozesckye9@wiley.com,Assistant Professor,3522,996,4518
14903,Elisabeth,Rappport,erappportea@imdb.com,Safety Technician III,2205,1142,3347
14969,Kim,Billiard,kbilliardeb@acquirethisname.com,Software Test Engineer IV,4236,239,4475
14120,Jeffy,McGreil,jmcgreilec@berkeley.edu,Cost Accountant,5226,544,5770
14676,Fern,Gillions,fgillionsee@businessinsider.com,Media Manager II,1123,1600,2723
14460,Ileana,Sea,iseaef@rediff.com,Data Coordiator,2528,1629,4157
14398,Tanhya,Monument,tmonumenteg@issuu.com,Structural Engineer,1829,943,2772
14328,Dredi,Doumerc,ddoumerceh@exblog.jp,Legal Assistant,6075,1883,7958
14124,Katti,Goode,kgoodeei@dion.ne.jp,Assistant Media Planner,9662,270,9932
14165,Julietta,Ferrieroi,jferrieroiej@wikispaces.com,Actuary,1048,1929,2977
14553,Bartholemy,Becken,bbeckenem@jalbum.net,Technical Writer,3114,1429,4543
14347,Esra,Chaddock,echaddocken@vimeo.com,Media Manager IV,1719,1624,3343
14100,Branden,Gaunter,bgauntereq@netvibes.com,Director of Sales,2077,448,2525
14015,Ellsworth,Boaler,eboaleres@usa.gov,Internal Auditor,1850,1303,3153
14039,Zollie,Kester,zkesteret@youtu.be,Research Associate,1998,692,2690
14177,Jobina,Veazey,jveazeyev@marketwatch.com,Senior Cost Accountant,2821,1134,3955
14912,Teresina,Ehrat,tehratex@sbwire.com,Account Executive,4861,1425,6286
14452,John,Robken,jrobkenf0@java.com,Environmental Specialist,8942,927,9869
14612,Hobart,Millimoe,hmillimoef1@businessweek.com,Food Chemist,8440,1330,9770
14302,Neilla,Exposito,nexpositof2@cargocollective.com,VP Sales,1883,1246,3129
14571,Moyra,Northedge,mnorthedgef3@webmd.com,Assistant Manager,3073,1208,4281
14215,Alane,McArt,amcartf5@ca.gov,Senior Quality Engineer,4618,533,5151
14097,Deck,Rowswell,drowswellf6@alexa.com,Compensation Analyst,9491,864,10355
14422,Cara,Valsler,cvalslerf7@posterous.com,Nurse,6007,320,6327
14888,Emilee,Basini-Gazzi,ebasinigazzif8@github.io,Account Executive,4849,1655,6504
14982,Ruprecht,Lisimore,rlisimoref9@google.co.jp,Help Desk Technician,9474,1938,11412
14407,Gwyneth,Hampshaw,ghampshawfa@twitter.com,Occupational Therapist,1527,1298,2825
14089,Arnoldo,Wyrill,awyrillfc@myspace.com,Quality Engineer,6544,374,6918
14733,Saraann,Harman,sharmanfe@earthlink.net,Business Systems Development Analyst,9355,1685,11040
14290,Ethelda,Heinsen,eheinsenfg@xinhuanet.com,Actuary,1636,569,2205
14073,Sharleen,Gatfield,sgatfieldfh@ca.gov,Structural Engineer,5452,1963,7415
14408,Tilda,Perillo,tperillofi@yale.edu,Design Engineer,3594,999,4593
14576,Rick,MacGillavery,rmacgillaveryfj@shareasale.com,Database Administrator II,8489,720,9209
14114,Allys,Capron,acapronfl@parallels.com,Staff Scientist,8654,1633,10287
14649,Corrina,Lamble,clamblefn@zimbio.com,GIS Technical Architect,9027,1622,10649
14516,Andrei,Biddell,abiddellfo@zdnet.com,Recruiting Manager,6469,1230,7699
14305,Erick,Samme,esammefp@un.org,Social Worker,9851,1172,11023
14267,Kanya,Grunwall,kgrunwallfq@hugedomains.com,Product Engineer,5835,1839,7674
14288,Ewart,Rollings,erollingsfr@hexun.com,Senior Cost Accountant,3653,648,4301
14216,Sara-ann,Leggat,sleggatfs@imdb.com,Speech Pathologist,2708,568,3276
14948,Berke,Tellenbroker,btellenbrokerfv@canalblog.com,Payment Adjustment Coordinator,7959,1781,9740
14077,Davis,Shaefer,dshaeferfw@yellowbook.com,Structural Engineer,9123,501,9624
14874,Dominique,Duffield,dduffieldg0@shutterfly.com,Senior Financial Analyst,3182,1920,5102
14739,Helga,Kirkham,hkirkhamg2@yellowpages.com,Recruiting Manager,5005,1327,6332
14181,Quentin,Geldert,qgeldertg3@cbsnews.com,Office Assistant III,2286,978,3264
14963,Virgina,Ruckledge,vruckledgeg4@xing.com,VP Quality Control,4564,1350,5914
14234,Vanessa,Dunthorn,vdunthorng5@techcrunch.com,Actuary,4903,864,5767
14477,Merna,Pelfer,mpelferg6@purevolume.com,Payment Adjustment Coordinator,5949,1902,7851
14870,Anabel,Abrashkov,aabrashkovg9@example.com,Marketing Manager,8296,741,9037
14339,Murdoch,Christophersen,mchristophersenga@skype.com,Quality Control Specialist,4526,277,4803
14032,Gian,Krolik,gkrolikgc@surveymonkey.com,Research Associate,1342,1448,2790
14301,Milicent,Suggett,msuggettgd@geocities.jp,Structural Engineer,4901,1324,6225
14785,Thomasin,Kohrsen,tkohrsengf@fema.gov,Account Representative III,8957,1911,10868
14496,Kassie,Tyers,ktyersgj@wordpress.com,Automation Specialist II,7670,1098,8768
14914,Dionysus,Basso,dbassogk@t.co,Actuary,3552,511,4063
14924,Laurel,Swinford,lswinfordgl@samsung.com,Social Worker,7860,494,8354
14235,Antony,Kelway,akelwaygp@microsoft.com,GIS Technical Architect,6125,1744,7869
14709,Jyoti,MacMenamy,jmacmenamygq@washington.edu,Programmer Analyst II,1357,1308,2665
14420,Karissa,De-Ville,kdevillegr@comsenz.com,Clinical Specialist,6326,1957,8283
14646,Rowe,Weekland,rweeklandgt@cnbc.com,Software Engineer III,4939,1755,6694
14226,Danila,Kevane,dkevanegw@bing.com,Nurse Practicioner,1128,1788,2916
14401,Cele,Streetfield,cstreetfieldgx@netvibes.com,Teacher,8931,1731,10662
14329,Betteann,Witcombe,bwitcombegz@mysql.com,Computer Systems Analyst I,8445,336,8781
14918,Giffard,Andrusov,gandrusovh1@home.pl,Financial Analyst,8177,548,8725
14163,Chickie,Mateuszczyk,cmateuszczykh2@patch.com,Technical Writer,8339,1360,9699
14756,Josi,Tafani,jtafanih3@reverbnation.com,Systems Administrator IV,7887,1881,9768
14104,Claudell,Lowensohn,clowensohnh4@quantcast.com,Marketing Manager,2382,1244,3626
14579,Eolanda,Partrick,epartrickh5@squidoo.com,Administrative Assistant IV,6221,1004,7225
14344,Marillin,Yitzhakof,myitzhakofh8@liveinternet.ru,Senior Financial Analyst,3622,665,4287
14168,Ray,Crosoer,rcrosoerha@dailymail.co.uk,Operator,8085,1558,9643
14887,Roland,Prettjohn,rprettjohnhb@macromedia.com,Automation Specialist IV,5447,961,6408
14271,Ardyth,Sutor,asutorhd@slate.com,Product Engineer,9056,913,9969
14981,Sallee,Stark,sstarkhf@cdc.gov,Recruiter,3487,1077,4564
14991,Frasier,Dineges,fdinegeshh@nih.gov,Design Engineer,1526,538,2064
14944,Tressa,Dungay,tdungayhi@wikia.com,Operator,5556,1799,7355
14867,Maure,Riordan,mriordanhm@webmd.com,Community Outreach Specialist,6096,1716,7812
14503,Georgie,Blacksell,gblacksellhp@ameblo.jp,Research Nurse,6501,869,7370
14799,Jasen,Korneluk,jkornelukhs@uol.com.br,GIS Technical Architect,4785,1786,6571
14260,Kass,Ibel,kibelht@opera.com,VP Marketing,2037,1332,3369
14317,Uriel,Pohling,upohlinghv@ucoz.ru,Safety Technician I,8979,1765,10744
14307,Desirae,Ranger,drangerhw@skype.com,Food Chemist,2979,490,3469
14876,Randie,Rubenfeld,rrubenfeldhz@craigslist.org,Recruiter,8370,1143,9513
14140,Anya,Aleksashin,aaleksashini0@sina.com.cn,Marketing Manager,3542,1345,4887
14625,Drake,Courtes,dcourtesi2@fda.gov,Recruiter,6113,1097,7210
14628,Theodor,Bartleet,tbartleeti4@vinaora.com,Librarian,2284,1603,3887
14810,Selena,Hundell,shundelli5@wikipedia.org,Administrative Assistant I,1729,956,2685
14377,Dylan,Bogie,dbogiei6@biglobe.ne.jp,Software Test Engineer IV,9828,312,10140
14679,Brit,Balsdone,bbalsdonei7@tripod.com,Assistant Media Planner,2653,981,3634
14638,Mamie,McMains,mmcmainsi8@umich.edu,Help Desk Operator,5353,619,5972
14775,Kingston,Brandreth,kbrandrethia@archive.org,VP Product Management,8990,1064,10054
14743,Modestine,Rowet,mrowetif@godaddy.com,Account Representative IV,9528,339,9867
14468,Phillipe,McGeady,pmcgeadyii@gravatar.com,Speech Pathologist,5606,826,6432
14891,Danielle,Worge,dworgeij@aol.com,Human Resources Manager,8153,1627,9780
14340,Hyacinth,Lergan,hlerganil@npr.org,Marketing Manager,5775,460,6235
14083,Gage,Willcox,gwillcoxim@networkadvertising.org,Community Outreach Specialist,3293,1165,4458
14205,Myrvyn,Featherstonhaugh,mfeatherstonhaughiq@over-blog.com,Sales Representative,1294,1975,3269
14947,Gerome,Sugarman,gsugarmanir@google.co.jp,Operator,2146,445,2591
14720,Anetta,Axworthy,aaxworthyis@omniture.com,VP Product Management,2578,1993,4571
14370,Edwin,Oulner,eoulneriu@seattletimes.com,Food Chemist,9902,867,10769
14129,Van,Favill,vfavillix@sfgate.com,Senior Developer,5028,945,5973
14079,Erwin,Digwood,edigwoodiy@youtu.be,Media Manager III,1553,1309,2862
14379,Kally,Dumphrey,kdumphreyiz@vk.com,Product Engineer,9466,1825,11291
14474,Eirena,Espine,eespinej2@phoca.cz,Database Administrator III,9864,741,10605
14575,Quincey,Secret,qsecretj3@marketwatch.com,Office Assistant II,5919,488,6407
14018,Stephenie,Kennsley,skennsleyj4@chron.com,Geologist III,9937,798,10735
14998,Kellby,Derell,kderelljd@google.com.br,Speech Pathologist,9646,274,9920
14922,Salim,Ryding,srydingjf@spotify.com,Payment Adjustment Coordinator,6745,1881,8626
14213,Tandy,Robke,trobkejh@twitter.com,Occupational Therapist,3825,1273,5098
14540,Rozalie,McCoid,rmccoidji@skyrock.com,Sales Associate,5416,1478,6894
14975,Eliot,Bottell,ebottelljm@myspace.com,General Manager,2544,527,3071
14350,Consalve,Baggiani,cbaggianijn@tumblr.com,Account Coordinator,5822,209,6031
14828,Ginnie,Gaspard,ggaspardjr@163.com,Assistant Media Planner,6512,377,6889
14600,Carlos,Cowlam,ccowlamjt@google.pl,Research Associate,8349,862,9211
14824,Kordula,Barlee,kbarleejv@arizona.edu,Nuclear Power Engineer,4070,250,4320
14253,Fanechka,Delap,fdelapjy@instagram.com,Recruiting Manager,4672,1601,6273
14750,Victoria,Spary,vsparyk1@google.com.hk,Software Test Engineer III,4702,360,5062
14091,Emelita,O'Finan,eofinank2@usgs.gov,Assistant Professor,7952,1167,9119
14875,Tyne,Collingham,tcollinghamk5@sfgate.com,Human Resources Manager,7666,267,7933
14935,Donella,Bland,dblandk6@weebly.com,Operator,2700,1683,4383
14062,Dale,Gors,dgorska@statcounter.com,VP Accounting,2446,695,3141
14314,Sabra,Simenon,ssimenonkb@technorati.com,Quality Engineer,2612,690,3302
14635,Horatius,Ewbach,hewbachkd@sina.com.cn,Web Developer IV,8441,700,9141
14232,Mitchell,Covert,mcovertke@ucoz.ru,Assistant Manager,5233,850,6083
14825,Shalne,Toombs,stoombskg@opera.com,Human Resources Assistant IV,3982,1595,5577
14971,Jemimah,Stollard,jstollardkk@usatoday.com,Account Coordinator,3829,306,4135
14905,Mollie,Skaife d'Ingerthorpe,mskaifedingerthorpekm@npr.org,Safety Technician I,1219,461,1680
14025,Allene,Skamell,askamellkn@utexas.edu,Sales Representative,8419,579,8998
14622,Thorndike,Nansom,tnansomkq@blogspot.com,Pharmacist,2885,363,3248
14920,Hamid,Nancekivell,hnancekivellkr@dot.gov,Dental Hygienist,9011,1017,10028
14410,Aurilia,Roskams,aroskamsks@sciencedaily.com,Senior Sales Associate,9156,1251,10407
14808,Kalie,Hawk,khawkkt@dropbox.com,Assistant Media Planner,9036,1637,10673
14934,Roxine,Heigl,rheiglkv@feedburner.com,Teacher,5507,763,6270
14426,Ruthann,Burgh,rburghkx@twitpic.com,Software Test Engineer IV,8946,1759,10705
14616,Cecilius,Duckitt,cduckittky@youtube.com,Senior Financial Analyst,9838,506,10344
14155,Clary,Sapshed,csapshedkz@japanpost.jp,Internal Auditor,4622,1064,5686
14866,Jedd,Blondelle,jblondellel0@hhs.gov,Computer Systems Analyst III,6237,1685,7922
14166,Sheelah,Jacmar,sjacmarl1@cmu.edu,Senior Cost Accountant,6572,1909,8481
14179,Rhett,Ulrik,rulrikl3@typepad.com,Help Desk Operator,6424,1562,7986
14751,Sophia,Balam,sbalaml6@bloglovin.com,Computer Systems Analyst III,6095,1701,7796
14442,Harcourt,Ableson,hablesonl8@businessweek.com,Administrative Assistant I,9584,1543,11127
14927,Ronni,Gerty,rgertyl9@privacy.gov.au,Technical Writer,9731,1685,11416
14795,Benson,Ebdin,bebdinlb@moonfruit.com,Computer Systems Analyst III,2072,399,2471
14439,Moishe,Fawlkes,mfawlkeslc@smugmug.com,Sales Associate,2525,677,3202
14787,Shermy,D'Aguanno,sdaguannole@blogs.com,Programmer II,8348,1347,9695
14691,Francene,Berre,fberrelg@vkontakte.ru,Senior Developer,2021,1167,3188
14587,Pollyanna,Soall,psoalllh@spotify.com,Technical Writer,7725,1436,9161
14538,Binky,Hairsine,bhairsineli@java.com,Geologist IV,9999,518,10517
14254,Birgitta,Gazey,bgazeylj@youku.com,Research Associate,8997,1712,10709
14256,Georgina,Dilks,gdilkslk@cbslocal.com,Legal Assistant,6893,764,7657
14045,Colin,Adney,cadneylo@tamu.edu,Marketing Assistant,5832,1782,7614
14472,Perice,Vanini,pvaninilq@pagesperso-orange.fr,Programmer II,8681,313,8994
14419,Jeniece,Hastie,jhastielr@ezinearticles.com,Assistant Media Planner,4645,1872,6517
14994,Gloriane,Smooth,gsmoothls@icq.com,Cost Accountant,4160,1805,5965
14698,Duke,Pearne,dpearnelv@oakley.com,Structural Engineer,8474,1875,10349
14397,Batholomew,Lytle,blytlely@nymag.com,GIS Technical Architect,8506,1338,9844
14731,Gardie,Portam,gportamlz@vkontakte.ru,Clinical Specialist,1411,562,1973
14486,Daisy,Matschek,dmatschekm0@lulu.com,Health Coach I,1603,817,2420
14490,Torrin,Haddington,thaddingtonm2@google.fr,Research Associate,2048,1864,3912
14721,Nobie,Kassel,nkasselm4@gnu.org,Legal Assistant,8527,1970,10497
14707,Eadmund,Thominga,ethomingam5@vimeo.com,Human Resources Manager,5260,1974,7234
14476,Darline,Montez,dmontezm7@yellowpages.com,Research Assistant II,8787,618,9405
14697,Venita,Mawne,vmawnem8@china.com.cn,Accounting Assistant III,3807,1411,5218
14338,Carolus,Attwill,cattwillmd@mozilla.org,Computer Systems Analyst II,1831,1737,3568
14399,Tyrone,Bradbrook,tbradbrookml@cdbaby.com,Payment Adjustment Coordinator,7262,1549,8811
14655,Michel,Kemmish,mkemmishmo@ning.com,Research Nurse,3332,265,3597
14423,Clarette,Meredyth,cmeredythmq@businesswire.com,Operator,6587,1433,8020
14391,Tish,Kingh,tkinghmw@samsung.com,Professor,8155,636,8791
14653,Storm,Elix,selixmx@ning.com,Legal Assistant,4573,1514,6087
14424,Darin,Fritz,dfritzn0@arizona.edu,Paralegal,1232,990,2222
14064,Rozanna,Muccino,rmuccinon1@homestead.com,Physical Therapy Assistant,5627,1944,7571
14987,Pavia,Inchan,pinchann6@spotify.com,Tax Accountant,6742,670,7412
14771,Midge,Bolzmann,mbolzmannn7@ameblo.jp,Editor,4051,1678,5729
14508,North,Scade,nscadena@huffingtonpost.com,Office Assistant III,7226,1383,8609
14827,Bren,Annetts,bannettsnf@wunderground.com,Junior Executive,8662,746,9408
14201,Holden,Kennington,hkenningtonng@walmart.com,Assistant Media Planner,9724,821,10545
14210,Aldrich,Nazair,anazairni@livejournal.com,Administrative Officer,5887,294,6181
14602,Beverly,MacRedmond,bmacredmondnl@wufoo.com,Tax Accountant,9167,871,10038
14028,Nels,Mandifield,nmandifieldno@nifty.com,Marketing Manager,9337,1009,10346
14464,Arnaldo,Behnen,abehnennp@hostgator.com,Project Manager,9178,1310,10488
14892,Bronny,Mourge,bmourgenq@slideshare.net,Web Developer III,9104,947,10051
14569,Blondie,Gregol,bgregolnr@bluehost.com,Nuclear Power Engineer,7926,1720,9646
14684,Nevin,Gostling,ngostlingns@wikia.com,Nuclear Power Engineer,5262,1070,6332
14348,Kippy,Shee,ksheent@yelp.com,Payment Adjustment Coordinator,6411,853,7264
14778,Jerrie,Dart,jdartnu@comcast.net,Payment Adjustment Coordinator,2927,354,3281
14361,Dionisio,Dimmer,ddimmernv@csmonitor.com,Senior Sales Associate,4363,735,5098
14193,Blondy,Mion,bmionnx@aol.com,Editor,6686,575,7261
14126,Gigi,Farleigh,gfarleigho0@dmoz.org,Software Test Engineer I,9823,830,10653
14461,Guilbert,Caudrey,gcaudreyo3@ycombinator.com,Structural Engineer,4133,1627,5760
14489,Hazlett,Physic,hphysico5@mayoclinic.com,Structural Engineer,9356,853,10209
14491,Klemens,Jeandeau,kjeandeauo6@people.com.cn,Senior Editor,5158,1490,6648
14139,Ronny,Cape,rcapeo8@list-manage.com,Human Resources Manager,1223,1949,3172
14294,Nichole,McLarens,nmclarensoa@sfgate.com,Analog Circuit Design manager,3749,350,4099
14695,Harwell,Curran,hcurranoc@wisc.edu,Quality Engineer,9304,823,10127
14663,Daisy,Limbrick,dlimbrickod@smugmug.com,Financial Advisor,2653,411,3064
14331,Ailis,Ateggart,aateggartoi@barnesandnoble.com,Account Coordinator,9906,1605,11511
14814,Adelina,Van,avanon@123-reg.co.uk,Occupational Therapist,2803,1532,4335
14038,Wilek,Battill,wbattillop@reuters.com,Pharmacist,3983,499,4482
14483,Katine,Kohrding,kkohrdingoq@upenn.edu,GIS Technical Architect,7866,1615,9481
14153,Anselma,Karran,akarranor@godaddy.com,General Manager,9852,1910,11762
14074,Vyky,Macknish,vmacknishow@etsy.com,Sales Representative,6619,233,6852
14068,Linn,Figgins,lfigginsoz@eepurl.com,Statistician IV,7494,1088,8582
14547,Francois,Titley,ftitleyp2@mlb.com,Computer Systems Analyst II,3185,1989,5174
14597,Mal,Kees,mkeesp7@soup.io,Actuary,2248,221,2469
14797,Slade,Maneylaws,smaneylawspc@imgur.com,Community Outreach Specialist,3213,1300,4513
14161,Rona,Jerrard,rjerrardpd@deviantart.com,Environmental Specialist,8318,825,9143
14826,Henrie,Jurewicz,hjurewiczpe@businessweek.com,Financial Analyst,2674,1563,4237
14862,Cletus,Thunnerclef,cthunnerclefpf@cornell.edu,Chemical Engineer,2697,1045,3742
14182,Boy,Grane,bgranepg@ucoz.com,Project Manager,3434,731,4165
14312,Nalani,Berard,nberardpi@huffingtonpost.com,Sales Representative,6915,1302,8217
14214,Ramonda,McIlharga,rmcilhargapm@oracle.com,Administrative Assistant III,6092,1122,7214
14807,Saree,Dubbin,sdubbinpp@over-blog.com,Sales Representative,1367,1602,2969
14647,Dasya,Karus,dkaruspz@tuttocitta.it,Junior Executive,3819,1498,5317
14742,Celle,Windley,cwindleyq0@apple.com,Analog Circuit Design manager,5544,1669,7213
14281,Kylie,Fisher,kfisherq3@alibaba.com,Environmental Tech,9834,600,10434
14759,Dru,Summersett,dsummersettq4@livejournal.com,Geological Engineer,1259,1136,2395
14964,Vincenz,Wilce,vwilceqi@pagesperso-orange.fr,Cost Accountant,1861,647,2508
14654,Stavro,Gullivent,sgulliventqk@usa.gov,Budget/Accounting Analyst II,4322,779,5101
14631,Gallagher,Iannelli,giannelliqm@dailymail.co.uk,Chief Design Engineer,1190,1537,2727
14531,Zahara,Twitchett,ztwitchettqq@desdev.cn,Staff Accountant II,7941,1808,9749
14753,Hermy,Eates,heatesqr@so-net.ne.jp,Mechanical Systems Engineer,4309,384,4693
14834,Carlen,MacAirt,cmacairtqu@cloudflare.com,Design Engineer,8068,1498,9566
14668,Euphemia,Patron,epatronqx@bluehost.com,Community Outreach Specialist,6054,771,6825
14413,Lowe,Bee,lbeer1@weather.com,Editor,1311,776,2087
14087,Doralin,Ahearne,dahearner3@examiner.com,Safety Technician I,4718,1609,6327
14113,Dareen,Pagin,dpaginr4@wufoo.com,Civil Engineer,6036,1716,7752
14316,Lutero,Strethill,lstrethillr7@boston.com,Accounting Assistant III,9381,1646,11027
14885,Louisette,Dziwisz,ldziwiszra@archive.org,Civil Engineer,5481,1046,6527
14289,Anson,Suett,asuettrb@theguardian.com,Engineer I,2568,829,3397
14276,Hogan,Cuppitt,hcuppittri@goo.ne.jp,Administrative Officer,8789,1574,10363
14430,Kermie,Biermatowicz,kbiermatowiczrn@umich.edu,Accountant II,1044,1810,2854
14618,Kailey,Scorrer,kscorrerrq@apple.com,Account Representative II,8147,1285,9432
15264,Adelheid,Carnilian,acarnilian0@foxnews.com,Developer I,4022,1740,5762
15109,Dinny,Smitheman,dsmitheman1@usa.gov,Web Designer I,2800,1349,4149
15863,Teressa,Kyteley,tkyteley2@bing.com,Help Desk Operator,5682,286,5968
15252,Sallyanne,Dumbare,sdumbare3@berkeley.edu,Quality Engineer,7944,569,8513
15631,Elliot,Jefferies,ejefferies4@technorati.com,Budget/Accounting Analyst III,5904,1258,7162
15579,Caryl,Gaffer,cgaffer5@1und1.de,Executive Secretary,4299,1918,6217
15361,Skelly,Milksop,smilksop6@ox.ac.uk,Project Manager,1369,1789,3158
15331,Abbie,Pughsley,apughsley7@shop-pro.jp,Environmental Specialist,3813,215,4028
15446,Rhianon,Orys,rorys8@tripadvisor.com,Computer Systems Analyst IV,5598,622,6220
15648,Udell,Lethbury,ulethbury9@army.mil,Director of Sales,9830,254,10084
15785,Cliff,Yanshinov,cyanshinova@smugmug.com,Operator,6164,281,6445
15436,Saundra,Chimienti,schimientib@house.gov,Clinical Specialist,7846,1048,8894
15183,Roosevelt,Mewburn,rmewburnc@ihg.com,Senior Cost Accountant,3175,229,3404
15241,Joanne,Fourcade,jfourcaded@sphinn.com,Senior Quality Engineer,1143,1372,2515
15137,Trina,Tagg,ttagge@cafepress.com,VP Accounting,9600,456,10056
15115,Gregoor,Catcheside,gcatchesidef@smugmug.com,Nurse Practicioner,9756,1400,11156
15881,Vassily,Lyven,vlyveng@google.co.uk,Product Engineer,9600,1173,10773
15976,Doralynn,Isselee,disseleeh@wikipedia.org,Desktop Support Technician,1355,700,2055
15400,Annabel,Trowler,atrowleri@arizona.edu,VP Sales,3412,1997,5409
15711,Fae,Thurgood,fthurgoodj@nytimes.com,Software Consultant,6315,1918,8233
15087,Charissa,Mattusevich,cmattusevichk@constantcontact.com,Environmental Specialist,2145,1099,3244
15769,Waylan,Kulas,wkulasl@unc.edu,Junior Executive,3908,1587,5495
15630,Tory,Bonsale,tbonsalem@xinhuanet.com,Office Assistant II,5286,254,5540
15187,Wernher,Gierek,wgierekn@washington.edu,Executive Secretary,3384,1170,4554
15868,Clem,Crosoer,ccrosoero@usnews.com,Financial Advisor,8669,963,9632
15202,Annabelle,Franz-Schoninger,afranzschoningerp@japanpost.jp,Human Resources Assistant I,5173,1713,6886
15833,Mitch,Kingscote,mkingscoteq@liveinternet.ru,Geological Engineer,1342,1099,2441
15714,Sabina,Waskett,swaskettr@soup.io,Automation Specialist I,6464,921,7385
15256,Kippy,Tesyro,ktesyros@irs.gov,Database Administrator IV,7958,1129,9087
15163,Candy,Frankcom,cfrankcomt@independent.co.uk,Actuary,8996,1086,10082
15405,Teodorico,Fanshawe,tfanshawev@technorati.com,Human Resources Manager,9071,1157,10228
15665,Benyamin,Buard,bbuardw@booking.com,Human Resources Manager,5174,1164,6338
15805,Ronnie,Gullifant,rgullifantx@issuu.com,Accounting Assistant III,6505,1268,7773
15322,Lyndsie,Moryson,lmorysony@cargocollective.com,Nurse,1084,1658,2742
15839,Elisabetta,Baroche,ebarochez@liveinternet.ru,General Manager,1573,263,1836
15305,Silvana,Moogan,smoogan10@digg.com,Senior Financial Analyst,3591,209,3800
15010,Karrie,Agglione,kagglione11@stumbleupon.com,Engineer IV,4900,425,5325
15722,Taddeo,Bottini,tbottini12@indiegogo.com,Mechanical Systems Engineer,1566,1595,3161
15698,Lenna,Shadrach,lshadrach13@ibm.com,Project Manager,9039,1889,10928
15230,Giustina,Clearley,gclearley14@ox.ac.uk,Systems Administrator IV,9170,1701,10871
15795,Danette,Snelgar,dsnelgar15@yellowpages.com,Senior Sales Associate,1824,600,2424
15780,Charmane,Lovitt,clovitt16@people.com.cn,Staff Accountant I,6738,1667,8405
15204,Vera,Cabrera,vcabrera17@youtube.com,Account Executive,8918,633,9551
15200,Alexi,Keaton,akeaton18@army.mil,Software Consultant,9718,1017,10735
15566,Giordano,McClements,gmcclements19@ehow.com,Research Associate,4930,1592,6522
15074,Carolann,Gallaccio,cgallaccio1a@newsvine.com,Account Executive,5509,1847,7356
15421,Hilda,Daveley,hdaveley1b@jigsy.com,Senior Editor,9037,1981,11018
15034,Lorry,Aspden,laspden1c@zdnet.com,Computer Systems Analyst I,3369,893,4262
15657,Meredeth,Twigley,mtwigley1d@prweb.com,Editor,1360,1109,2469
15594,Bearnard,Taggerty,btaggerty1e@trellian.com,Technical Writer,1216,1580,2796
15914,Jasmine,Degan,jdegan1f@sohu.com,Tax Accountant,9503,824,10327
15956,Jerri,Gravestone,jgravestone1g@vkontakte.ru,Sales Associate,9911,1227,11138
15986,Tades,Farrand,tfarrand1h@sogou.com,Web Developer III,1271,975,2246
15392,Regan,Grishechkin,rgrishechkin1i@360.cn,Help Desk Operator,8780,486,9266
15932,Corrianne,Seldner,cseldner1j@nasa.gov,Safety Technician III,2753,1008,3761
15814,Barton,Adame,badame1k@vinaora.com,Paralegal,9267,725,9992
15085,Ive,Chisholme,ichisholme1l@fotki.com,Food Chemist,4381,1856,6237
15096,Candide,Banes,cbanes1m@va.gov,Desktop Support Technician,8181,254,8435
15513,Dorelle,McGinney,dmcginney1n@sakura.ne.jp,Web Designer IV,8811,913,9724
15026,Deidre,Dimanche,ddimanche1o@exblog.jp,Statistician IV,3606,747,4353
15560,Lyn,Hart,lhart1p@1und1.de,Assistant Media Planner,4612,1085,5697
15643,Mersey,Fechnie,mfechnie1q@elegantthemes.com,Nurse,5756,648,6404
15917,Peder,Pikhno,ppikhno1r@ocn.ne.jp,Safety Technician III,8485,1683,10168
15555,Ichabod,Pemble,ipemble1s@dedecms.com,Account Coordinator,2790,1791,4581
15463,Colly,Roskelley,croskelley1t@opensource.org,Software Test Engineer IV,3315,1432,4747
15317,Maddi,Starking,mstarking1u@oracle.com,Accountant III,1857,468,2325
15984,Karim,Warn,kwarn1v@ft.com,Human Resources Assistant IV,2517,1542,4059
15082,Perice,Thurston,pthurston1w@nifty.com,Marketing Assistant,5847,1277,7124
15563,Ellsworth,Zarfati,ezarfati1x@yahoo.co.jp,Senior Developer,3203,1173,4376
15098,Kristel,Guy,kguy1y@furl.net,General Manager,8960,1413,10373
15525,Joanie,Artinstall,jartinstall1z@yolasite.com,Paralegal,9475,1608,11083
15740,Garret,Yarranton,gyarranton20@marriott.com,Account Representative III,7027,943,7970
15794,Maurie,Lening,mlening21@elegantthemes.com,Actuary,9561,1189,10750
15751,Tanny,Hempshall,thempshall22@engadget.com,Senior Cost Accountant,3504,1213,4717
15165,Griff,Baxstare,gbaxstare23@furl.net,Biostatistician IV,8273,1563,9836
15379,Magdalena,Brundale,mbrundale25@photobucket.com,Staff Accountant II,7754,1504,9258
15808,Gavra,Myrick,gmyrick27@mashable.com,Tax Accountant,5823,1821,7644
15330,Wilhelm,Woodhall,wwoodhall28@canalblog.com,Staff Scientist,8437,1797,10234
15865,Kellina,Sly,ksly29@discovery.com,Environmental Specialist,1046,1479,2525
15242,Alfonso,Vaux,avaux2a@ifeng.com,Compensation Analyst,1411,1330,2741
15991,Roma,Dikes,rdikes2b@skype.com,Automation Specialist III,3347,1467,4814
15982,Egon,Garbert,egarbert2c@1und1.de,Junior Executive,6467,1253,7720
15381,Corrina,Corroyer,ccorroyer2d@free.fr,Senior Sales Associate,8626,1907,10533
15759,Ludwig,Gillson,lgillson2e@taobao.com,Product Engineer,5908,962,6870
15994,Amber,Jelphs,ajelphs2f@hugedomains.com,Senior Cost Accountant,7676,420,8096
15953,Marsiella,Limming,mlimming2h@typepad.com,Web Designer II,6315,426,6741
15599,Hillel,Burrell,hburrell2i@pinterest.com,Actuary,8012,1043,9055
15726,Zia,Proschek,zproschek2k@issuu.com,General Manager,6653,1316,7969
15944,Boone,Le Barre,blebarre2m@github.io,Help Desk Technician,6940,1132,8072
15387,Carmine,Brandli,cbrandli2n@seattletimes.com,Assistant Professor,1174,1639,2813
15697,Lenard,Lintot,llintot2o@mtv.com,Human Resources Manager,5503,1711,7214
15521,Belia,Condliffe,bcondliffe2p@comsenz.com,Biostatistician II,1630,204,1834
15807,Hansiain,Succamore,hsuccamore2q@arstechnica.com,Safety Technician I,9700,1130,10830
15383,Lyle,Thorsby,lthorsby2r@google.ca,Operator,9983,809,10792
15130,Meade,Batstone,mbatstone2u@merriam-webster.com,Editor,4285,1953,6238
15474,Willard,Hounson,whounson2v@mapquest.com,Senior Cost Accountant,7789,482,8271
15715,Susanna,Ybarra,sybarra2w@cornell.edu,Social Worker,5276,427,5703
15841,Marybeth,Rodolfi,mrodolfi2x@forbes.com,Senior Cost Accountant,4824,671,5495
15430,Boigie,Creighton,bcreighton2y@list-manage.com,Analog Circuit Design manager,5632,1404,7036
15162,Tessie,Nellies,tnellies2z@miibeian.gov.cn,Social Worker,8258,1173,9431
15394,Tammy,Hartell,thartell30@upenn.edu,Systems Administrator I,5135,525,5660
15479,Krystalle,MacNalley,kmacnalley31@statcounter.com,Software Consultant,1906,1117,3023
15800,Adora,Romeo,aromeo32@nyu.edu,Editor,3263,1457,4720
15081,Granville,MacLaig,gmaclaig33@businessinsider.com,Civil Engineer,6460,1691,8151
15974,Amy,Santino,asantino34@furl.net,Senior Cost Accountant,7894,849,8743
15327,Katharina,Wille,kwille35@soup.io,Associate Professor,9909,1743,11652
15316,Graeme,Chittleburgh,gchittleburgh36@ebay.com,Sales Representative,2537,1941,4478
15017,Shurwood,Wilkin,swilkin37@weather.com,Financial Advisor,1256,1432,2688
15924,Lisette,Dotterill,ldotterill38@goo.ne.jp,Automation Specialist IV,2800,1439,4239
15064,Teddy,Keningham,tkeningham39@stumbleupon.com,Professor,5367,1758,7125
15161,Clari,McCrow,cmccrow3a@netscape.com,Computer Systems Analyst IV,2801,1571,4372
15708,Nolana,Lillie,nlillie3b@infoseek.co.jp,Sales Associate,5857,927,6784
15186,Cissy,Tittletross,ctittletross3d@jugem.jp,Associate Professor,6715,1139,7854
15632,Haleigh,Donoghue,hdonoghue3e@weebly.com,VP Product Management,2646,1684,4330
15849,Lin,Haslehurst,lhaslehurst3f@multiply.com,Product Engineer,6938,601,7539
15595,Imelda,Rubie,irubie3g@google.it,Database Administrator II,3029,1107,4136
15052,Noach,Noraway,nnoraway3h@forbes.com,Structural Engineer,2532,1628,4160
15016,Axel,Ayre,aayre3i@bizjournals.com,Health Coach IV,7014,918,7932
15176,Evelina,Overthrow,eoverthrow3j@ameblo.jp,Accountant IV,3095,548,3643
15556,Gibb,Francey,gfrancey3k@epa.gov,Tax Accountant,8500,1961,10461
15502,Christiane,Guyers,cguyers3l@drupal.org,Nuclear Power Engineer,4000,877,4877
15273,Ulrick,O'Monahan,uomonahan3m@behance.net,Research Associate,9157,1673,10830
15442,Willow,Comins,wcomins3n@pagesperso-orange.fr,Project Manager,6890,1064,7954
15272,Vassily,Orteaux,vorteaux3o@posterous.com,Senior Cost Accountant,7358,1338,8696
15332,Debby,Dellenbrook,ddellenbrook3p@sohu.com,Sales Representative,6267,282,6549
15103,Jone,Spollen,jspollen3q@youtube.com,Media Manager IV,3312,1249,4561
15385,Bria,Brendeke,bbrendeke3r@multiply.com,Human Resources Assistant IV,2502,1710,4212
15613,Karel,Katzmann,kkatzmann3u@usatoday.com,Health Coach II,5596,241,5837
15314,Sophronia,Hickin,shickin3v@networksolutions.com,Help Desk Operator,2102,1811,3913
15363,Melosa,Symones,msymones3w@joomla.org,Computer Systems Analyst II,4171,1709,5880
15554,Annice,Blum,ablum3x@so-net.ne.jp,Budget/Accounting Analyst III,6277,1419,7696
15644,Elane,Barbara,ebarbara3y@hc360.com,Dental Hygienist,1611,269,1880
15936,Margarette,Tetther,mtetther3z@npr.org,Accounting Assistant II,5681,1900,7581
15879,Odessa,Orrocks,oorrocks40@jalbum.net,Internal Auditor,5772,1614,7386
15884,Urson,Feake,ufeake41@free.fr,Project Manager,5993,900,6893
15024,Devora,Kroger,dkroger44@storify.com,Software Consultant,7070,255,7325
15758,Dayle,O'Halligan,dohalligan45@ucoz.ru,Recruiter,5019,487,5506
15980,Worthy,Stit,wstit46@dion.ne.jp,Human Resources Manager,7717,438,8155
15634,Bella,Plumbridge,bplumbridge47@dailymail.co.uk,Editor,8803,603,9406
15039,Ogdan,Maudson,omaudson48@ca.gov,Legal Assistant,8539,1207,9746
15650,Anett,Pickett,apickett4a@kickstarter.com,Associate Professor,1431,1281,2712
15745,Filberto,Zuanazzi,fzuanazzi4b@ameblo.jp,Assistant Media Planner,7851,1960,9811
15990,Evelyn,Pic,epic4c@wsj.com,Legal Assistant,8272,873,9145
15258,Garv,Leadbitter,gleadbitter4d@tinypic.com,VP Sales,4836,1163,5999
15549,Shane,Baterip,sbaterip4e@wordpress.com,Research Nurse,2562,1374,3936
15971,Stacee,Assiratti,sassiratti4f@blinklist.com,Senior Cost Accountant,8829,1768,10597
15282,Rex,Gilchriest,rgilchriest4g@lulu.com,Cost Accountant,7875,1909,9784
15054,Ingra,Jonk,ijonk4h@hibu.com,Clinical Specialist,8027,1896,9923
15494,Efren,Klimowicz,eklimowicz4i@cnn.com,Food Chemist,6625,916,7541
15523,Hadley,Apedaile,hapedaile4j@patch.com,Information Systems Manager,5316,939,6255
15825,Damien,Mulvaney,dmulvaney4k@google.ca,Accounting Assistant IV,4990,1523,6513
15901,Chiquia,Girardeau,cgirardeau4l@gov.uk,GIS Technical Architect,6094,1814,7908
15857,Maryanna,Tavener,mtavener4m@whitehouse.gov,Database Administrator I,7037,1726,8763
15278,Abrahan,McKenny,amckenny4n@trellian.com,Research Assistant IV,2553,256,2809
15438,Andreas,Antonomoli,aantonomoli4o@shutterfly.com,Software Consultant,8290,1104,9394
15003,Alejoa,Dyzart,adyzart4p@java.com,General Manager,8521,1586,10107
15049,Daffi,McDougall,dmcdougall4q@soundcloud.com,Geologist II,3444,1493,4937
15826,Sherwood,McCloch,smccloch4r@simplemachines.org,Quality Engineer,5351,1733,7084
15133,Brynna,Baudacci,bbaudacci4s@comcast.net,Recruiter,5721,1575,7296
15290,Annabel,Mingaye,amingaye4u@yandex.ru,Software Engineer IV,6172,300,6472
15440,Sylvan,Dudeney,sdudeney4v@samsung.com,Media Manager II,7398,1436,8834
15703,Ollie,Diano,odiano4w@census.gov,Internal Auditor,1165,1370,2535
15296,Levy,Lawles,llawles4x@tripod.com,Statistician III,9895,1903,11798
15199,Annissa,Pottell,apottell4y@desdev.cn,Geologist IV,1629,388,2017
15530,Marcus,Beecroft,mbeecroft50@baidu.com,Data Coordiator,8269,627,8896
15293,Veradis,Conlon,vconlon52@nationalgeographic.com,Account Executive,6476,1195,7671
15245,Gerik,Brampton,gbrampton53@ebay.com,Software Test Engineer II,3515,1616,5131
15288,Joelly,Goane,jgoane54@webmd.com,Statistician I,7540,752,8292
15718,Mirna,Di Maggio,mdimaggio55@ftc.gov,Graphic Designer,2007,1996,4003
15083,Elwyn,Moughtin,emoughtin56@arstechnica.com,Administrative Officer,7663,1092,8755
15469,Kerwin,Monck,kmonck57@i2i.jp,VP Product Management,7680,1485,9165
15040,Antonina,Niset,aniset58@marriott.com,Legal Assistant,6130,945,7075
15823,Antonino,Goodricke,agoodricke59@cpanel.net,Financial Analyst,5983,802,6785
15022,Christine,Mould,cmould5a@about.com,Budget/Accounting Analyst I,6527,1741,8268
15742,Gunter,Lappine,glappine5b@tinypic.com,Nurse,1153,627,1780
15678,Immanuel,Liddiatt,iliddiatt5c@bandcamp.com,Chief Design Engineer,2371,1089,3460
15820,Cloris,Brecken,cbrecken5d@economist.com,Junior Executive,4397,1358,5755
15596,Bertine,Checcuzzi,bcheccuzzi5f@ft.com,Help Desk Technician,1450,1668,3118
15462,Elnar,O'Growgane,eogrowgane5g@npr.org,Associate Professor,8154,902,9056
15046,Adelina,Hansen,ahansen5h@wsj.com,Staff Accountant III,6031,934,6965
15896,Siana,Elsop,selsop5i@php.net,Professor,6934,267,7201
15036,Chrissy,Silbersak,csilbersak5j@mediafire.com,Senior Quality Engineer,6342,1128,7470
15008,Hastings,Surgood,hsurgood5k@who.int,Engineer III,9315,1571,10886
15544,Sherlocke,Tagg,stagg5l@senate.gov,Food Chemist,3763,1717,5480
15465,Lazarus,Aishford,laishford5m@indiegogo.com,Desktop Support Technician,9404,1379,10783
15511,Lauree,Meneghi,lmeneghi5n@wikispaces.com,Senior Developer,8029,1457,9486
15633,Leeland,Alanbrooke,lalanbrooke5o@cdc.gov,Analyst Programmer,9547,1985,11532
15014,Jacquelynn,Desbrow,jdesbrow5p@etsy.com,Teacher,6419,1168,7587
15954,Hermann,Cornew,hcornew5r@storify.com,Analyst Programmer,1919,656,2575
15160,Allsun,Iannazzi,aiannazzi5u@walmart.com,Junior Executive,8864,234,9098
15998,Fayette,Halpen,fhalpen5v@desdev.cn,Product Engineer,9308,1142,10450
15704,Leigh,Shieldon,lshieldon5w@cdc.gov,Human Resources Assistant III,8079,1936,10015
15882,Cal,Hanscome,chanscome5x@sourceforge.net,Legal Assistant,7894,1703,9597
15232,Klarrisa,Cardis,kcardis5y@oracle.com,Account Executive,5740,1909,7649
15349,Meryl,Marielle,mmarielle5z@hc360.com,Recruiting Manager,7824,403,8227
15756,Kiele,Wiper,kwiper60@csmonitor.com,Tax Accountant,4938,887,5825
15819,Janina,Byng,jbyng61@webmd.com,Recruiter,4761,1068,5829
15723,Garry,Ville,gville62@salon.com,Account Executive,6071,317,6388
15483,Xymenes,Espinola,xespinola64@flavors.me,Civil Engineer,5700,213,5913
15676,Bourke,McCowan,bmccowan65@house.gov,Senior Developer,7201,978,8179
15471,Jabez,Kiehne,jkiehne66@blogtalkradio.com,Accounting Assistant I,10000,1716,11716
15015,Correy,Goare,cgoare67@yellowpages.com,Financial Advisor,4587,712,5299
15975,Carson,Tinsley,ctinsley68@etsy.com,Operator,3933,460,4393
15522,Noni,Benjefield,nbenjefield69@pcworld.com,Editor,2738,426,3164
15545,Gweneth,Kidd,gkidd6a@un.org,VP Sales,6193,459,6652
15118,Tierney,Kitchinham,tkitchinham6b@storify.com,Automation Specialist III,6748,910,7658
15368,Averil,Mawson,amawson6c@nydailynews.com,Senior Quality Engineer,2875,222,3097
15688,Milena,Shea,mshea6d@hud.gov,Senior Sales Associate,6014,1227,7241
15818,Finley,Alwin,falwin6g@vinaora.com,Accountant III,8394,373,8767
15077,Cicely,Toothill,ctoothill6h@ftc.gov,Web Designer II,7698,1995,9693
15277,Massimo,Scrange,mscrange6i@bizjournals.com,Payment Adjustment Coordinator,4766,1928,6694
15684,Bertha,Cromar,bcromar6k@hc360.com,Programmer II,3225,1081,4306
15409,Janna,Anten,janten6l@about.me,Speech Pathologist,2570,509,3079
15789,Eduino,Dilkes,edilkes6m@delicious.com,Teacher,7924,717,8641
15393,Regina,Kitchinham,rkitchinham6n@engadget.com,Electrical Engineer,8996,257,9253
15895,Dorree,Kiezler,dkiezler6p@nyu.edu,Cost Accountant,5937,876,6813
15418,Fletch,Doree,fdoree6q@linkedin.com,Senior Developer,6037,601,6638
15147,Johannes,Nathon,jnathon6r@slideshare.net,Environmental Specialist,4106,814,4920
15222,Quinlan,Martignoni,qmartignoni6s@quantcast.com,Automation Specialist III,4087,445,4532
15581,Dorena,Glendzer,dglendzer6t@opera.com,Automation Specialist IV,2017,300,2317
15372,Janek,Brokenshaw,jbrokenshaw6u@ox.ac.uk,Statistician I,9369,1484,10853
15136,Thekla,Dullard,tdullard6v@webmd.com,Senior Quality Engineer,9682,555,10237
15782,Ammamaria,Laurentin,alaurentin6w@i2i.jp,Director of Sales,9037,982,10019
15454,Daren,Rylance,drylance6y@histats.com,Sales Associate,7680,704,8384
15191,Willis,Cobbe,wcobbe6z@huffingtonpost.com,Administrative Officer,6790,1532,8322
15615,Farlee,Grayer,fgrayer70@technorati.com,Financial Analyst,8866,1115,9981
15306,Kennedy,Benbough,kbenbough71@berkeley.edu,Actuary,1205,322,1527
15942,Callean,Pleuman,cpleuman72@apache.org,VP Marketing,4068,1697,5765
15656,Mildrid,Kellert,mkellert74@businesswire.com,Actuary,8866,413,9279
15229,Bernie,Battams,bbattams75@patch.com,Editor,2520,1130,3650
15001,Kristopher,Rooms,krooms76@dyndns.org,Mechanical Systems Engineer,1627,506,2133
15620,Asia,Moth,amoth77@devhub.com,Project Manager,3127,1705,4832
15303,Birgitta,Skeath,bskeath79@feedburner.com,Human Resources Manager,6637,921,7558
15312,Allard,Godbolt,agodbolt7b@stumbleupon.com,Graphic Designer,4812,760,5572
15997,Gene,Scathard,gscathard7c@instagram.com,Senior Editor,1687,493,2180
15319,Ward,Baudesson,wbaudesson7d@businesswire.com,Food Chemist,5714,313,6027
15422,Anita,Raith,araith7e@theguardian.com,Marketing Assistant,5013,530,5543
15065,Nollie,Howe,nhowe7f@nymag.com,Sales Representative,2396,1664,4060
15712,Boyd,Taynton,btaynton7g@odnoklassniki.ru,Director of Sales,2937,764,3701
15806,Jobye,Kitching,jkitching7i@bloomberg.com,Senior Sales Associate,4376,1888,6264
15345,Bibi,Rheaume,brheaume7j@wix.com,Librarian,5556,1806,7362
15778,Isaac,Le Frank,ilefrank7k@123-reg.co.uk,Tax Accountant,5988,1606,7594
15937,Elmira,Shewery,eshewery7l@uiuc.edu,Junior Executive,1135,1588,2723
15035,Clemence,Totterdell,ctotterdell7m@harvard.edu,Sales Representative,9432,623,10055
15673,Worth,Courteney,wcourteney7n@drupal.org,Web Designer II,7738,1056,8794
15844,Maje,Dudbridge,mdudbridge7p@4shared.com,Office Assistant III,7031,1850,8881
15774,Doloritas,Gullick,dgullick7q@theguardian.com,Automation Specialist I,3962,409,4371
15151,Shandie,Hawksworth,shawksworth7r@sfgate.com,Safety Technician II,2983,855,3838
15453,Waylon,Dearl,wdearl7s@com.com,Software Engineer I,5369,1315,6684
15569,Bride,Pydcock,bpydcock7t@ucoz.com,Executive Secretary,3155,826,3981
15728,Gal,Cardinale,gcardinale7u@discuz.net,Data Coordiator,4113,757,4870
15792,Mohandis,Whotton,mwhotton7v@hostgator.com,Clinical Specialist,4487,737,5224
15964,Nikki,Jakubowicz,njakubowicz7w@amazon.co.uk,Administrative Officer,7963,327,8290
15706,Korney,Paylie,kpaylie7x@msu.edu,Legal Assistant,3960,1812,5772
15326,Tybi,Milby,tmilby7y@jigsy.com,Speech Pathologist,8665,1195,9860
15929,Maximilianus,Sebire,msebire7z@mediafire.com,Assistant Professor,2676,522,3198
15156,Ceciley,Braben,cbraben80@princeton.edu,Paralegal,3320,774,4094
15445,Tracey,McKelvey,tmckelvey81@auda.org.au,Web Designer IV,4097,964,5061
15510,Nickey,Hardware,nhardware83@tiny.cc,Social Worker,1391,1162,2553
15166,Donnie,Prozescky,dprozescky84@vistaprint.com,Accounting Assistant I,6892,331,7223
15855,Broddy,Yeabsley,byeabsley85@technorati.com,VP Marketing,1394,1441,2835
15068,Liana,Bramont,lbramont86@narod.ru,Geologist II,3552,866,4418
15484,Heindrick,Blakesley,hblakesley87@ning.com,Analog Circuit Design manager,4370,1325,5695
15788,Ewart,Boyce,eboyce88@guardian.co.uk,Accounting Assistant II,9240,714,9954
15067,Alison,Jime,ajime8a@bigcartel.com,Librarian,7773,1251,9024
15559,Seymour,Rivallant,srivallant8b@netvibes.com,Editor,8642,1754,10396
15076,Fitz,Keuneke,fkeuneke8c@imgur.com,Operator,9356,1388,10744
15478,Lorelei,Zuenelli,lzuenelli8e@forbes.com,Registered Nurse,1732,1519,3251
15600,Saunders,McCloid,smccloid8f@ucsd.edu,Operator,7069,359,7428
15231,Kyla,Alpin,kalpin8g@webs.com,Assistant Media Planner,7256,605,7861
15027,Norean,Badby,nbadby8h@gmpg.org,Graphic Designer,5733,655,6388
15196,Lee,Keat,lkeat8j@t.co,Operator,1551,956,2507
15043,Zsa zsa,Faunt,zfaunt8k@google.ru,VP Sales,6863,1212,8075
15434,Orbadiah,Bosward,obosward8l@alexa.com,Physical Therapy Assistant,3715,1626,5341
15075,Ross,Corden,rcorden8n@toplist.cz,Geological Engineer,4666,988,5654
15775,Sanson,Lutwidge,slutwidge8o@shinystat.com,Account Coordinator,1589,1537,3126
15295,Stanislas,Brettoner,sbrettoner8p@dagondesign.com,Help Desk Technician,9077,1521,10598
15504,Tatum,Chesswas,tchesswas8r@goo.ne.jp,Accounting Assistant IV,4604,1439,6043
15709,Emerson,MacDowal,emacdowal8s@spotify.com,Occupational Therapist,2985,209,3194
15493,Mirella,Norheny,mnorheny8u@mozilla.org,Associate Professor,1615,373,1988
15601,Glendon,Gatus,ggatus8v@boston.com,Automation Specialist I,8153,939,9092
15370,Ulla,Pavolini,upavolini8w@quantcast.com,Health Coach I,2422,1414,3836
15407,Clevie,Wathall,cwathall8y@indiatimes.com,Geological Engineer,8906,468,9374
15100,Alexander,Dussy,adussy8z@intel.com,Help Desk Operator,2599,1698,4297
15356,Leyla,Pavie,lpavie90@angelfire.com,Librarian,8933,1612,10545
15348,Audrey,Wingate,awingate93@pagesperso-orange.fr,Financial Advisor,3853,1787,5640
15237,Corbett,Clarage,cclarage94@about.me,Nuclear Power Engineer,2620,1333,3953
15113,Jamal,Toombs,jtoombs95@chicagotribune.com,Financial Advisor,4986,686,5672
15946,Brant,Fury,bfury96@free.fr,Graphic Designer,2202,1140,3342
15672,Juliane,Barniss,jbarniss97@google.nl,Analyst Programmer,7657,1050,8707
15006,Brett,Stooders,bstooders98@imageshack.us,Administrative Officer,3126,563,3689
15627,Raynell,Puckham,rpuckham99@webmd.com,Software Consultant,2070,1497,3567
15832,Tamera,Mepsted,tmepsted9b@google.it,Account Representative III,2322,373,2695
15121,Annabal,Coverdill,acoverdill9c@wiley.com,Human Resources Assistant II,6999,661,7660
15649,Kyrstin,Merritt,kmerritt9e@bing.com,Senior Quality Engineer,9452,461,9913
15020,Roxanna,Kraft,rkraft9f@wiley.com,Environmental Specialist,7499,236,7735
15930,Lorne,Ert,lert9h@issuu.com,Teacher,2000,1197,3197
15988,Alexandro,Aitchinson,aaitchinson9i@moonfruit.com,Assistant Manager,1569,1316,2885
15693,Guthrey,Toppin,gtoppin9j@gravatar.com,Data Coordiator,2639,1579,4218
15973,Jess,Keningley,jkeningley9k@macromedia.com,Statistician III,6114,1550,7664
15831,Yasmin,Benedict,ybenedict9l@princeton.edu,Data Coordiator,4239,1767,6006
15211,Reena,Kreber,rkreber9m@friendfeed.com,Biostatistician I,8482,748,9230
15793,Charlotta,Jumonet,cjumonet9n@fotki.com,Safety Technician I,3987,891,4878
15846,Berkeley,Merrick,bmerrick9o@mac.com,Senior Editor,8631,660,9291
15062,Errol,Bachshell,ebachshell9p@discovery.com,Account Representative II,3377,414,3791
15140,Gerhardt,Shambroke,gshambroke9q@amazon.com,Web Designer III,2419,402,2821
15773,Gilles,Garthshore,ggarthshore9u@example.com,Senior Quality Engineer,8057,721,8778
15444,Othello,Tompkins,otompkins9v@ft.com,Research Assistant III,9683,1806,11489
15962,Talbot,Lipson,tlipson9w@indiegogo.com,Community Outreach Specialist,7889,1461,9350
15744,Rock,Oxlade,roxlade9x@wordpress.org,Financial Analyst,2000,1520,3520
15377,Kaitlynn,Corneljes,kcorneljes9z@dmoz.org,Project Manager,3822,1854,5676
15717,Mar,Allden,malldena0@typepad.com,Physical Therapy Assistant,4710,625,5335
15636,Wylie,Birtwisle,wbirtwislea4@cnbc.com,Structural Analysis Engineer,8198,982,9180
15965,Lacy,Aronovich,laronovicha6@bandcamp.com,Registered Nurse,2444,709,3153
15767,Cristin,Digg,cdigga7@wikispaces.com,Account Coordinator,7882,908,8790
15460,Frank,O'Fallone,fofallonea8@seesaa.net,Desktop Support Technician,7710,220,7930
15679,Christie,Divell,cdivellaa@sohu.com,Business Systems Development Analyst,2241,212,2453
15424,Odessa,Caton,ocatonad@ehow.com,Tax Accountant,5315,1244,6559
15475,Heddi,Ife,hifeae@virginia.edu,General Manager,6762,1337,8099
15850,Lewiss,Rodbourne,lrodbourneag@google.nl,Marketing Manager,1585,1501,3086
15582,Tabb,Ord,tordah@stanford.edu,Financial Advisor,8915,1346,10261
15193,Wat,Banaszkiewicz,wbanaszkiewiczai@harvard.edu,Administrative Officer,6386,686,7072
15912,Hedwig,Clamo,hclamoal@bloglines.com,Research Nurse,1189,1922,3111
15959,Zechariah,Kayley,zkayleyan@google.com,Compensation Analyst,8274,642,8916
15390,Manfred,McMillan,mmcmillanao@biglobe.ne.jp,Community Outreach Specialist,3673,1481,5154
15280,Cleveland,Blazy,cblazyar@friendfeed.com,Account Representative I,1135,1288,2423
15382,Chadwick,Flipek,cflipekas@webeden.co.uk,Librarian,5692,1061,6753
15874,Sal,Wrench,swrenchaw@qq.com,Quality Engineer,4013,299,4312
15496,Lombard,Arkwright,larkwrightay@biglobe.ne.jp,Administrative Officer,6357,1626,7983
15864,Daren,Boydell,dboydellb1@multiply.com,Nurse,7196,900,8096
15766,Korney,Talby,ktalbyb2@hud.gov,Editor,4675,1500,6175
15254,Annmaria,Polfer,apolferb3@ovh.net,Operator,8897,378,9275
15448,Karisa,Floyd,kfloydb5@paypal.com,Actuary,4772,1064,5836
15763,George,Gayle,ggayleb6@jugem.jp,Assistant Professor,3511,1015,4526
15247,Van,Mallindine,vmallindineb9@prlog.org,Biostatistician IV,8766,989,9755
15066,Ruth,Gurdon,rgurdonbb@google.ca,Research Assistant IV,6896,1645,8541
15489,Ruby,Rogister,rrogisterbc@ucoz.com,Developer IV,8551,375,8926
15403,Torie,Shillitoe,tshillitoebd@youtu.be,Internal Auditor,4471,1222,5693
15589,Cammi,Sugars,csugarsbe@ustream.tv,Nurse,1253,1098,2351
15346,Godfrey,O'Caherny,gocahernybf@wordpress.com,VP Accounting,7532,1565,9097
15208,Marnie,Govinlock,mgovinlockbh@ftc.gov,Financial Analyst,7353,1064,8417
15949,Saudra,Southwood,ssouthwoodbi@nih.gov,Statistician IV,6467,383,6850
15238,Chas,Meharry,cmeharrybj@washington.edu,Associate Professor,5031,1057,6088
15339,Dorothea,Anthonies,danthoniesbk@behance.net,Marketing Manager,7316,954,8270
15963,Emilia,Woofinden,ewoofindenbm@biglobe.ne.jp,Software Test Engineer III,1488,1082,2570
15271,Sukey,Jacox,sjacoxbn@netlog.com,Senior Sales Associate,4254,1138,5392
15606,Jeremy,Loffhead,jloffheadbo@webmd.com,Speech Pathologist,7146,463,7609
15209,Glenn,Torvey,gtorveybp@github.com,Assistant Professor,6166,1456,7622
15384,Andris,Connichie,aconnichiebq@psu.edu,Director of Sales,5040,643,5683
15142,Nappie,Dix,ndixbr@homestead.com,Senior Cost Accountant,5049,872,5921
15920,Amalee,Tuiller,atuillerbu@printfriendly.com,Data Coordiator,3743,1832,5575
15416,Cacilia,Bedburrow,cbedburrowbv@wix.com,Office Assistant I,8984,974,9958
15243,Kakalina,Edmons,kedmonsbw@wikimedia.org,Analyst Programmer,2690,1428,4118
15922,Ryley,Cogin,rcoginbz@bluehost.com,Payment Adjustment Coordinator,1971,1978,3949
15574,Marni,Yurkin,myurkinc0@comcast.net,Software Engineer IV,5515,1735,7250
15323,Mahmud,Atyea,matyeac3@bbb.org,Clinical Specialist,3729,542,4271
15576,Any,Kemer,akemerc4@engadget.com,Account Representative III,2789,1301,4090
15304,Karlan,Camois,kcamoisc5@time.com,Web Developer III,9276,1836,11112
15935,Micki,Scobie,mscobiec6@oracle.com,VP Quality Control,5971,429,6400
15614,Allis,Adamovicz,aadamoviczc8@sakura.ne.jp,Human Resources Assistant III,5829,1659,7488
15777,Damiano,Ebourne,debournec9@utexas.edu,Geologist III,5121,1844,6965
15093,Arabel,Cormack,acormackca@about.com,Research Associate,4991,226,5217
15412,Berkie,Grandison,bgrandisoncc@google.ru,Clinical Specialist,6170,854,7024
15480,Fred,Donke,fdonkecd@devhub.com,Accountant III,8251,350,8601
15101,Ingrim,Mechell,imechellce@nymag.com,Payment Adjustment Coordinator,7077,332,7409
15724,Moira,Wooffitt,mwooffittcg@dagondesign.com,Electrical Engineer,6783,1546,8329
15221,Avigdor,Greguol,agreguolch@yellowbook.com,GIS Technical Architect,5501,902,6403
15557,Grayce,Anfosso,ganfossoci@cdc.gov,Physical Therapy Assistant,4119,1115,5234
15477,Daphne,Bondar,dbondarcj@cyberchimps.com,Programmer IV,6777,1291,8068
15616,Lynn,Schnieder,lschniedercm@mit.edu,Mechanical Systems Engineer,1192,568,1760
15287,Constantia,Slowan,cslowancn@meetup.com,Chemical Engineer,7706,621,8327
15609,Dugald,Hunnawill,dhunnawillcr@answers.com,Technical Writer,2301,1734,4035
15079,Ellerey,Heinrich,eheinrichct@bizjournals.com,Systems Administrator I,9906,1201,11107
15518,Townie,Grellis,tgrelliscu@aboutads.info,Registered Nurse,7340,397,7737
15451,Ewen,Farthing,efarthingcv@hibu.com,Structural Analysis Engineer,5711,1943,7654
15720,Clarinda,Laurance,claurancecw@friendfeed.com,Analyst Programmer,7632,1842,9474
15399,Vonnie,Baert,vbaertcy@redcross.org,Clinical Specialist,5137,725,5862
15524,Blanche,Rubinsztein,brubinszteincz@vistaprint.com,Occupational Therapist,6059,1934,7993
15663,Gertrude,Pattie,gpattied1@trellian.com,Software Test Engineer IV,1843,1631,3474
15897,Aliza,Cruikshanks,acruikshanksd2@chronoengine.com,Chemical Engineer,7235,1649,8884
15943,Danette,Grogono,dgrogonod3@fotki.com,Senior Quality Engineer,9902,1317,11219
15307,Mildred,Aysh,mayshd4@vk.com,Electrical Engineer,5150,378,5528
15367,Wheeler,Safell,wsafelld6@ted.com,Senior Developer,4714,1061,5775
15861,Hayden,Absalom,habsalomd7@nih.gov,Developer II,3741,635,4376
15638,Nikolia,Sill,nsilld8@intel.com,Chief Design Engineer,5951,1038,6989
15840,Henrieta,Brearley,hbrearleyda@hc360.com,Media Manager IV,7856,1684,9540
15135,Yevette,Volette,yvolettedb@reddit.com,Software Test Engineer II,3276,519,3795
15659,Margy,Asken,maskende@huffingtonpost.com,Electrical Engineer,6501,489,6990
15172,Camilla,Muat,cmuatdf@accuweather.com,Legal Assistant,6291,907,7198
15848,Tito,Stredder,tstredderdg@zimbio.com,VP Accounting,7052,687,7739
15050,Annmaria,Robers,arobersdi@domainmarket.com,Staff Accountant I,5461,1135,6596
15977,Sonnie,Paddon,spaddondk@123-reg.co.uk,Occupational Therapist,9965,989,10954
15426,Idalia,Dorrington,idorringtondl@whitehouse.gov,Recruiter,3995,1355,5350
15695,Burnard,Duddan,bduddandq@addtoany.com,Graphic Designer,6546,261,6807
15117,Dario,Dickerson,ddickersonds@chicagotribune.com,Senior Cost Accountant,3414,756,4170
15341,Priscella,Blest,pblestdw@china.com.cn,Biostatistician III,7761,1126,8887
15995,Abey,Lennon,alennondz@symantec.com,Senior Financial Analyst,3888,1245,5133
15838,Meghann,Esposi,mesposie0@a8.net,Web Developer III,2738,1881,4619
15637,Amandi,Hing,ahinge1@thetimes.co.uk,Account Coordinator,4246,667,4913
15843,Celinda,Bromidge,cbromidgee2@hp.com,Tax Accountant,4217,1164,5381
15253,Lemuel,Meek,lmeeke4@4shared.com,Tax Accountant,4000,1209,5209
15259,Gwennie,Raulston,graulstone5@mashable.com,Clinical Specialist,8486,763,9249
15318,Pippy,Le Gassick,plegassicke7@digg.com,Safety Technician II,9239,1397,10636
15023,Torrey,Dunseath,tdunseathe8@xinhuanet.com,Graphic Designer,1309,1537,2846
15292,Mufi,Tees,mteeseb@live.com,Legal Assistant,4485,491,4976
15558,Devon,Scrimshaw,dscrimshawed@furl.net,Budget/Accounting Analyst I,8848,1708,10556
15735,Ferdinande,Laurie,flaurieeg@usnews.com,Sales Representative,6192,1610,7802
15683,Fara,Lidden,fliddeneh@digg.com,Environmental Tech,7329,692,8021
15801,Gabbie,Tesh,gteshem@hhs.gov,VP Quality Control,2995,1875,4870
15817,Izaak,Plan,iplaner@bloglines.com,Recruiting Manager,2727,1401,4128
15933,Trey,Ivanchin,tivanchines@lycos.com,Junior Executive,1804,260,2064
15803,Renell,Meo,rmeoeu@si.edu,Occupational Therapist,1979,1135,3114
15219,Casey,Gribbell,cgribbellev@geocities.jp,Pharmacist,4254,428,4682
15880,Devin,Qualtro,dqualtroew@microsoft.com,Mechanical Systems Engineer,2976,415,3391
15499,Mimi,Branni,mbranniex@bloomberg.com,Teacher,1788,1035,2823
15528,Dominik,Aldgate,daldgateey@360.cn,Research Nurse,5651,1966,7617
15691,Edward,Natalie,enatalieez@xrea.com,VP Sales,8268,1662,9930
15269,Farley,McLurg,fmclurgf0@1und1.de,Software Consultant,1629,1740,3369
15300,Wilden,Demicoli,wdemicolif1@theguardian.com,Help Desk Technician,7458,1206,8664
15260,Malory,Toffoletto,mtoffolettof3@instagram.com,Software Consultant,2033,223,2256
15395,Geno,Harmond,gharmondf5@mapy.cz,Electrical Engineer,5811,1556,7367
15562,Edward,Jeannon,ejeannonf7@irs.gov,Technical Writer,8240,1981,10221
15500,Alta,Harsnipe,aharsnipef8@canalblog.com,Safety Technician II,3651,1522,5173
15335,Nana,Willshire,nwillshiref9@gizmodo.com,VP Marketing,4508,1651,6159
15784,Margarita,Banane,mbananefb@nih.gov,Operator,4676,1491,6167
15308,Radcliffe,Wolfinger,rwolfingerfc@vk.com,Quality Engineer,3289,391,3680
15519,Andi,Lipscombe,alipscombefd@mac.com,Sales Representative,5912,901,6813
15790,Brenden,Beckley,bbeckleyff@booking.com,Office Assistant III,7430,1105,8535
16000,Emelina,Leipelt,eleipeltfg@over-blog.com,Marketing Manager,8376,863,9239
15192,Bartholomeo,Mabe,bmabefh@mac.com,Office Assistant II,5681,420,6101
15425,Martelle,Mason,mmasonfj@fastcompany.com,Safety Technician III,6717,1527,8244
15129,Aleen,Scotney,ascotneyfk@prweb.com,Software Consultant,8567,1615,10182
15013,Brockie,Earnshaw,bearnshawfo@nih.gov,Project Manager,1332,1509,2841
15182,Ardella,Hynard,ahynardfp@paginegialle.it,Environmental Specialist,8550,1916,10466
15967,Loleta,Scarce,lscarcefq@sbwire.com,Account Executive,2436,1880,4316
15925,Huntington,Wennington,hwenningtonft@upenn.edu,Biostatistician I,6800,971,7771
15761,Danika,Diggar,ddiggarfu@upenn.edu,Technical Writer,4996,929,5925
15951,Franny,McCallum,fmccallumfv@seattletimes.com,Senior Financial Analyst,3167,242,3409
15358,Harp,Woolfenden,hwoolfendenfw@ustream.tv,Office Assistant III,3971,1219,5190
15150,Arley,Bone,abonefz@irs.gov,VP Sales,5362,1717,7079
15702,Arthur,Forsard,aforsardg0@mayoclinic.com,Staff Accountant IV,8646,1046,9692
15458,Rhodia,Samworth,rsamworthg2@craigslist.org,Systems Administrator II,4614,1674,6288
15725,Aaren,Gibbonson,agibbonsong5@fotki.com,Dental Hygienist,3012,1743,4755
15639,Dacia,Stuck,dstuckg6@ustream.tv,Geological Engineer,5227,1558,6785
15045,Creighton,Biaggelli,cbiaggelliga@t.co,Professor,6895,1206,8101
15730,Ann-marie,Shakespear,ashakespeargb@edublogs.org,Computer Systems Analyst IV,1020,966,1986
15981,Bary,Bergeon,bbergeongc@addthis.com,Electrical Engineer,5686,1584,7270
15651,Cariotta,Florey,cfloreygd@nationalgeographic.com,Recruiter,8054,770,8824
15225,Sanford,Icom,sicomgg@phoca.cz,Systems Administrator IV,1331,1258,2589
15610,Morganica,McAirt,mmcairtgh@oracle.com,Business Systems Development Analyst,9969,372,10341
15941,Matthiew,Moye,mmoyegi@weebly.com,Accounting Assistant IV,3335,853,4188
15999,Jamie,Brookfield,jbrookfieldgn@comsenz.com,Safety Technician IV,1701,1797,3498
15362,Giffie,De Hailes,gdehailesgo@unicef.org,Environmental Tech,3330,672,4002
15645,Jobie,Greenly,jgreenlygs@craigslist.org,Programmer Analyst I,7018,1619,8637
15970,Callida,Rulten,crultengt@yellowbook.com,Structural Analysis Engineer,9512,1412,10924
15060,Kiley,Bulloch,kbullochgv@mail.ru,Staff Accountant III,9973,422,10395
15028,Robby,Yeatman,ryeatmangw@networksolutions.com,Quality Engineer,5933,1366,7299
15364,Nata,Goodridge,ngoodridgegx@a8.net,Quality Engineer,2446,1284,3730
15847,Tyne,Brocking,tbrockinggy@samsung.com,Project Manager,1956,1650,3606
15236,Sholom,Ledington,sledingtonh0@alexa.com,Editor,7540,965,8505
15324,Daune,Kunat,dkunath2@liveinternet.ru,Desktop Support Technician,3677,1986,5663
15501,Sandro,Gaffney,sgaffneyh3@yolasite.com,Operator,3029,1330,4359
15048,Binnie,Scoullar,bscoullarh7@livejournal.com,Sales Representative,4253,891,5144
15593,Jackson,Boner,jbonerha@fc2.com,Senior Sales Associate,4866,240,5106
15157,Micheil,Assiter,massiterhb@vk.com,Design Engineer,5299,1300,6599
15729,Mona,Gorelli,mgorellihf@rambler.ru,Operator,1232,1956,3188
15047,Lammond,Adami,ladamihg@businessinsider.com,Computer Systems Analyst IV,4581,486,5067
15184,Sinclare,Pether,spetherhh@gizmodo.com,Sales Representative,8927,1694,10621
15834,Myrta,Cleen,mcleenhi@etsy.com,Business Systems Development Analyst,4197,341,4538
15276,Vincents,Castaneda,vcastanedahj@qq.com,Financial Advisor,4839,1860,6699
15747,Sadye,Audenis,saudenishk@sourceforge.net,Paralegal,6697,1620,8317
15653,Tawsha,Nannini,tnanninihl@dmoz.org,Research Associate,4767,1754,6521
15573,Delbert,Speck,dspeckhm@sogou.com,Computer Systems Analyst II,1115,989,2104
15042,Pamela,Kemwal,pkemwalhn@dropbox.com,Electrical Engineer,5563,1441,7004
15572,Crista,Smale,csmaleho@wisc.edu,Senior Editor,4481,255,4736
15680,Tremaine,Chatteris,tchatterishp@comcast.net,Dental Hygienist,5263,1042,6305
15002,Wash,Tripony,wtriponyhr@comcast.net,Operator,7526,1688,9214
15621,Erika,Sybbe,esybbeht@vinaora.com,Tax Accountant,8182,1713,9895
15201,Guillemette,Gasticke,ggastickehv@yahoo.co.jp,Administrative Assistant III,4617,935,5552
15235,Harriett,Macrae,hmacraehy@infoseek.co.jp,Sales Representative,4302,1511,5813
15955,Iggy,Newarte,inewartei7@free.fr,Director of Sales,7235,980,8215
15505,Goldy,Broadhead,gbroadheadia@seattletimes.com,Legal Assistant,3730,251,3981
15771,Randolf,Girvin,rgirvinib@google.com,Safety Technician III,5085,1703,6788
15401,Josiah,Hourihan,jhourihanic@chron.com,Civil Engineer,8807,1510,10317
15099,Ferris,O'Nions,fonionsid@harvard.edu,Safety Technician II,1025,1365,2390
15090,Perry,MacConneely,pmacconneelyie@goodreads.com,Human Resources Manager,8219,656,8875
15934,Dinny,Weekes,dweekesig@sohu.com,GIS Technical Architect,9847,499,10346
15214,Jeramey,Stobbes,jstobbesih@ucoz.ru,Software Consultant,2278,1532,3810
15629,Marcelle,Anthoin,manthoinii@noaa.gov,Project Manager,9430,1395,10825
15515,Arliene,Ogle,aogleik@intel.com,Dental Hygienist,7708,1166,8874
15088,Jacinta,Paeckmeyer,jpaeckmeyeril@omniture.com,Staff Scientist,8915,692,9607
15754,Gregg,Pestell,gpestellim@tripod.com,Senior Editor,6953,1856,8809
15437,Randene,Euston,reustonin@cam.ac.uk,Physical Therapy Assistant,7472,1962,9434
15459,Mil,Savoury,msavouryiq@studiopress.com,Quality Engineer,9955,1614,11569
15640,Griz,Olley,golleyir@eepurl.com,Sales Representative,2302,532,2834
15928,Glynis,Minshaw,gminshawis@oracle.com,Staff Scientist,9181,390,9571
15007,Cthrine,Van den Oord,cvandenoordit@abc.net.au,Human Resources Assistant I,1311,1528,2839
15890,Artie,Lowder,alowderix@tuttocitta.it,Systems Administrator II,2053,1420,3473
15539,Vi,McRannell,vmcrannellj0@chron.com,Recruiting Manager,1625,1261,2886
15488,Bianka,McCorrie,bmccorriej2@blogtalkradio.com,Mechanical Systems Engineer,4540,831,5371
15765,Bradan,Tabord,btabordj3@free.fr,Pharmacist,5189,1447,6636
15877,Mikael,Leavry,mleavryj4@thetimes.co.uk,Senior Editor,2150,1464,3614
15642,Lorraine,Izacenko,lizacenkoj5@businessweek.com,Internal Auditor,7489,1043,8532
15666,Karylin,Colcomb,kcolcombja@blog.com,Project Manager,1438,889,2327
15350,Lindy,MacAless,lmacalessjb@example.com,Senior Quality Engineer,2782,353,3135
15893,Terrye,Lawson,tlawsonjc@youtube.com,Web Developer III,3670,676,4346
15536,Franni,Cathenod,fcathenodje@illinois.edu,Senior Developer,4450,640,5090
15700,Had,Lohmeyer,hlohmeyerjg@stanford.edu,Account Coordinator,5250,1491,6741
15516,Darryl,Melross,dmelrossjh@dailymail.co.uk,Office Assistant II,7543,1868,9411
15355,Shepherd,Mayou,smayoujk@digg.com,Tax Accountant,9420,736,10156
15281,Walden,Cornelissen,wcornelissenjl@slideshare.net,Junior Executive,4822,1101,5923
15234,Rhoda,O'Rowane,rorowanejm@umn.edu,Human Resources Manager,3964,1494,5458
15979,Lenore,Dunseath,ldunseathjr@fotki.com,Teacher,6318,1234,7552
15716,Vilhelmina,Berthelmot,vberthelmotjs@amazonaws.com,Help Desk Operator,1041,1124,2165
15812,Filmore,Coxon,fcoxonju@globo.com,Graphic Designer,1870,896,2766
15198,Trixie,Burtwistle,tburtwistlek0@huffingtonpost.com,Computer Systems Analyst IV,1941,1626,3567
15958,Elton,Ashard,eashardk3@ftc.gov,Product Engineer,4805,1262,6067
15815,Blanche,Works,bworksk4@zimbio.com,Senior Developer,7718,323,8041
15622,Mair,Sawkin,msawkink8@si.edu,Account Executive,5780,1979,7759
15134,Tessie,Imlock,timlockk9@youtube.com,Help Desk Technician,7027,618,7645
15689,Francklin,Vasquez,fvasquezkb@discuz.net,Assistant Manager,4211,516,4727
15011,Arri,Birtley,abirtleykf@mozilla.org,Information Systems Manager,6218,1547,7765
15321,Ellary,Gleadle,egleadlekh@people.com.cn,Junior Executive,2492,844,3336
15116,Fidela,Gadman,fgadmanki@howstuffworks.com,Senior Developer,4416,1623,6039
15721,Bax,Dampney,bdampneykq@live.com,Tax Accountant,5404,484,5888
15694,Annis,Coathup,acoathupkr@loc.gov,Registered Nurse,9355,285,9640
15110,Isaak,Meert,imeertks@wiley.com,Budget/Accounting Analyst I,3448,560,4008
15070,Ludovico,Daniele,ldanielekt@acquirethisname.com,Marketing Assistant,4653,572,5225
15139,Robin,Cotterrill,rcotterrillkv@csmonitor.com,Payment Adjustment Coordinator,2933,1160,4093
15526,Lonnie,Pittle,lpittlekw@mapquest.com,Senior Cost Accountant,2771,672,3443
15910,Laina,Dabinett,ldabinettky@shareasale.com,Software Engineer II,9569,967,10536
15866,Lilas,Gilchrist,lgilchristkz@mayoclinic.com,Legal Assistant,3449,545,3994
15875,Rhiamon,Faraday,rfaradayl3@artisteer.com,Design Engineer,3370,1118,4488
15061,Allegra,Schulke,aschulkel4@list-manage.com,Compensation Analyst,5334,1209,6543
15248,Solly,Beckson,sbecksonl9@reuters.com,Pharmacist,3005,1645,4650
15752,Adham,Studdeard,astuddeardla@gnu.org,Director of Sales,8519,970,9489
15342,Tome,Minney,tminneyld@nytimes.com,Dental Hygienist,2949,329,3278
15262,Had,Pinsent,hpinsentle@aboutads.info,Database Administrator II,9054,841,9895
15604,Taddeusz,Manus,tmanuslj@eventbrite.com,Analog Circuit Design manager,1508,1943,3451
15811,Olenka,Aust,oaustlk@livejournal.com,Help Desk Operator,8023,1177,9200
15945,Aprilette,Chesher,achesherll@aboutads.info,Operator,8826,1504,10330
15535,Gram,Irlam,girlamlm@linkedin.com,Electrical Engineer,1518,1341,2859
15107,Emalia,Nan Carrow,enancarrowlp@istockphoto.com,Paralegal,5711,1955,7666
15328,Corrie,Loosely,clooselylq@mapy.cz,Design Engineer,7747,988,8735
15611,Neddie,Greenway,ngreenwaylv@wordpress.org,Associate Professor,8538,1527,10065
15376,Bobette,Furminger,bfurmingerlx@hibu.com,Environmental Tech,6493,1690,8183
15591,Moritz,Braker,mbrakerm0@t-online.de,Technical Writer,1177,859,2036
15873,Leanna,Eliesco,leliescom1@github.com,VP Marketing,6275,1587,7862
15906,Cristal,Levecque,clevecquem2@merriam-webster.com,Product Engineer,6857,329,7186
15423,Granger,Tuckwell,gtuckwellm4@economist.com,Desktop Support Technician,1335,1976,3311
15915,Elton,Penner,epennerm9@uiuc.edu,Pharmacist,7924,488,8412
15097,Tore,Krollman,tkrollmanmc@youku.com,Legal Assistant,5776,1567,7343
15337,Obed,Seale,osealemd@mtv.com,Marketing Assistant,8468,578,9046
15261,Jessica,Sawers,jsawersmg@devhub.com,Financial Advisor,5148,1497,6645
15797,Harriet,Rispine,hrispinemi@skype.com,Quality Control Specialist,2456,1797,4253
15411,Creigh,Jenken,cjenkenml@is.gd,Recruiting Manager,7967,1596,9563
15552,Charlena,Gask,cgaskmm@flavors.me,Biostatistician III,5195,1444,6639
15249,Benedikt,Padkin,bpadkinmn@dot.gov,Geological Engineer,1137,1583,2720
15217,Kaitlynn,Dubs,kdubsmp@yelp.com,Database Administrator III,8345,520,8865
15152,Andros,Gutridge,agutridgemt@moonfruit.com,Software Test Engineer I,3644,544,4188
15371,Butch,Siddle,bsiddlemu@domainmarket.com,VP Accounting,9131,1992,11123
15661,Gerhardine,Lambert-Ciorwyn,glambertciorwynmx@mediafire.com,Dental Hygienist,1454,934,2388
15899,Kalli,Ebbetts,kebbettsmz@sina.com.cn,Quality Control Specialist,4334,539,4873
15155,Ichabod,Suthren,isuthrenn1@forbes.com,Assistant Professor,8339,1350,9689
15957,Gerome,Fynn,gfynnn2@virginia.edu,Software Test Engineer IV,7317,949,8266
15329,Steven,Leeburne,sleeburnen4@altervista.org,Account Coordinator,9820,839,10659
15347,Barbe,Hynam,bhynamn6@oaic.gov.au,Engineer II,1582,1799,3381
15816,Marysa,Maes,mmaesn7@ca.gov,Project Manager,2306,254,2560
15439,Dayna,Kmieciak,dkmieciakn8@xing.com,Technical Writer,1574,575,2149
15623,Milli,Cuningham,mcuninghamn9@unc.edu,Librarian,6365,1686,8051
15578,Kellina,Arnatt,karnattna@home.pl,Pharmacist,8556,1188,9744
15674,Granville,Scanlin,gscanlinne@comsenz.com,Environmental Tech,4691,1774,6465
15541,Tarrah,Binner,tbinnernf@facebook.com,Human Resources Manager,4121,1020,5141
15291,Desmond,Endley,dendleynh@squarespace.com,Structural Analysis Engineer,9920,353,10273
15206,Ninetta,Twelvetrees,ntwelvetreesnk@ibm.com,Human Resources Assistant III,2215,281,2496
15669,Hugo,Attenburrow,hattenburrownn@dedecms.com,Analog Circuit Design manager,2492,1451,3943
15149,Gabie,Ossenna,gossennano@linkedin.com,GIS Technical Architect,8092,1146,9238
15532,Sherwood,Koomar,skoomarnp@1und1.de,Budget/Accounting Analyst I,8964,1518,10482
15894,Charlotte,Dunning,cdunningnq@aol.com,Occupational Therapist,4218,1788,6006
15452,Lauree,Dickie,ldickiens@pinterest.com,Financial Advisor,3952,1625,5577
15687,Esdras,Sadat,esadatnt@biglobe.ne.jp,Computer Systems Analyst III,7086,1732,8818
15073,Alf,Titterton,atittertonnw@lulu.com,Social Worker,7044,836,7880
15246,Gaspard,Caldwall,gcaldwallnx@nyu.edu,VP Marketing,1006,1440,2446
15212,Reena,Whitcomb,rwhitcombo2@weibo.com,Web Developer III,5252,1374,6626
15978,Rabbi,Moncey,rmonceyo8@usatoday.com,Assistant Manager,5315,1035,6350
15268,Silvia,Cluely,scluelyoc@51.la,Compensation Analyst,9228,1416,10644
15851,Caddric,Parmiter,cparmiterol@java.com,VP Marketing,9068,1012,10080
15654,Rivalee,Brumfitt,rbrumfittom@blogs.com,Structural Analysis Engineer,2653,1505,4158
15619,Carl,Spieck,cspieckon@studiopress.com,Account Representative III,5689,1886,7575
15553,Clayborn,Tunbridge,ctunbridgeop@mashable.com,Quality Control Specialist,3770,1773,5543
15188,Jewelle,Kunc,jkuncoq@skype.com,Automation Specialist III,7413,519,7932
15755,Corbin,Keoghane,ckeoghaneot@surveymonkey.com,Engineer I,8459,1943,10402
15466,Kaitlin,Yorkston,kyorkstonou@irs.gov,Teacher,8231,1354,9585
15005,Lavina,Saberton,lsabertonov@cpanel.net,Director of Sales,3790,1835,5625
15969,Ferdie,Freund,ffreundow@scientificamerican.com,Health Coach IV,5208,813,6021
15302,Pieter,Chillingsworth,pchillingsworthox@ihg.com,Chief Design Engineer,1564,1799,3363
15059,Josias,Keane,jkeanep0@goo.ne.jp,Analog Circuit Design manager,3263,1460,4723
15781,Danita,Kment,dkmentp2@google.fr,Administrative Officer,9058,715,9773
15021,Jerry,Wipper,jwipperp8@time.com,Payment Adjustment Coordinator,8532,1609,10141
15507,Denys,Hawick,dhawickpd@miitbeian.gov.cn,Engineer III,9879,1986,11865
15764,Maybelle,Crispe,mcrispepf@yale.edu,Administrative Officer,3090,1544,4634
15872,Hew,Seeney,hseeneyph@pen.io,Media Manager II,6283,1216,7499
15433,Fayina,Selborne,fselbornepi@tripadvisor.com,Chief Design Engineer,1867,574,2441
15529,Kayle,Hansley,khansleypk@springer.com,Legal Assistant,4478,1009,5487
15427,Raf,Finkle,rfinklepl@creativecommons.org,Accounting Assistant II,5770,975,6745
15275,Binny,Pineaux,bpineauxpq@wikia.com,Senior Quality Engineer,3347,1716,5063
15852,Peder,Potkins,ppotkinspr@ebay.com,Structural Analysis Engineer,5073,1909,6982
15299,Bron,Murcutt,bmurcuttps@behance.net,Structural Analysis Engineer,1035,415,1450
15174,Bern,McGiven,bmcgivenpt@hud.gov,Teacher,5223,1614,6837
15985,Perceval,McIlvaney,pmcilvaneypx@cnbc.com,Account Executive,7522,1216,8738
15072,Duky,Dougary,ddougaryq0@multiply.com,Senior Sales Associate,9799,1046,10845
15538,Dorrie,Sutherel,dsutherelq1@skyrock.com,Geologist I,9374,1668,11042
15743,Gerard,Root,grootq3@microsoft.com,Recruiter,4322,346,4668
15993,Keary,Darby,kdarbyq4@techcrunch.com,Registered Nurse,7856,1539,9395
15274,Devina,Robertet,drobertetq6@1688.com,Professor,8192,212,8404
15590,Reinhard,O' Donohue,rodonohueq7@nifty.com,Automation Specialist III,3483,1951,5434
15779,Corri,Catford,ccatfordqa@nydailynews.com,Human Resources Assistant III,8771,1808,10579
15435,Cyndi,Wontner,cwontnerqc@aboutads.info,Nurse Practicioner,3692,508,4200
15677,Jonie,Huggan,jhugganqh@nydailynews.com,Financial Advisor,6077,580,6657
15353,Dietrich,Dowsett,ddowsettqi@telegraph.co.uk,Pharmacist,7551,1534,9085
15485,Sharlene,MacPeice,smacpeiceqj@cnbc.com,Database Administrator III,1299,215,1514
15431,Alicia,O'Neil,aoneilql@usa.gov,Desktop Support Technician,2243,1701,3944
15886,Mel,Emanuelli,memanuelliqm@meetup.com,Junior Executive,4153,1486,5639
15836,Leonid,Oaker,loakerqn@domainmarket.com,Physical Therapy Assistant,3314,499,3813
15311,Nissa,Donohoe,ndonohoeqo@usa.gov,VP Marketing,8596,1377,9973
15218,Adora,Gaskarth,agaskarthqr@networksolutions.com,Research Assistant III,6795,1101,7896
15283,Anica,Spurrett,aspurrettqs@theguardian.com,Marketing Assistant,6381,240,6621
15297,Porter,Franks,pfranksqv@reuters.com,Automation Specialist II,6067,1700,7767
15131,Alisander,Beer,abeerqy@blog.com,Librarian,4723,259,4982
15266,Lion,Fishe,lfisher4@smugmug.com,Accounting Assistant IV,7929,497,8426
15091,Horton,Fricke,hfricker5@shop-pro.jp,Desktop Support Technician,3857,1919,5776
15122,Isa,Ducroe,iducroer9@kickstarter.com,Statistician IV,4296,872,5168
15365,Dasie,Rodders,droddersrd@sfgate.com,Nuclear Power Engineer,5484,667,6151
15919,Jessie,Collelton,jcolleltonre@smugmug.com,VP Sales,1888,423,2311
15334,Marjy,Phillput,mphillputri@arstechnica.com,Occupational Therapist,2174,1085,3259
15428,Cody,Stanmer,cstanmerrm@digg.com,Software Test Engineer IV,8219,821,9040
15854,Nola,Zanre,nzanrero@i2i.jp,Legal Assistant,3110,1153,4263
15309,Diahann,Bearcroft,dbearcroftrr@delicious.com,Accounting Assistant IV,3407,273,3680
16973,Myrle,Durban,mdurban0@theatlantic.com,Geological Engineer,4515,1664,6179
16670,Gradeigh,Keaysell,gkeaysell1@nydailynews.com,Senior Sales Associate,8259,1811,10070
16975,Abelard,Reading,areading2@wisc.edu,Cost Accountant,3180,1197,4377
16007,Parke,Winterscale,pwinterscale3@digg.com,Design Engineer,9455,1366,10821
16317,Randal,Evason,revason4@aboutads.info,Project Manager,6799,1986,8785
16825,Joby,Praundl,jpraundl5@bigcartel.com,Research Assistant IV,6320,1300,7620
16699,Lesley,Kimblen,lkimblen6@cocolog-nifty.com,Environmental Specialist,3573,1818,5391
16328,Oneida,D'Alesio,odalesio7@xrea.com,Statistician I,8150,1899,10049
16325,Doralin,Peplow,dpeplow8@cnet.com,Junior Executive,2311,934,3245
16816,Ladonna,Attride,lattride9@cocolog-nifty.com,Cost Accountant,5418,621,6039
16181,Ogden,Challens,ochallensa@is.gd,VP Quality Control,7214,1478,8692
16725,Addi,Whoolehan,awhoolehanb@joomla.org,General Manager,4311,1343,5654
16155,Yankee,Poynzer,ypoynzerc@vkontakte.ru,Paralegal,4841,1303,6144
16245,Randi,Blaiklock,rblaiklockd@sogou.com,Quality Control Specialist,8916,1726,10642
16382,Correna,Honsch,chonsche@wp.com,Senior Quality Engineer,7059,379,7438
16129,Allyn,Gavahan,agavahanf@alibaba.com,Social Worker,9198,501,9699
16878,Darbie,Andric,dandricg@webnode.com,Accountant I,1248,325,1573
16715,Josselyn,Frankcomb,jfrankcombh@pagesperso-orange.fr,Registered Nurse,1021,428,1449
16920,Gusty,Verson,gversoni@theguardian.com,Compensation Analyst,7218,1005,8223
16079,Sorcha,Fenty,sfentyj@domainmarket.com,Cost Accountant,8583,1094,9677
16927,Veronica,Robertet,vrobertetk@msn.com,Junior Executive,8750,1151,9901
16299,Valentine,Jiggen,vjiggenl@yale.edu,Product Engineer,9708,499,10207
16525,Forbes,Wishkar,fwishkarm@home.pl,Administrative Assistant IV,8932,1480,10412
16349,Brendan,Ossenna,bossennan@1und1.de,Chief Design Engineer,7195,1368,8563
16515,Hank,Whittenbury,hwhittenburyo@nationalgeographic.com,Web Designer I,8777,568,9345
16203,Shaylah,Otteridge,sotteridgep@google.fr,Help Desk Operator,8297,1458,9755
16399,Yurik,Vinecombe,yvinecombeq@latimes.com,Software Test Engineer II,8984,626,9610
16742,Teddie,Inchcomb,tinchcombr@mozilla.org,Internal Auditor,8104,1714,9818
16718,Tatiana,Duffell,tduffells@loc.gov,Business Systems Development Analyst,5225,1124,6349
16139,Tobie,Lansbury,tlansburyt@topsy.com,Senior Financial Analyst,5368,1661,7029
16492,Britteny,Verecker,bvereckeru@sina.com.cn,Quality Engineer,3632,471,4103
16033,Nonnah,Choldcroft,ncholdcroftv@blogger.com,Help Desk Operator,1745,1006,2751
16653,Immanuel,Tomich,itomichw@istockphoto.com,Nurse,4863,1466,6329
16404,Delly,Lewisham,dlewishamx@blogger.com,Systems Administrator IV,5409,1611,7020
16113,Hendrick,O'Shavlan,hoshavlany@admin.ch,Executive Secretary,6666,936,7602
16322,Grier,Lansley,glansleyz@bizjournals.com,Accountant III,8123,822,8945
16256,Janie,Dadge,jdadge10@yolasite.com,Product Engineer,4264,1691,5955
16248,Andree,Halley,ahalley11@drupal.org,Administrative Officer,4860,1478,6338
16429,Marylou,Arghent,marghent12@google.com,Administrative Assistant I,6052,632,6684
16071,Rainer,Raisher,rraisher13@wired.com,Software Consultant,1662,445,2107
16605,Gordan,Wealthall,gwealthall14@auda.org.au,Automation Specialist I,8899,1637,10536
16109,Issiah,Izkoveski,iizkoveski15@toplist.cz,Actuary,4565,454,5019
16641,Opalina,Raffels,oraffels16@aboutads.info,Recruiter,2188,889,3077
16201,Wilbert,Eannetta,weannetta17@artisteer.com,VP Quality Control,6383,766,7149
16724,Orran,Vauter,ovauter18@example.com,Compensation Analyst,9451,398,9849
16986,Sinclair,Harvey,sharvey19@youku.com,Clinical Specialist,6622,320,6942
16449,Stevy,Normandale,snormandale1a@netvibes.com,Executive Secretary,6216,1583,7799
16908,Silvie,Dartnall,sdartnall1b@earthlink.net,Technical Writer,7649,1069,8718
16682,Rachelle,Sherreard,rsherreard1c@samsung.com,Project Manager,8414,1253,9667
16249,Dorita,Noller,dnoller1d@kickstarter.com,Senior Cost Accountant,8154,756,8910
16253,Teri,Geerdts,tgeerdts1e@baidu.com,Programmer Analyst I,1844,864,2708
16115,Sax,Bresson,sbresson1f@technorati.com,Nurse Practicioner,8018,1490,9508
16929,Yves,Camm,ycamm1g@goo.ne.jp,Quality Control Specialist,3145,1643,4788
16416,Priscella,Carnier,pcarnier1h@webmd.com,Health Coach III,7346,1640,8986
16105,Guinevere,Rayson,grayson1j@intel.com,Senior Quality Engineer,5825,959,6784
16646,Langston,Choake,lchoake1k@microsoft.com,Librarian,2634,1795,4429
16509,Abigael,Casillas,acasillas1l@ifeng.com,Administrative Officer,1178,721,1899
16296,Vaughn,Buxsy,vbuxsy1m@ibm.com,Civil Engineer,4022,673,4695
16531,Danita,Gracewood,dgracewood1n@paginegialle.it,Office Assistant II,8995,1889,10884
16617,Hilarius,Haggleton,hhaggleton1o@360.cn,Human Resources Manager,7718,793,8511
16562,Norina,Ech,nech1p@google.com.au,VP Marketing,4383,548,4931
16219,Rubetta,MacGhee,rmacghee1r@jalbum.net,Junior Executive,6467,1187,7654
16824,Chrystel,M'Quharge,cmquharge1s@google.it,Information Systems Manager,2986,1369,4355
16785,Shelby,Speers,sspeers1t@blogspot.com,Staff Accountant I,2368,549,2917
16054,Madelin,Renshell,mrenshell1u@un.org,Operator,8879,1333,10212
16247,Hartley,Grist,hgrist1w@prnewswire.com,Health Coach I,1972,1619,3591
16419,Mar,Sandells,msandells1x@squidoo.com,Staff Accountant IV,9490,1607,11097
16597,Isabel,Edlestone,iedlestone1y@japanpost.jp,VP Accounting,6784,753,7537
16014,Noell,McDougall,nmcdougall20@redcross.org,Teacher,7441,1669,9110
16049,Vina,Locket,vlocket21@scribd.com,Payment Adjustment Coordinator,6808,928,7736
16313,Tallia,Dyos,tdyos22@joomla.org,Computer Systems Analyst II,9463,1266,10729
16433,Winfred,Gration,wgration23@bizjournals.com,Executive Secretary,3163,1314,4477
16442,Rodney,Choldcroft,rcholdcroft24@jimdo.com,Internal Auditor,7758,466,8224
16436,Lorene,Vouls,lvouls25@live.com,Senior Sales Associate,8888,714,9602
16012,Marj,Allsep,mallsep26@etsy.com,Mechanical Systems Engineer,5130,1383,6513
16154,Chandra,Jennins,cjennins27@feedburner.com,Actuary,2139,1877,4016
16787,Mirabella,Winder,mwinder28@cdc.gov,Nurse,8497,448,8945
16394,Nikolas,Benito,nbenito29@1688.com,Human Resources Assistant I,7138,1213,8351
16374,Maribeth,Ruddell,mruddell2a@ifeng.com,Recruiter,6031,409,6440
16539,Patsy,Gillease,pgillease2c@privacy.gov.au,Nurse Practicioner,2518,638,3156
16933,Gray,Sames,gsames2d@tripod.com,Recruiting Manager,4109,1762,5871
16157,Maddie,Matijevic,mmatijevic2e@mayoclinic.com,Design Engineer,9001,434,9435
16763,Bevan,Margaret,bmargaret2f@odnoklassniki.ru,Programmer Analyst IV,4380,658,5038
16835,Ragnar,Pedersen,rpedersen2g@newyorker.com,Payment Adjustment Coordinator,4428,826,5254
16681,Katherina,Stell,kstell2h@baidu.com,Senior Developer,4995,1353,6348
16241,Ginni,MacLaren,gmaclaren2i@bing.com,Information Systems Manager,5389,1877,7266
16337,Chanda,Ferryn,cferryn2j@moonfruit.com,Programmer Analyst II,4981,1186,6167
16917,Northrup,Tenpenny,ntenpenny2l@mapy.cz,Human Resources Manager,7526,927,8453
16089,Reeba,Noor,rnoor2m@sina.com.cn,Help Desk Operator,7624,681,8305
16413,Thelma,Permain,tpermain2o@vkontakte.ru,Compensation Analyst,2381,1036,3417
16381,Joyce,Sante,jsante2p@archive.org,VP Product Management,2671,1653,4324
16386,Jacqueline,Flintuff,jflintuff2q@blinklist.com,Electrical Engineer,7568,977,8545
16008,Darwin,Westman,dwestman2r@cdc.gov,Statistician III,9754,257,10011
16849,Henka,Doles,hdoles2s@china.com.cn,Senior Developer,9809,1455,11264
16338,Theressa,MacTerrelly,tmacterrelly2t@google.it,Account Executive,8633,829,9462
16968,Lev,Rolles,lrolles2u@rakuten.co.jp,Research Assistant III,6388,606,6994
16797,Shellie,Polsin,spolsin2w@bing.com,Database Administrator III,8485,1035,9520
16523,Mayor,Bugdall,mbugdall2x@tamu.edu,Account Coordinator,5922,319,6241
16757,Jessalin,Dukesbury,jdukesbury2y@dailymail.co.uk,Geological Engineer,6397,742,7139
16698,Shurwood,Boman,sboman2z@trellian.com,VP Accounting,6910,1949,8859
16218,Torie,Mompesson,tmompesson30@mozilla.com,Budget/Accounting Analyst III,5184,653,5837
16778,Mufi,Dowsey,mdowsey31@cocolog-nifty.com,Research Assistant I,6662,924,7586
16150,Linc,Favell,lfavell32@icq.com,Safety Technician II,9692,721,10413
16529,Flossy,Corssen,fcorssen33@bloglovin.com,Staff Scientist,6985,746,7731
16507,Maribeth,Clemits,mclemits34@istockphoto.com,Marketing Assistant,5570,1674,7244
16130,Bonnibelle,Eastmond,beastmond35@va.gov,Paralegal,7324,1548,8872
16702,Libbi,Braime,lbraime36@senate.gov,Research Associate,3382,1514,4896
16794,Nike,Gallifont,ngallifont37@cmu.edu,Graphic Designer,3320,1548,4868
16365,Vic,Addinall,vaddinall38@delicious.com,Sales Associate,5559,1807,7366
16913,Ive,Penke,ipenke39@ucoz.ru,Human Resources Assistant I,6553,772,7325
16491,Demott,Seegar,dseegar3a@un.org,Quality Engineer,7210,1344,8554
16924,Whitby,Hassin,whassin3b@taobao.com,Research Nurse,4670,1199,5869
16340,Willis,Pendrigh,wpendrigh3c@ftc.gov,Product Engineer,8201,1586,9787
16324,Tani,Fissenden,tfissenden3d@msu.edu,Assistant Media Planner,8101,620,8721
16610,Marti,Beach,mbeach3e@pinterest.com,Web Developer III,7557,1316,8873
16846,Damon,Lant,dlant3f@ucoz.ru,VP Marketing,7925,867,8792
16053,Nat,Chater,nchater3g@answers.com,Graphic Designer,6087,1855,7942
16914,Andeee,Caldairou,acaldairou3h@nsw.gov.au,Electrical Engineer,2957,1944,4901
16278,Viola,Blasetti,vblasetti3i@pinterest.com,Information Systems Manager,2751,1019,3770
16263,Fern,Botger,fbotger3j@yandex.ru,Social Worker,5137,1671,6808
16034,Margo,Abercromby,mabercromby3k@gov.uk,Tax Accountant,4575,1041,5616
16329,Fayre,Burberry,fburberry3l@columbia.edu,Data Coordiator,6256,1366,7622
16766,Warren,Hatfull,whatfull3m@businessinsider.com,Senior Developer,5385,1443,6828
16847,Gardener,Vian,gvian3n@sitemeter.com,Research Nurse,1119,1581,2700
16524,Law,Varlow,lvarlow3o@omniture.com,Physical Therapy Assistant,7005,1802,8807
16472,Karlotte,Al Hirsi,kalhirsi3p@weibo.com,Nurse Practicioner,1513,723,2236
16853,Prescott,De Biaggi,pdebiaggi3r@scribd.com,Product Engineer,6128,1616,7744
16627,Merle,Himsworth,mhimsworth3s@typepad.com,Recruiting Manager,5330,1885,7215
16798,Esra,Penswick,epenswick3u@economist.com,Paralegal,1940,1866,3806
16905,Crawford,Calway,ccalway3w@ted.com,Research Nurse,6217,1509,7726
16395,Jozef,Olanda,jolanda3x@macromedia.com,Information Systems Manager,6256,1924,8180
16892,Emery,Paulot,epaulot3y@miitbeian.gov.cn,Senior Sales Associate,2451,816,3267
16479,Lay,Shillum,lshillum3z@springer.com,Accounting Assistant III,9820,1060,10880
16626,Florry,McAvaddy,fmcavaddy40@spiegel.de,Director of Sales,3006,1457,4463
16949,Alvy,Sieb,asieb41@opensource.org,Senior Editor,8829,1991,10820
16888,Sherlocke,Flett,sflett42@tuttocitta.it,Teacher,4614,1970,6584
16619,Mayer,Mungan,mmungan43@com.com,Design Engineer,1914,1844,3758
16953,Sam,Fewtrell,sfewtrell44@wired.com,Marketing Manager,9805,1881,11686
16861,Albert,Dureden,adureden45@squidoo.com,Budget/Accounting Analyst I,4415,1256,5671
16792,Kellina,Bacop,kbacop46@sogou.com,Design Engineer,7562,551,8113
16691,Gerda,Lince,glince47@marriott.com,Programmer II,2770,1363,4133
16805,Korry,De Beauchamp,kdebeauchamp48@cbc.ca,Geological Engineer,2725,602,3327
16851,Lonnie,Whitear,lwhitear49@theatlantic.com,Pharmacist,2941,955,3896
16996,Tommy,Kirman,tkirman4a@vinaora.com,Cost Accountant,7283,574,7857
16435,Anatol,Neath,aneath4b@craigslist.org,Office Assistant II,7380,270,7650
16870,Mendy,Leverington,mleverington4c@yale.edu,Legal Assistant,2775,635,3410
16969,Odele,Stang-Gjertsen,ostanggjertsen4d@eepurl.com,Research Assistant III,2469,977,3446
16830,Ninette,Keedy,nkeedy4e@reverbnation.com,Administrative Assistant I,8975,1994,10969
16832,Stephanus,O'Hagirtie,sohagirtie4f@ehow.com,Structural Engineer,6410,1295,7705
16362,Winny,Matessian,wmatessian4g@uiuc.edu,Sales Associate,8998,1219,10217
16294,Netti,Veeler,nveeler4h@salon.com,Business Systems Development Analyst,7974,698,8672
16162,Buiron,Rown,brown4i@twitpic.com,Software Engineer II,5639,523,6162
16657,Derry,Luthwood,dluthwood4j@wunderground.com,Environmental Tech,5592,1145,6737
16771,Fonz,Nissle,fnissle4k@columbia.edu,Engineer III,1801,939,2740
16141,Gonzales,Pilipets,gpilipets4m@epa.gov,Administrative Officer,7366,275,7641
16808,Wilie,Marshfield,wmarshfield4n@dyndns.org,Financial Analyst,4744,1328,6072
16708,Sidonnie,Petruszka,spetruszka4o@bandcamp.com,General Manager,8835,1236,10071
16591,Patience,Baldin,pbaldin4q@stanford.edu,Marketing Assistant,9148,567,9715
16781,Carmita,Cherrett,ccherrett4r@nifty.com,Senior Cost Accountant,5633,1885,7518
16712,Ruy,Camin,rcamin4s@dedecms.com,Analyst Programmer,7100,425,7525
16262,Laura,Rivelin,lrivelin4u@craigslist.org,Database Administrator III,5207,1423,6630
16549,Ardisj,Cattel,acattel4w@issuu.com,Professor,7513,1348,8861
16412,Kirsti,Ramirez,kramirez4y@seattletimes.com,Geologist I,7073,1620,8693
16066,Felecia,Polle,fpolle4z@chicagotribune.com,Cost Accountant,9807,1511,11318
16592,Christian,Sarge,csarge51@hubpages.com,Geologist III,8630,1258,9888
16675,Querida,Calam,qcalam52@pen.io,Chief Design Engineer,5681,1393,7074
16415,Sonny,Suttaby,ssuttaby53@gizmodo.com,Editor,6741,724,7465
16860,Justinian,Pleat,jpleat54@e-recht24.de,Registered Nurse,6788,208,6996
16845,Stan,Copelli,scopelli55@edublogs.org,Compensation Analyst,5262,815,6077
16099,Alejandra,Rizziello,arizziello56@t-online.de,Nuclear Power Engineer,3718,1373,5091
16084,Carlye,Giacoppoli,cgiacoppoli57@accuweather.com,Director of Sales,5002,960,5962
16234,Matelda,Tethacot,mtethacot58@japanpost.jp,Senior Sales Associate,7075,1326,8401
16536,Grenville,Millan,gmillan59@nymag.com,Web Developer II,3275,423,3698
16956,Parnell,Sissons,psissons5a@state.gov,Junior Executive,8201,1932,10133
16041,Berkly,Rhydderch,brhydderch5b@illinois.edu,Actuary,3347,344,3691
16311,Sawyer,Pearsall,spearsall5c@godaddy.com,GIS Technical Architect,8915,622,9537
16864,Tamqrah,Sukbhans,tsukbhans5e@examiner.com,Quality Engineer,8558,970,9528
16169,Bab,Carwithen,bcarwithen5f@webnode.com,Senior Quality Engineer,2790,705,3495
16291,Norene,Holborn,nholborn5g@wikipedia.org,Occupational Therapist,6473,349,6822
16451,Florrie,Prebble,fprebble5h@youtu.be,Pharmacist,4394,1546,5940
16910,Mela,Fer,mfer5i@globo.com,Database Administrator III,2188,231,2419
16091,Izzy,Berney,iberney5j@wiley.com,Business Systems Development Analyst,8764,600,9364
16341,Casandra,Mc Grath,cmcgrath5k@utexas.edu,Budget/Accounting Analyst I,6991,585,7576
16522,Shelagh,Sowden,ssowden5m@creativecommons.org,Staff Accountant II,9875,739,10614
16868,Cosimo,Emberson,cemberson5n@webnode.com,Internal Auditor,1690,1935,3625
16173,Lynnea,Lyddiard,llyddiard5o@wisc.edu,Account Representative III,7677,1954,9631
16967,Franny,Kleanthous,fkleanthous5q@diigo.com,Help Desk Technician,5381,1786,7167
16391,Neala,Stambridge,nstambridge5r@archive.org,Physical Therapy Assistant,8135,1688,9823
16104,Tedman,Dawidsohn,tdawidsohn5s@merriam-webster.com,Nurse Practicioner,7319,1682,9001
16634,Carroll,Vynarde,cvynarde5t@cargocollective.com,Assistant Professor,5264,1585,6849
16707,Thelma,Fairall,tfairall5v@seesaa.net,Senior Financial Analyst,1217,1635,2852
16982,Yvonne,Ivery,yivery5w@discovery.com,Information Systems Manager,9170,1403,10573
16731,Rollin,McKune,rmckune5z@seattletimes.com,Design Engineer,1008,1877,2885
16060,Roley,Zapatero,rzapatero60@scientificamerican.com,Electrical Engineer,6670,1893,8563
16357,Earl,Bonett,ebonett61@indiegogo.com,Assistant Media Planner,2333,1074,3407
16244,Darice,Reef,dreef62@cpanel.net,Product Engineer,6350,730,7080
16009,Robinette,Marushak,rmarushak64@ustream.tv,Web Designer III,1698,1928,3626
16166,Tessa,Ashbrook,tashbrook65@fema.gov,Executive Secretary,3908,297,4205
16080,Mord,Paley,mpaley67@mtv.com,Database Administrator IV,9075,1418,10493
16931,Charlotta,Chewter,cchewter68@mozilla.org,Product Engineer,1159,1941,3100
16295,Christophorus,Brandino,cbrandino6a@cafepress.com,Actuary,2011,1423,3434
16026,Lincoln,Folkes,lfolkes6c@mit.edu,Sales Associate,7283,480,7763
16581,Eleanore,Scotney,escotney6d@alexa.com,Web Developer IV,2468,1687,4155
16074,Carlynne,Linggood,clinggood6f@smugmug.com,Compensation Analyst,3492,555,4047
16709,Coleen,Lardge,clardge6g@elegantthemes.com,Media Manager IV,2321,1496,3817
16520,Leopold,Crowder,lcrowder6j@yale.edu,Civil Engineer,1860,1724,3584
16327,Malachi,Dummigan,mdummigan6k@chronoengine.com,General Manager,3281,502,3783
16441,Mose,Seleway,mseleway6n@nps.gov,Quality Engineer,2926,937,3863
16487,Kary,Decourt,kdecourt6p@icio.us,Tax Accountant,6434,1773,8207
16003,Claudie,Farbrace,cfarbrace6r@forbes.com,General Manager,1125,1831,2956
16906,Ileana,Youdell,iyoudell6s@ibm.com,Legal Assistant,7025,1192,8217
16434,Cathi,Rolse,crolse6t@chron.com,Editor,1491,1249,2740
16383,Angelica,Bucklan,abucklan6u@time.com,Recruiting Manager,8917,785,9702
16233,Pepe,Maylin,pmaylin6v@businessweek.com,Social Worker,5545,661,6206
16921,Nealson,Bougourd,nbougourd6w@jalbum.net,Paralegal,6790,526,7316
16005,Zechariah,Wagen,zwagen6x@php.net,Information Systems Manager,1224,586,1810
16148,Prudence,Showering,pshowering6y@tripod.com,Senior Editor,3145,797,3942
16667,Darda,Bellison,dbellison6z@blogger.com,Chief Design Engineer,8018,869,8887
16410,Stanford,Corday,scorday70@census.gov,Librarian,7119,1740,8859
16631,Benn,Pesak,bpesak71@hc360.com,Account Representative II,5975,958,6933
16639,Krissy,Luty,kluty72@nba.com,Health Coach IV,4123,415,4538
16738,Lewie,Gooders,lgooders73@com.com,Human Resources Manager,6858,1417,8275
16571,Donna,Tween,dtween74@sogou.com,Librarian,1805,1264,3069
16976,Timothea,Belfelt,tbelfelt78@gizmodo.com,Data Coordiator,5809,631,6440
16729,Monah,Rylstone,mrylstone79@miitbeian.gov.cn,Structural Engineer,5873,855,6728
16965,Maighdiln,d' Elboux,mdelboux7a@mac.com,Senior Sales Associate,6894,910,7804
16440,Doe,Deveraux,ddeveraux7b@facebook.com,Automation Specialist I,6557,1882,8439
16587,Cart,Fairbourne,cfairbourne7c@macromedia.com,Staff Accountant IV,6767,1831,8598
16575,Brinna,Circuitt,bcircuitt7e@cbc.ca,VP Marketing,8614,1178,9792
16534,Brett,Doige,bdoige7f@jugem.jp,Staff Scientist,9247,418,9665
16753,See,Tassell,stassell7i@addthis.com,Marketing Manager,3102,789,3891
16611,Karney,Courtliff,kcourtliff7j@nsw.gov.au,Statistician I,4082,868,4950
16202,Mario,Strafford,mstrafford7k@unc.edu,Nurse,4978,1131,6109
16302,Kermit,Bohje,kbohje7l@hibu.com,Design Engineer,3612,779,4391
16916,Lammond,Wimsett,lwimsett7m@sciencedirect.com,Analog Circuit Design manager,1688,204,1892
16844,Gifford,Le Blond,gleblond7n@seattletimes.com,VP Quality Control,3589,1696,5285
16131,Sophie,Urey,surey7o@bigcartel.com,Senior Financial Analyst,1054,1604,2658
16271,Vera,Mityashin,vmityashin7p@jiathis.com,Civil Engineer,1036,1972,3008
16473,Chalmers,Ricciardello,cricciardello7q@indiatimes.com,Sales Associate,4106,1985,6091
16024,Francisca,Still,fstill7s@soundcloud.com,Software Test Engineer III,3303,806,4109
16370,Engelbert,Wilford,ewilford7t@admin.ch,Health Coach I,9275,1348,10623
16298,Erin,Andrews,eandrews7v@newyorker.com,Professor,3699,670,4369
16275,Jobie,Gallaher,jgallaher7w@github.io,Geologist IV,9277,375,9652
16379,Whittaker,Headings,wheadings7x@china.com.cn,Assistant Professor,9474,559,10033
16970,Rivy,Spurryer,rspurryer7z@hugedomains.com,Social Worker,2490,822,3312
16843,Neel,Hinkley,nhinkley81@t-online.de,Assistant Media Planner,2380,359,2739
16530,Brittney,Dunsmuir,bdunsmuir82@mozilla.com,Safety Technician II,1236,1719,2955
16418,Noe,Soldner,nsoldner83@etsy.com,Help Desk Technician,6523,219,6742
16019,Jamima,Cottem,jcottem84@usda.gov,Media Manager IV,8575,583,9158
16059,Annalise,Hadleigh,ahadleigh85@wix.com,Senior Developer,5055,544,5599
16013,Johnette,Tomasi,jtomasi88@cnbc.com,Software Engineer III,2448,1100,3548
16421,Regan,Boxer,rboxer89@printfriendly.com,Recruiter,6321,1816,8137
16589,Jerrine,Kop,jkop8a@techcrunch.com,Account Executive,7615,1837,9452
16862,Charlean,Burkitt,cburkitt8d@mapquest.com,Technical Writer,1174,1763,2937
16579,Bertie,Scopham,bscopham8f@simplemachines.org,Environmental Specialist,9810,1159,10969
16833,Penelope,Somerlie,psomerlie8g@fastcompany.com,Assistant Professor,8538,1175,9713
16369,Fin,Stichel,fstichel8i@histats.com,Geological Engineer,1461,1221,2682
16866,Phebe,Gillian,pgillian8j@nsw.gov.au,Graphic Designer,1084,1239,2323
16255,Ranique,Kemery,rkemery8n@zimbio.com,Programmer I,1923,1371,3294
16621,Nancey,Minero,nminero8o@1und1.de,Health Coach II,1518,1862,3380
16307,Pauli,Fidell,pfidell8q@twitter.com,Automation Specialist I,2770,291,3061
16649,Kitti,Simmers,ksimmers8r@salon.com,Desktop Support Technician,9874,1714,11588
16161,Haslett,McKinn,hmckinn8s@mac.com,Software Engineer II,3507,1243,4750
16836,Rafe,Igounet,rigounet8t@java.com,Senior Developer,7669,1055,8724
16533,Allianora,Nares,anares8u@npr.org,Help Desk Technician,4313,452,4765
16977,Zonnya,Casero,zcasero8v@businesswire.com,Environmental Tech,9262,609,9871
16717,Amata,Boake,aboake8x@wisc.edu,Chief Design Engineer,8067,1237,9304
16185,Morty,Doxey,mdoxey8y@imageshack.us,Actuary,9320,1304,10624
16358,Zacharia,Bartunek,zbartunek8z@nydailynews.com,Research Nurse,4702,1723,6425
16801,Simonette,Sphinxe,ssphinxe90@ftc.gov,Research Nurse,6264,209,6473
16321,Peg,Boshier,pboshier91@cmu.edu,Teacher,2407,366,2773
16990,Antone,Sirette,asirette92@reverbnation.com,Registered Nurse,5636,1518,7154
16380,Laurianne,Josland,ljosland94@phpbb.com,Statistician II,3310,1499,4809
16614,Gayler,Cottesford,gcottesford95@altervista.org,Pharmacist,2592,1894,4486
16701,Arnaldo,Barley,abarley96@ucoz.ru,VP Sales,8256,231,8487
16237,Krishnah,Benyon,kbenyon9a@twitter.com,VP Accounting,1886,1999,3885
16213,Kerrie,Scholey,kscholey9b@mail.ru,GIS Technical Architect,8601,847,9448
16926,Dulsea,Morter,dmorter9d@miitbeian.gov.cn,Technical Writer,9887,978,10865
16580,Valenka,Caldwall,vcaldwall9f@jalbum.net,Paralegal,9554,1803,11357
16661,Jodi,Strond,jstrond9g@123-reg.co.uk,Recruiter,6450,755,7205
16344,Freddy,Bemwell,fbemwell9h@ihg.com,Help Desk Technician,4244,600,4844
16414,Hilliard,Jewes,hjewes9i@pinterest.com,Nurse,3568,1212,4780
16371,Ilene,Lidden,ilidden9l@noaa.gov,Community Outreach Specialist,5619,963,6582
16895,Tabbi,Bagniuk,tbagniuk9n@homestead.com,Senior Editor,9841,398,10239
16596,Reagen,Sheaf,rsheaf9o@theglobeandmail.com,Operator,2157,624,2781
16985,Zitella,Gottelier,zgottelier9q@pbs.org,Geological Engineer,5075,1123,6198
16867,Ole,Flye,oflye9r@opensource.org,Web Developer IV,2860,1114,3974
16893,Pyotr,Hornig,phornig9s@time.com,Desktop Support Technician,2495,1247,3742
16608,Ignatius,McKeevers,imckeevers9t@ted.com,Speech Pathologist,4473,549,5022
16615,Opalina,Matanin,omatanin9u@sciencedaily.com,Design Engineer,2288,1257,3545
16265,Georg,Beetham,gbeetham9w@desdev.cn,Nuclear Power Engineer,1295,1554,2849
16831,Brade,Burkinshaw,bburkinshaw9x@dedecms.com,Nurse Practicioner,7005,1700,8705
16974,Von,Twiddy,vtwiddy9y@skype.com,Assistant Media Planner,3945,1970,5915
16629,Zulema,Sandcroft,zsandcroft9z@jalbum.net,Research Associate,4791,384,5175
16993,Horton,Sheard,hshearda0@storify.com,Mechanical Systems Engineer,7337,960,8297
16586,Sauncho,Mulles,smullesa1@alexa.com,Executive Secretary,2740,1195,3935
16540,Anetta,Castilljo,acastilljoa3@amazon.com,Internal Auditor,2995,1613,4608
16566,Amie,Benoey,abenoeya4@wordpress.com,Legal Assistant,7982,1223,9205
16514,Cullan,Harrod,charroda5@bigcartel.com,Human Resources Assistant III,2763,1924,4687
16896,Uriah,McCathie,umccathiea7@irs.gov,Staff Scientist,7451,1377,8828
16817,Knox,Vina,kvinaa8@so-net.ne.jp,Dental Hygienist,3932,631,4563
16486,Angelico,Mc Kellen,amckellena9@merriam-webster.com,Payment Adjustment Coordinator,4180,1061,5241
16543,Ricki,Harris,rharrisab@a8.net,Senior Editor,9623,1935,11558
16679,Eva,Bettenson,ebettensonad@merriam-webster.com,Senior Developer,5724,534,6258
16067,Fulton,McMeekan,fmcmeekanae@a8.net,VP Marketing,3310,439,3749
16637,Maurits,McPhee,mmcpheeaf@geocities.jp,Statistician II,4384,1340,5724
16438,Aggy,Crossfield,acrossfieldag@adobe.com,Business Systems Development Analyst,2946,1947,4893
16402,Idaline,Ventum,iventumah@auda.org.au,Systems Administrator II,7287,727,8014
16021,Jocelyn,Hedan,jhedanai@google.co.jp,Structural Analysis Engineer,9922,795,10717
16258,Roy,Cutten,rcuttenaj@dailymotion.com,Editor,1558,988,2546
16527,Rollins,Gambrell,rgambrellak@devhub.com,Recruiting Manager,4135,1377,5512
16252,Elsa,Cohalan,ecohalanam@reverbnation.com,VP Accounting,8432,777,9209
16554,Hale,Ropcke,hropckean@unesco.org,VP Accounting,3290,852,4142
16082,Doria,Cremer,dcremerao@dyndns.org,Compensation Analyst,4504,708,5212
16452,Tailor,McGow,tmcgowap@bandcamp.com,Teacher,5972,842,6814
16528,Annecorinne,Mushett,amushettaq@eventbrite.com,Data Coordiator,4053,999,5052
16334,Dolf,Gatherell,dgatherellar@freewebs.com,Staff Scientist,2304,926,3230
16392,Lennard,Tavner,ltavneras@sbwire.com,Human Resources Manager,1712,1519,3231
16651,Gilbertine,Janovsky,gjanovskyat@prnewswire.com,Account Coordinator,5203,1631,6834
16315,Eadie,Loder,eloderau@mail.ru,Food Chemist,9744,322,10066
16470,Odele,Barsam,obarsamav@mit.edu,Director of Sales,8615,1756,10371
16984,Elisa,Broadstock,ebroadstockax@businessinsider.com,Legal Assistant,4675,717,5392
16501,Harvey,Taft,htaftaz@wired.com,Legal Assistant,4383,320,4703
16482,Annadiane,Selwood,aselwoodb1@nsw.gov.au,Information Systems Manager,1193,1761,2954
16690,Genevieve,Extall,gextallb3@ovh.net,Automation Specialist II,5945,1199,7144
16208,Gabrila,Hendrickx,ghendrickxb4@vkontakte.ru,Nuclear Power Engineer,7900,1298,9198
16998,Bartie,Cockshott,bcockshottb5@theguardian.com,Cost Accountant,8753,1879,10632
16168,Conni,Asplen,casplenb8@ftc.gov,Senior Quality Engineer,1465,755,2220
16257,Koenraad,Valde,kvaldeb9@scientificamerican.com,Tax Accountant,3380,1671,5051
16312,Palm,Feeny,pfeenyba@chronoengine.com,Dental Hygienist,9526,1207,10733
16431,Brunhilda,O'Hegertie,bohegertiebc@live.com,Financial Advisor,1364,325,1689
16015,Ebba,Pinhorn,epinhornbd@army.mil,Geologist II,3568,1585,5153
16300,Shurlocke,Duckett,sduckettbf@businesswire.com,Senior Cost Accountant,6946,1895,8841
16063,Cull,Filipczak,cfilipczakbg@yale.edu,Nurse,1744,1374,3118
16215,Adolphe,McOwen,amcowenbh@deviantart.com,VP Product Management,6366,1051,7417
16318,Kamilah,Barhims,kbarhimsbi@intel.com,Editor,9155,930,10085
16464,Theressa,Brewer,tbrewerbl@gnu.org,Social Worker,5945,616,6561
16746,Harrietta,Rylstone,hrylstonebm@sun.com,Geological Engineer,2808,1149,3957
16711,Terry,Schulter,tschulterbr@booking.com,Nurse Practicioner,3872,1611,5483
16788,Allistir,Monard,amonardbs@disqus.com,Recruiter,2957,1284,4241
16841,Stanislas,Jewster,sjewsterbt@mayoclinic.com,Statistician III,7573,1534,9107
16002,Bendick,Charon,bcharonbv@gov.uk,Structural Engineer,7816,1692,9508
16947,Jayme,Burgne,jburgnebx@un.org,Help Desk Technician,2636,1852,4488
16459,Vanna,Bitten,vbittenby@accuweather.com,Financial Analyst,9553,1419,10972
16210,Denni,Chedzoy,dchedzoybz@bravesites.com,Account Representative III,5527,584,6111
16877,Peder,Putterill,pputterillc0@theguardian.com,Human Resources Manager,7686,936,8622
16126,Daloris,Domenici,ddomenicic1@shareasale.com,Senior Sales Associate,9165,1806,10971
16359,Helaine,Wisden,hwisdenc3@bbb.org,Senior Quality Engineer,9726,1488,11214
16710,Cyril,Everton,cevertonc6@amazonaws.com,VP Sales,6685,523,7208
16336,Dierdre,Cossons,dcossonsc7@usa.gov,Speech Pathologist,5921,1345,7266
16326,Sophie,Arkle,sarklec9@studiopress.com,Analog Circuit Design manager,6560,1043,7603
16355,Wenonah,Chatan,wchatanca@istockphoto.com,Automation Specialist III,8452,278,8730
16751,Lammond,Ramirez,lramirezcb@barnesandnoble.com,Sales Associate,4075,291,4366
16229,Myrta,Ainger,maingercc@springer.com,Developer II,6606,1447,8053
16388,Osmund,Snoxill,osnoxillcd@theguardian.com,VP Accounting,4882,1507,6389
16807,Alfi,Manuelli,amanuellicf@archive.org,Developer I,6431,994,7425
16232,Lenna,Divisek,ldivisekcg@ted.com,Graphic Designer,7485,1276,8761
16730,Hewitt,Giottoi,hgiottoicj@biblegateway.com,Biostatistician III,7889,1410,9299
16512,Hilliard,Whawell,hwhawellck@cam.ac.uk,Assistant Professor,7691,401,8092
16106,Inglis,Clawe,iclawecl@sohu.com,Budget/Accounting Analyst IV,1231,1429,2660
16377,Galen,Whitbread,gwhitbreadcr@zimbio.com,Actuary,9627,1415,11042
16881,Dionysus,Fisk,dfiskcw@ning.com,Senior Cost Accountant,8116,226,8342
16231,Casie,Wolton,cwoltoncy@jigsy.com,Office Assistant III,9158,1774,10932
16583,Philippine,Formie,pformied0@nydailynews.com,Professor,3312,1268,4580
16488,Sunny,Dundon,sdundond1@histats.com,Physical Therapy Assistant,3951,1939,5890
16939,Calvin,Haddow,chaddowd2@example.com,Assistant Manager,5896,942,6838
16960,Benedick,Elce,belced3@lulu.com,Analog Circuit Design manager,6693,382,7075
16954,Nicolai,Candelin,ncandelind7@dropbox.com,Occupational Therapist,2508,543,3051
16147,Cassandry,Alsford,calsfordd9@com.com,Software Consultant,4576,559,5135
16561,Boyce,Congrave,bcongraveda@mapy.cz,Software Test Engineer II,6766,507,7273
16458,Winston,Sebborn,wsebborndd@qq.com,Health Coach I,2900,1099,3999
16018,Lenora,Chatelot,lchatelotde@unicef.org,Cost Accountant,7814,795,8609
16204,Cortney,Reichardt,creichardtdf@photobucket.com,Research Associate,7875,1863,9738
16345,Paulie,Ailsbury,pailsburydh@pbs.org,Account Representative III,9457,1213,10670
16837,Maynord,Cleworth,mcleworthdj@github.com,Sales Associate,5974,1274,7248
16959,Drusie,Keele,dkeeledk@i2i.jp,VP Quality Control,4730,1850,6580
16784,Rowena,Tichelaar,rtichelaardl@foxnews.com,Senior Developer,8222,1845,10067
16303,Dion,Lively,dlivelydm@shareasale.com,Pharmacist,2797,991,3788
16676,Garner,Cowderoy,gcowderoydn@columbia.edu,VP Product Management,6348,1482,7830
16304,Bridgette,Earingey,bearingeydo@imdb.com,Structural Analysis Engineer,6992,242,7234
16727,Lynne,Rozec,lrozecdp@purevolume.com,Professor,3321,434,3755
16273,Siusan,Dossantos,sdossantosdq@constantcontact.com,Product Engineer,6417,1285,7702
16101,Burnard,Izard,bizarddr@wunderground.com,Product Engineer,9420,531,9951
16087,Rollo,Beaty,rbeatyds@miibeian.gov.cn,Senior Cost Accountant,5034,1687,6721
16409,Valery,Konertz,vkonertzdu@barnesandnoble.com,Librarian,3626,214,3840
16854,Timothea,Errichelli,terrichellidv@apache.org,Environmental Specialist,2176,529,2705
16468,Celina,Boundy,cboundydw@clickbank.net,Junior Executive,7342,959,8301
16590,Evy,Barlass,ebarlassdx@slashdot.org,Chemical Engineer,6433,1295,7728
16559,Rex,Delacroux,rdelacrouxdy@shareasale.com,Junior Executive,3383,895,4278
16736,Gianni,Eakens,geakensdz@youtube.com,Mechanical Systems Engineer,8568,838,9406
16146,Claybourne,Lough,cloughe0@webmd.com,Dental Hygienist,9904,597,10501
16880,Paulina,Ekell,pekelle1@usda.gov,Software Engineer I,7802,1898,9700
16994,Brose,Jendrassik,bjendrassike3@umich.edu,Computer Systems Analyst I,4079,1913,5992
16625,Sonny,Pimer,spimere7@deliciousdays.com,Registered Nurse,8434,1028,9462
16992,Gladi,Pawson,gpawsone8@parallels.com,Nuclear Power Engineer,8891,672,9563
16542,Grange,Sellick,gsellicke9@phoca.cz,Operator,3325,333,3658
16485,Monroe,Madsen,mmadsenea@hc360.com,Programmer Analyst II,8969,1540,10509
16689,Madalena,Haddow,mhaddoweb@reuters.com,Senior Sales Associate,7297,1289,8586
16450,Mitzi,Le Fevre,mlefevreed@craigslist.org,Internal Auditor,7782,1739,9521
16911,Karylin,Abbado,kabbadoef@archive.org,Sales Associate,8087,713,8800
16565,Dacy,Oxborrow,doxborroweh@hubpages.com,Developer II,1261,834,2095
16277,Gus,Haire,ghaireek@stumbleupon.com,Physical Therapy Assistant,9382,879,10261
16673,Staford,Loveday,slovedayel@lulu.com,Biostatistician II,3226,1845,5071
16743,Wally,Castilljo,wcastilljoem@cisco.com,Account Executive,6481,1270,7751
16773,Carleen,Hemphall,chemphallen@globo.com,Human Resources Assistant III,9738,1204,10942
16397,Emmott,Girardey,egirardeyep@google.de,Financial Advisor,4256,749,5005
16158,Wildon,Balsdone,wbalsdoneeq@hc360.com,Account Executive,7245,811,8056
16951,Cirilo,Hodgin,chodgines@opera.com,Assistant Professor,4950,810,5760
16768,Billie,Hedlestone,bhedlestoneet@jugem.jp,Developer IV,6669,350,7019
16971,Jdavie,Scowcraft,jscowcrafteu@cbsnews.com,Help Desk Operator,1363,1876,3239
16538,Grove,Greatorex,ggreatorexev@pen.io,Assistant Professor,8345,834,9179
16685,Serena,Sommerlin,ssommerlinex@whitehouse.gov,Actuary,1373,580,1953
16124,Della,Hubbert,dhubbertez@imgur.com,Senior Editor,7931,1584,9515
16243,Aviva,Kerin,akerinf0@npr.org,Engineer II,2303,1774,4077
16476,Sari,Phittiplace,sphittiplacef1@imageshack.us,Health Coach III,9407,549,9956
16624,Fianna,Jouanot,fjouanotf3@who.int,Web Designer IV,3806,1827,5633
16182,Cindi,O'Nion,conionf4@psu.edu,Business Systems Development Analyst,4810,1864,6674
16136,Milly,Purse,mpursef7@ifeng.com,Associate Professor,3964,483,4447
16238,Aguistin,Kobierzycki,akobierzyckif8@nyu.edu,Internal Auditor,9132,740,9872
16588,Jacinthe,Schwartz,jschwartzf9@123-reg.co.uk,Analyst Programmer,3706,366,4072
16632,Fran,Mcall,fmcallfc@newsvine.com,Data Coordiator,9495,390,9885
16803,Barth,McCaffery,bmccafferyff@narod.ru,Senior Financial Analyst,7866,968,8834
16553,Bobine,De Cristofalo,bdecristofalofh@stumbleupon.com,Database Administrator II,6349,881,7230
16636,Loutitia,Furness,lfurnessfk@timesonline.co.uk,Analog Circuit Design manager,1900,745,2645
16261,Catrina,Hardwicke,chardwickefo@goodreads.com,Nurse,1453,552,2005
16989,Oren,Stringman,ostringmanfs@tiny.cc,Registered Nurse,6884,1535,8419
16408,Ron,McVrone,rmcvronefx@reverbnation.com,Web Developer III,8759,561,9320
16330,Hastie,Kuschel,hkuschelg1@bravesites.com,Cost Accountant,2611,376,2987
16178,Nichols,McGaffey,nmcgaffeyg2@histats.com,Nurse Practicioner,8703,1073,9776
16110,Laurie,Risely,lriselyg3@amazon.co.uk,Senior Editor,6381,1864,8245
16224,Vitoria,Garbert,vgarbertg4@washingtonpost.com,GIS Technical Architect,6305,1612,7917
16812,Jacob,Cromarty,jcromartyg6@posterous.com,Programmer Analyst I,2402,935,3337
16648,Cornelle,Mangon,cmangong8@icq.com,Chemical Engineer,4325,328,4653
16779,Thadeus,Huston,thustong9@ed.gov,Information Systems Manager,3611,1565,5176
16364,Deidre,Tidcombe,dtidcombegc@imgur.com,Occupational Therapist,5471,1991,7462
16693,Noreen,Bruckenthal,nbruckenthalgd@toplist.cz,Business Systems Development Analyst,2831,396,3227
16889,Webb,Middleditch,wmiddleditchgf@nhs.uk,Software Test Engineer III,6174,1131,7305
16840,Esther,Parades,eparadesgg@usa.gov,Automation Specialist I,7481,956,8437
16090,Rubia,Bresnen,rbresnengh@privacy.gov.au,Nurse,2545,1925,4470
16887,Porty,Trasler,ptraslergi@illinois.edu,Marketing Manager,5311,733,6044
16714,Gleda,Matyushenko,gmatyushenkogj@surveymonkey.com,Nuclear Power Engineer,6289,546,6835
16618,Blinnie,Preddy,bpreddygl@yelp.com,Desktop Support Technician,4003,1189,5192
16697,Desiree,Tummasutti,dtummasuttigm@ucla.edu,Nurse Practicioner,6794,1222,8016
16964,Ninnette,John,njohngn@mlb.com,Account Coordinator,8214,315,8529
16828,Tuckie,Le Brun,tlebrungr@independent.co.uk,Research Associate,9324,1412,10736
16815,Eldridge,Glanz,eglanzgs@wikia.com,VP Accounting,7207,1821,9028
16826,Allistir,Littler,alittlergt@house.gov,Human Resources Assistant I,3071,1909,4980
16306,Pegeen,Size,psizegu@ihg.com,Marketing Manager,1294,1162,2456
16040,Andie,Colum,acolumgw@alexa.com,Computer Systems Analyst III,7697,493,8190
16705,Chandal,Cleal,cclealgx@dailymotion.com,Financial Analyst,4268,524,4792
16025,Ingra,Grimmer,igrimmergy@tmall.com,Human Resources Assistant IV,5728,1049,6777
16839,Zulema,Tudbald,ztudbaldh0@cafepress.com,Health Coach III,1541,1882,3423
16758,Lynnell,Lagden,llagdenh1@paypal.com,Accountant I,9995,1946,11941
16903,Gnni,Corish,gcorishh2@cargocollective.com,Sales Associate,8134,1627,9761
16467,Anson,Kealy,akealyh3@unblog.fr,Staff Scientist,3875,1604,5479
16343,Stu,Whitington,swhitingtonh4@dailymail.co.uk,Technical Writer,4600,1429,6029
16078,Marie-ann,Fotherby,mfotherbyh6@dailymotion.com,Nuclear Power Engineer,6176,1201,7377
16455,Gwendolyn,Rutley,grutleyh7@unc.edu,Assistant Manager,4349,741,5090
16004,Hobie,Hallifax,hhallifaxh9@dyndns.org,Desktop Support Technician,1365,801,2166
16192,Lammond,Rozzell,lrozzellha@imdb.com,Senior Financial Analyst,8274,498,8772
16765,Tallie,Dmitrievski,tdmitrievskihb@baidu.com,Staff Scientist,5542,727,6269
16424,Den,Taberner,dtabernerhd@rakuten.co.jp,Budget/Accounting Analyst II,8259,1959,10218
16222,Tonia,McMyler,tmcmylerhe@ca.gov,Staff Accountant I,3266,1001,4267
16187,Iorgos,Giraldon,igiraldonhf@weibo.com,Professor,3195,1660,4855
16309,Hildagarde,Antonik,hantonikhh@toplist.cz,Software Consultant,4941,1864,6805
16194,Korie,Worrall,kworrallhj@reddit.com,Senior Developer,7119,700,7819
16576,Camella,Keough,ckeoughhl@joomla.org,Financial Analyst,9746,1609,11355
16073,Kathryne,Rue,kruehp@godaddy.com,Staff Scientist,4419,1715,6134
16733,Claudio,Arnoult,carnoulthq@yellowbook.com,Administrative Assistant I,6709,570,7279
16407,Lorne,Colleck,lcolleckht@comcast.net,Assistant Professor,8166,1919,10085
16240,Fleurette,Burdas,fburdashu@msu.edu,Engineer III,1005,966,1971
16703,Anders,Brisseau,abrisseauhw@domainmarket.com,General Manager,9732,1706,11438
16353,Matteo,Ceeley,mceeleyhx@biblegateway.com,Account Representative II,6335,1337,7672
16280,Eduino,Kopf,ekopfhz@sohu.com,Clinical Specialist,6669,855,7524
16842,Julius,Vasentsov,jvasentsovi0@live.com,Administrative Officer,3884,511,4395
16761,Adriena,Pomphrett,apomphretti3@yahoo.com,Structural Analysis Engineer,3607,387,3994
16290,Jacinthe,Kennington,jkenningtonib@webeden.co.uk,Dental Hygienist,4747,454,5201
16950,Kirby,Bisseker,kbissekeric@redcross.org,Assistant Media Planner,6284,880,7164
16268,Bard,Heads,bheadsih@mashable.com,Systems Administrator IV,9396,1804,11200
16001,Malynda,Dobrowolski,mdobrowolskiii@noaa.gov,Health Coach I,3712,1594,5306
16532,Jaclyn,Brimble,jbrimbleik@shop-pro.jp,Analyst Programmer,4971,281,5252
16762,Jenelle,Berthot,jberthotil@ucla.edu,Director of Sales,1163,1528,2691
16385,Fidel,Screach,fscreachim@dot.gov,Software Consultant,6158,992,7150
16031,Heddi,Oneill,honeillin@ebay.com,Engineer IV,4851,681,5532
16904,Lemar,Caban,lcabanio@stumbleupon.com,VP Product Management,9948,978,10926
16755,Riva,Iacovone,riacovoneip@mediafire.com,Desktop Support Technician,1807,1946,3753
16563,Tedra,Hartzenberg,thartzenbergiq@tinypic.com,Quality Engineer,1312,354,1666
16879,Maybelle,Debow,mdebowir@si.edu,Actuary,6477,344,6821
16856,Issi,Ryton,irytonit@nbcnews.com,Software Consultant,2478,480,2958
16356,Zedekiah,Haughan,zhaughanix@phpbb.com,Chief Design Engineer,2953,831,3784
16987,Dee,Palk,dpalkj1@miibeian.gov.cn,Registered Nurse,1415,1329,2744
16535,Mariska,Mowbury,mmowburyj3@nyu.edu,Administrative Officer,5711,499,6210
16857,Charyl,O'Curran,cocurranj8@netlog.com,Nuclear Power Engineer,1873,205,2078
16474,Vivie,Spriggen,vspriggenj9@examiner.com,Senior Cost Accountant,2595,1484,4079
16457,Sander,Ribey,sribeyjb@51.la,Biostatistician I,2534,712,3246
16460,Janela,Redfern,jredfernjc@microsoft.com,Help Desk Technician,6493,1068,7561
16741,Zolly,Shewery,zsheweryjd@dell.com,GIS Technical Architect,7176,1684,8860
16006,Ingrim,Gensavage,igensavageje@google.co.jp,Structural Analysis Engineer,4694,1082,5776
16188,Blane,Hartwell,bhartwelljf@mediafire.com,Legal Assistant,8821,439,9260
16948,Brannon,Askham,baskhamjh@msn.com,VP Sales,8805,1398,10203
16061,Karlens,Lorentzen,klorentzenjj@intel.com,Professor,7618,1604,9222
16323,Lorilyn,Ollerhad,lollerhadjm@webs.com,Structural Analysis Engineer,6759,608,7367
16461,Darin,Mulqueen,dmulqueenjn@va.gov,Analog Circuit Design manager,1070,1583,2653
16981,Pace,Goly,pgolyjo@bbc.co.uk,Physical Therapy Assistant,6305,611,6916
16217,Ignacius,Gartland,igartlandjp@jiathis.com,Pharmacist,4257,1845,6102
16121,Andre,Cabane,acabanejq@ox.ac.uk,Operator,9244,1078,10322
16654,Ailey,Davydkov,adavydkovjr@ocn.ne.jp,Desktop Support Technician,8196,1153,9349
16663,Barbee,Gregori,bgregorijs@moonfruit.com,Nurse,3657,234,3891
16635,Munmro,Bachelar,mbachelarju@yandex.ru,Geological Engineer,2267,1610,3877
16095,Augustina,Wiggett,awiggettjy@yahoo.com,Nuclear Power Engineer,5221,1099,6320
16687,Addy,Griffen,agriffenjz@unesco.org,Data Coordiator,4614,1987,6601
16127,Deerdre,Asser,dasserk0@symantec.com,Sales Associate,4073,1286,5359
16517,Geralda,Linkie,glinkiek2@123-reg.co.uk,Human Resources Manager,9271,1910,11181
16068,Adelbert,Thaller,athallerk3@ucoz.com,Staff Accountant II,8302,1054,9356
16674,Munmro,Vanni,mvannik4@hao123.com,Account Coordinator,8408,486,8894
16822,Tamera,Fawlks,tfawlksk6@unesco.org,Financial Analyst,8555,687,9242
16790,Nydia,Baudassi,nbaudassikh@imgur.com,Senior Cost Accountant,7356,412,7768
16020,Karolina,Boch,kbochkj@auda.org.au,Design Engineer,1265,1115,2380
16570,Ivar,Croose,icroosekn@cbc.ca,Research Associate,7758,550,8308
16044,Poppy,Swarbrick,pswarbrickkp@multiply.com,Budget/Accounting Analyst III,1814,403,2217
16411,Raf,Ferrino,rferrinokq@multiply.com,Junior Executive,4333,1340,5673
16937,Jorrie,Roxbee,jroxbeekt@java.com,Geological Engineer,2327,921,3248
16209,Park,Comelini,pcomelinikw@yahoo.co.jp,Computer Systems Analyst I,6922,222,7144
16348,Giavani,Bootyman,gbootymankx@arizona.edu,Recruiting Manager,9888,725,10613
16225,Shalna,Cossar,scossarl0@army.mil,Software Consultant,1874,204,2078
16016,Neel,Toope,ntoopel3@1und1.de,Design Engineer,1095,1062,2157
16922,Janos,Wealthall,jwealthalll5@yandex.ru,Financial Analyst,3025,909,3934
16638,Cameron,Habin,chabinl7@cocolog-nifty.com,Programmer Analyst II,2003,981,2984
16767,Nollie,Vannikov,nvannikovl9@pinterest.com,Legal Assistant,5253,1741,6994
16056,Salomo,Jerzak,sjerzakla@altervista.org,Account Coordinator,7468,712,8180
16172,Reinaldos,Dangerfield,rdangerfieldlc@ftc.gov,Analyst Programmer,1670,297,1967
16432,Franny,Clipston,fclipstonld@github.io,Associate Professor,6104,1228,7332
16478,Charlot,Laffin,claffinle@abc.net.au,Senior Quality Engineer,7835,1378,9213
16934,Reinhard,Chippindall,rchippindalllf@livejournal.com,Structural Engineer,7061,1674,8735
16029,Suzanna,Jakab,sjakablq@geocities.jp,Software Engineer I,8151,323,8474
16135,Harmonia,Egarr,hegarrls@angelfire.com,Civil Engineer,2629,1362,3991
16865,Almire,Bowich,abowichlu@usgs.gov,Nurse,4910,1527,6437
16957,Melanie,Cupper,mcupperlw@sakura.ne.jp,Electrical Engineer,8355,720,9075
16671,Carmen,Maytom,cmaytomlx@cmu.edu,Chief Design Engineer,5096,356,5452
16719,Tamas,Rosenfrucht,trosenfruchtm3@biblegateway.com,Quality Engineer,2570,1305,3875
16696,Stephen,Scallon,sscallonm6@wikispaces.com,Assistant Manager,9983,1504,11487
16112,Javier,Boggas,jboggasm9@abc.net.au,Actuary,2722,1778,4500
16945,Allyn,Siuda,asiudamb@a8.net,Financial Analyst,5080,1779,6859
16599,Veronica,Bemrose,vbemrosemc@surveymonkey.com,Help Desk Technician,7373,1072,8445
16030,Allard,Burras,aburrasme@webeden.co.uk,Help Desk Technician,9220,920,10140
16274,Thain,Feldberger,tfeldbergermf@noaa.gov,Senior Cost Accountant,2596,1336,3932
16782,Ileana,Perrington,iperringtonmh@parallels.com,Account Executive,9348,559,9907
16613,Ludwig,Housley,lhousleymm@xinhuanet.com,VP Sales,4411,1164,5575
16156,Bryce,Blyden,bblydenmp@mapy.cz,Actuary,8978,1262,10240
16783,Vickie,Fearnill,vfearnillmq@zdnet.com,Analog Circuit Design manager,5938,1064,7002
16032,Kattie,Scalia,kscaliams@comcast.net,Recruiting Manager,5312,863,6175
16301,Meghann,Novis,mnovismt@alexa.com,Office Assistant II,3290,1568,4858
16655,Cazzie,Allport,callportmz@cloudflare.com,Senior Financial Analyst,5045,907,5952
16791,Keelia,Dugood,kdugoodn0@cpanel.net,Account Executive,1712,803,2515
16170,Sybilla,Molyneux,smolyneuxn4@domainmarket.com,Director of Sales,6209,1552,7761
16446,Francesco,Gilson,fgilsonn6@ocn.ne.jp,Marketing Assistant,6676,971,7647
16519,Pail,Kitcher,pkitchern8@1688.com,Food Chemist,3537,1280,4817
16335,Curry,Strewthers,cstrewthersna@earthlink.net,Recruiter,4246,478,4724
16122,Kent,Blackman,kblackmannc@scientificamerican.com,Database Administrator II,6697,1339,8036
16999,Faydra,Ainge,faingend@twitter.com,VP Marketing,4156,1544,5700
16100,Mathias,Reville,mrevillenf@usgs.gov,Tax Accountant,2283,957,3240
16398,Georg,Blazhevich,gblazhevichng@paypal.com,Actuary,9667,1136,10803
16191,Selig,Tuttle,stuttlenh@skyrock.com,Physical Therapy Assistant,1407,511,1918
16706,Sela,Hyndman,shyndmanni@squarespace.com,Structural Analysis Engineer,9717,1875,11592
16665,Carline,Cordero,ccorderonj@si.edu,Compensation Analyst,6739,1086,7825
16057,Felipa,Beazer,fbeazernl@chicagotribune.com,Internal Auditor,1806,1007,2813
16069,Rich,Jagielski,rjagielskinn@wiley.com,Cost Accountant,7085,1630,8715
16505,Udale,Goulborne,ugoulbornenp@theguardian.com,Marketing Assistant,3111,1616,4727
16809,Tracy,Futcher,tfutchernq@trellian.com,Product Engineer,7777,334,8111
16955,Jakie,Ullyott,jullyottnr@google.com.au,Automation Specialist IV,2413,1605,4018
16269,Dill,Goghin,dgoghinnu@free.fr,VP Sales,5397,618,6015
16735,Francine,Cooke,fcookenx@baidu.com,Recruiting Manager,4287,1624,5911
16683,Bertram,Sarjent,bsarjentny@zdnet.com,Cost Accountant,8215,1919,10134
16111,Ferdinande,Campsall,fcampsallnz@stanford.edu,Administrative Officer,2839,729,3568
16818,Gamaliel,Keyhoe,gkeyhoeo1@unicef.org,Administrative Assistant II,4245,1400,5645
16405,Nollie,Renton,nrentono2@altervista.org,Office Assistant III,9560,1044,10604
16602,Elsi,Sign,esigno4@sitemeter.com,Help Desk Operator,2420,921,3341
16678,Gerri,D'Hooge,gdhoogeo5@dmoz.org,Assistant Professor,6724,1177,7901
16120,Renee,Hefforde,rheffordeo6@amazon.co.uk,Human Resources Assistant II,5638,1496,7134
16513,Sukey,Ganforthe,sganfortheo7@discovery.com,Dental Hygienist,5648,1629,7277
16075,Aylmar,Petteford,apettefordo9@pcworld.com,Graphic Designer,9403,673,10076
16722,Brittani,Coniam,bconiamoa@ted.com,Human Resources Assistant II,3308,1973,5281
16098,Monroe,Berling,mberlingob@w3.org,General Manager,6563,387,6950
16366,Riki,Temprell,rtemprelloc@cbsnews.com,Account Representative II,6663,888,7551
16052,Horst,Priditt,hpridittod@nsw.gov.au,Research Assistant III,2034,1575,3609
16838,Butch,Bonwell,bbonwelloi@china.com.cn,Social Worker,9831,1804,11635
16737,Donielle,Crabb,dcrabboj@oracle.com,Senior Cost Accountant,7232,700,7932
16017,Casie,Scattergood,cscattergoodon@instagram.com,Paralegal,7151,1240,8391
16283,Raimundo,Schwieso,rschwiesoop@theglobeandmail.com,VP Quality Control,1251,1175,2426
16688,Eunice,Vaadeland,evaadelandos@cafepress.com,Desktop Support Technician,9189,1714,10903
16160,Prent,Von Helmholtz,pvonhelmholtzou@etsy.com,Software Test Engineer III,2698,327,3025
16043,Sheelagh,Barhem,sbarhemoy@meetup.com,Account Executive,4596,851,5447
16116,Suzy,Kimberly,skimberlyoz@hc360.com,Operator,2684,1523,4207
16601,Felicio,Trunchion,ftrunchionp0@livejournal.com,Developer III,8591,536,9127
16793,Isaak,Liggins,iligginsp4@mlb.com,Chemical Engineer,4961,849,5810
16799,Nike,Daspar,ndasparp5@naver.com,Senior Editor,8580,890,9470
16125,Alexander,Restorick,arestorickp7@flickr.com,Sales Representative,6683,957,7640
16884,Khalil,Trengove,ktrengovep9@tinyurl.com,Cost Accountant,8523,773,9296
16175,Rhys,Dorset,rdorsetpa@prweb.com,Clinical Specialist,1601,338,1939
16490,Padraig,Kneal,pknealpd@ning.com,Administrative Officer,1489,1273,2762
16270,Renault,Clemens,rclemensph@prweb.com,Media Manager IV,2157,1593,3750
16484,Rayner,Bezemer,rbezemerpl@amazon.com,Safety Technician IV,1724,1804,3528
16819,Belia,Symson,bsymsonpp@sourceforge.net,Biostatistician IV,4519,1941,6460
16573,Randi,Cordova,rcordovapr@xing.com,Geological Engineer,1412,1712,3124
16453,Myron,Feely,mfeelyps@vkontakte.ru,Information Systems Manager,6963,1619,8582
16898,Hurlee,Gladdolph,hgladdolphpt@scientificamerican.com,Environmental Tech,4161,800,4961
16396,Rachael,Coiley,rcoileypu@xrea.com,Junior Executive,4288,465,4753
16422,Terza,Sancroft,tsancroftpz@angelfire.com,Accountant IV,6027,1511,7538
16603,Hort,Armall,harmallq1@nytimes.com,Social Worker,2031,592,2623
16011,Eadie,Fritz,efritzq3@mit.edu,Research Associate,9875,1750,11625
16928,Babb,Brotheridge,bbrotheridgeq6@jugem.jp,Human Resources Manager,6026,1539,7565
16558,Margarette,Digges,mdiggesq7@is.gd,Senior Quality Engineer,9370,1642,11012
16508,Roz,Scotfurth,rscotfurthq8@umich.edu,Pharmacist,6072,1619,7691
16548,Elmore,Palser,epalserqa@mashable.com,Human Resources Assistant I,6316,1536,7852
16584,Kathie,Woodwing,kwoodwingqc@imdb.com,Desktop Support Technician,4692,498,5190
16207,Asia,Ostrich,aostrichqd@google.ru,Quality Control Specialist,4144,1698,5842
16456,Levy,Stopford,lstopfordqh@mysql.com,Health Coach III,9776,1217,10993
16205,Marilee,Garstang,mgarstangqi@marriott.com,Nuclear Power Engineer,9477,442,9919
16196,Horst,Briscow,hbriscowqk@delicious.com,Analyst Programmer,3648,546,4194
16042,Conny,Chisman,cchismanql@apple.com,Senior Financial Analyst,5687,1445,7132
16284,Elspeth,Fortye,efortyeqm@linkedin.com,Compensation Analyst,6557,1319,7876
16070,Vincenz,Colles,vcollesqq@arstechnica.com,Accountant II,9103,1999,11102
16140,Isabelita,Langridge,ilangridgeqt@google.it,Biostatistician III,5016,1062,6078
16310,Ricky,Payze,rpayzequ@oracle.com,Senior Sales Associate,1927,1344,3271
16167,Hamid,Eckly,hecklyr1@privacy.gov.au,Chemical Engineer,9262,1655,10917
16227,Douglas,Kaesmans,dkaesmansr4@example.com,Sales Representative,1275,1340,2615
16894,Imogene,Olenichev,iolenichevr9@1688.com,Marketing Manager,5574,1205,6779
16214,Muire,Haslam,mhaslamrb@fema.gov,Nuclear Power Engineer,6710,1849,8559
16387,Perice,Lakin,plakinrf@bing.com,Senior Financial Analyst,8797,330,9127
16417,Shannen,O'Cannon,socannonrg@ustream.tv,Desktop Support Technician,2491,493,2984
16426,Nelly,Marjoram,nmarjoramrk@boston.com,Mechanical Systems Engineer,2093,248,2341
16320,Jedd,Harrowsmith,jharrowsmithrn@creativecommons.org,Geological Engineer,2663,549,3212
18001,Tiphany,Bushen,tbushen0@jalbum.net,Junior Executive,1382,1661,3043
18000,Roze,Woodsford,rwoodsford2@engadget.com,Programmer III,2307,1184,3491
18269,Annadiana,Slevin,aslevin0@eventbrite.com,Senior Quality Engineer,5417,1673,7090
18096,Quint,Al Hirsi,qalhirsi1@theatlantic.com,VP Marketing,8316,1631,9947
18219,Tiffani,Phillp,tphillp2@amazon.de,Human Resources Assistant I,3804,651,4455
18208,Eveline,Feavers,efeavers3@independent.co.uk,Structural Analysis Engineer,4548,1365,5913
18301,Jeanie,Catherall,jcatherall4@rambler.ru,Civil Engineer,2300,1883,4183
18605,Monro,Harvie,mharvie5@booking.com,Librarian,6354,1783,8137
18858,Gunner,Fletcher,gfletcher6@mac.com,Safety Technician II,3447,938,4385
18272,Hettie,Hambright,hhambright7@wiley.com,Web Designer I,2273,267,2540
18348,Jenica,Mainston,jmainston8@smugmug.com,Accountant II,5017,1214,6231
18568,Meris,Pittman,mpittman9@4shared.com,Research Nurse,9135,1716,10851
18168,Paulette,Daoust,pdaousta@ow.ly,Developer II,4063,1572,5635
18073,Yuri,Gardener,ygardenerb@bravesites.com,Desktop Support Technician,4601,686,5287
18042,Tuesday,Maiden,tmaidenc@behance.net,Help Desk Technician,6277,857,7134
18447,Nikola,Phethean,nphetheand@reuters.com,Civil Engineer,5425,1930,7355
18295,Ulla,Matas,umatase@digg.com,Statistician I,9877,848,10725
18917,Wadsworth,Roydon,wroydonf@unblog.fr,Systems Administrator III,6899,581,7480
18727,Odey,Avrahamy,oavrahamyg@pcworld.com,VP Quality Control,7570,1760,9330
18406,Elbertine,Darley,edarleyh@cdbaby.com,Community Outreach Specialist,3796,997,4793
18970,Bridget,Poynter,bpoynteri@php.net,Occupational Therapist,8694,1136,9830
18104,Jefferson,Boyet,jboyetj@purevolume.com,Graphic Designer,1779,669,2448
18982,Billy,Retchford,bretchfordk@xing.com,Geological Engineer,4215,1487,5702
18661,Astra,Roisen,aroisenl@github.com,Paralegal,9546,726,10272
18963,Gaelan,Culkin,gculkinm@sakura.ne.jp,Office Assistant II,4730,948,5678
18979,Mariellen,Tellenbrook,mtellenbrookn@hao123.com,Engineer IV,5173,1609,6782
18954,Barbara-anne,Bellson,bbellsono@va.gov,VP Product Management,2195,1142,3337
18901,Parry,Baugham,pbaughamp@discuz.net,Marketing Assistant,9203,1271,10474
18781,Doralin,Carratt,dcarrattq@reference.com,Staff Scientist,7811,1006,8817
18522,Kipp,Mathison,kmathisonr@toplist.cz,Chemical Engineer,2171,1080,3251
18878,Rogers,Wortman,rwortmans@pinterest.com,Financial Analyst,3681,253,3934
18370,Jorry,Habden,jhabdent@mozilla.org,Cost Accountant,8209,856,9065
18666,Catha,Fearey,cfeareyv@cpanel.net,Financial Advisor,4030,1606,5636
18438,Elmo,Cratchley,ecratchleyw@so-net.ne.jp,Payment Adjustment Coordinator,7841,655,8496
18534,Johna,Farries,jfarriesx@t-online.de,Desktop Support Technician,3394,1827,5221
18554,Kipper,Bridat,kbridaty@redcross.org,Data Coordiator,4029,1071,5100
18498,Haven,Yearron,hyearronz@hubpages.com,Senior Sales Associate,4279,439,4718
18826,Marlee,Lemarie,mlemarie10@alibaba.com,Software Consultant,8881,410,9291
18880,Gabie,Callaby,gcallaby11@cmu.edu,VP Accounting,6842,561,7403
18772,Enrica,Mayte,emayte12@cmu.edu,Sales Representative,2626,1591,4217
18796,Bartram,Barents,bbarents13@shinystat.com,Desktop Support Technician,6207,1215,7422
18409,Berti,Aspinall,baspinall14@arizona.edu,Database Administrator II,7781,416,8197
18196,Tybie,Kase,tkase15@ustream.tv,Analog Circuit Design manager,2299,1023,3322
18383,Sal,Mosdill,smosdill16@cpanel.net,Research Nurse,6700,1146,7846
18846,Elsie,Reynoldson,ereynoldson17@utexas.edu,Physical Therapy Assistant,2984,1291,4275
18012,Nedi,De Pietri,ndepietri18@dailymail.co.uk,Marketing Manager,7161,1705,8866
18949,Gwyn,Bouttell,gbouttell19@yelp.com,Account Representative III,5369,525,5894
18261,Carl,Serrels,cserrels1a@ow.ly,Human Resources Manager,5955,1300,7255
18157,Lorelle,Borrowman,lborrowman1b@friendfeed.com,Research Nurse,9762,1045,10807
18538,Page,Persitt,ppersitt1c@google.co.jp,Statistician IV,2706,1039,3745
18647,Lynnett,Petrasch,lpetrasch1d@themeforest.net,Editor,8390,1777,10167
18069,Reginald,Walstow,rwalstow1e@geocities.com,Librarian,7763,1360,9123
18392,Garnette,Lantaph,glantaph1f@icq.com,Financial Advisor,8119,1639,9758
18680,Carlotta,Romanski,cromanski1g@illinois.edu,Project Manager,4903,889,5792
18740,Virgie,Carnegie,vcarnegie1h@vkontakte.ru,Clinical Specialist,1562,1479,3041
18909,Noach,Hammer,nhammer1i@pen.io,Speech Pathologist,4222,1224,5446
18586,Becky,McGennis,bmcgennis1j@google.ca,Marketing Manager,6184,1027,7211
18508,Putnam,Martindale,pmartindale1k@nba.com,Social Worker,9843,1710,11553
18892,Linell,Takis,ltakis1l@histats.com,VP Marketing,8309,1609,9918
18719,Wendi,Pinilla,wpinilla1m@timesonline.co.uk,Systems Administrator III,8920,670,9590
18808,Elie,MacGraith,emacgraith1n@fastcompany.com,Tax Accountant,8126,1910,10036
18519,Tani,Docwra,tdocwra1o@plala.or.jp,Human Resources Manager,7317,603,7920
18825,Ruddy,Nussgen,rnussgen1p@google.co.jp,Mechanical Systems Engineer,8686,1161,9847
18131,Tye,Martonfi,tmartonfi1q@amazon.co.uk,Quality Engineer,8059,871,8930
18537,Bab,Mathivat,bmathivat1r@bigcartel.com,Geologist IV,4511,385,4896
18355,Brantley,Sturt,bsturt1s@webnode.com,Data Coordiator,8924,1184,10108
18071,Dwight,Patzelt,dpatzelt1t@desdev.cn,Structural Engineer,8112,1814,9926
18699,Dal,Jellings,djellings1u@people.com.cn,Paralegal,4216,982,5198
18195,Wendall,Colvine,wcolvine1w@tripod.com,VP Product Management,8182,913,9095
18753,Cicely,Dohrmann,cdohrmann1x@dropbox.com,Help Desk Technician,3481,841,4322
18840,Golda,Giggs,ggiggs1y@wikia.com,Statistician IV,5892,1273,7165
18065,Alyda,Shatliff,ashatliff1z@berkeley.edu,Legal Assistant,1284,1710,2994
18567,Rolando,Bretland,rbretland21@eepurl.com,Senior Quality Engineer,6377,997,7374
18376,Isacco,Tibbles,itibbles22@yahoo.com,Safety Technician II,5298,1695,6993
18211,Merrielle,Llewellin,mllewellin23@techcrunch.com,Internal Auditor,2022,616,2638
18139,Hewitt,Soutter,hsoutter24@tripod.com,Human Resources Assistant III,1743,600,2343
18107,Nanete,Rospars,nrospars25@51.la,GIS Technical Architect,6677,568,7245
18457,Andra,Colclough,acolclough27@cdc.gov,Database Administrator II,5351,1460,6811
18407,Corly,Cliff,ccliff28@addtoany.com,Senior Quality Engineer,2794,976,3770
18549,Clayson,Jeary,cjeary29@godaddy.com,Developer I,6089,250,6339
18723,Willy,Skeete,wskeete2a@tinypic.com,Administrative Officer,1460,617,2077
18662,Crista,Aleixo,caleixo2c@zdnet.com,Senior Quality Engineer,9602,467,10069
18767,Matthus,Izakov,mizakov2d@taobao.com,Desktop Support Technician,2798,403,3201
18928,Stanislaw,Farnsworth,sfarnsworth2e@nba.com,Account Executive,3749,393,4142
18217,Raviv,Atrill,ratrill2f@hud.gov,Assistant Media Planner,3621,1032,4653
18811,Monique,Defty,mdefty2g@stumbleupon.com,Data Coordiator,3587,1734,5321
18748,Nataline,Meharry,nmeharry2i@ca.gov,Food Chemist,3240,1481,4721
18883,Davey,Winterbottom,dwinterbottom2j@hostgator.com,Administrative Officer,1654,1239,2893
18777,Vina,Smeaton,vsmeaton2k@yahoo.co.jp,Technical Writer,7818,1709,9527
18507,Maible,Winterscale,mwinterscale2m@sciencedirect.com,Accountant I,2633,1670,4303
18923,Karel,Tzuker,ktzuker2n@moonfruit.com,Account Executive,7786,1624,9410
18423,Pippy,Rundall,prundall2o@slate.com,Health Coach I,4337,693,5030
18784,Edwin,Kenningley,ekenningley2p@exblog.jp,Senior Editor,7468,1248,8716
18332,Ermina,Cron,ecron2q@marriott.com,Biostatistician IV,7564,772,8336
18725,Darice,Albutt,dalbutt2r@xrea.com,Web Developer II,4508,941,5449
18425,Ludvig,Dillicate,ldillicate2s@irs.gov,Dental Hygienist,7466,215,7681
18900,Andres,Aitchison,aaitchison2t@typepad.com,Senior Quality Engineer,7192,1861,9053
18007,Kerr,Verbrugghen,kverbrugghen2u@posterous.com,Account Representative IV,6250,636,6886
18475,Remington,Palmer,rpalmer2v@a8.net,Computer Systems Analyst IV,6321,258,6579
18287,Ashley,Gretton,agretton2w@goo.ne.jp,Design Engineer,4989,635,5624
18459,Arlyne,O'Neill,aoneill2x@harvard.edu,Administrative Assistant IV,3737,1849,5586
18716,Sephira,Purver,spurver2y@weather.com,Food Chemist,5541,1975,7516
18646,Tymon,Winnard,twinnard2z@si.edu,Research Nurse,7317,312,7629
18931,Inesita,Dorton,idorton30@vk.com,Human Resources Manager,2477,1072,3549
18047,Shayla,Willmott,swillmott32@booking.com,Financial Analyst,5899,1524,7423
18986,Stern,Heaford,sheaford33@ehow.com,Automation Specialist II,8942,1607,10549
18391,Chaim,Charity,ccharity34@marriott.com,Pharmacist,7297,1461,8758
18958,Robby,Pechard,rpechard36@army.mil,Senior Cost Accountant,2012,1900,3912
18415,Sophia,Jellard,sjellard37@de.vu,Actuary,9014,1575,10589
18835,Julieta,Toner,jtoner38@wired.com,Assistant Media Planner,8397,1679,10076
18222,Karry,Catherine,kcatherine3a@skyrock.com,VP Product Management,4135,698,4833
18239,Antonietta,Janoschek,ajanoschek3b@weebly.com,Marketing Assistant,1806,1649,3455
18003,Thebault,Goldfinch,tgoldfinch3c@creativecommons.org,Web Designer I,1209,1266,2475
18594,Cherilyn,Shovelbottom,cshovelbottom3d@acquirethisname.com,Budget/Accounting Analyst IV,7986,1300,9286
18277,Trista,Lahy,tlahy3f@dmoz.org,Account Coordinator,4970,863,5833
18094,Brigida,Osorio,bosorio3g@shop-pro.jp,Senior Quality Engineer,8904,1949,10853
18701,Quinton,Burchett,qburchett3h@sun.com,Accountant I,2775,647,3422
18890,Danila,Aylesbury,daylesbury3i@technorati.com,Project Manager,7302,1512,8814
18766,Hatti,Szapiro,hszapiro3j@usnews.com,Assistant Manager,3766,867,4633
18265,Dorthea,Soppitt,dsoppitt3k@smugmug.com,Accounting Assistant II,1344,1592,2936
18760,Lonnie,Hurles,lhurles3l@netscape.com,Financial Advisor,3501,676,4177
18980,Jaclin,Waters,jwaters3o@tamu.edu,Office Assistant I,3640,1690,5330
18761,Melvin,Filochov,mfilochov3p@cbsnews.com,Programmer Analyst II,3595,586,4181
18738,Weider,Streatfeild,wstreatfeild3q@elpais.com,Marketing Manager,6386,818,7204
18146,Avigdor,McCarlie,amccarlie3r@ameblo.jp,Help Desk Technician,3304,222,3526
18860,Crista,Showen,cshowen3s@wisc.edu,Accountant III,3384,1511,4895
18663,Kerr,Sellers,ksellers3u@woothemes.com,Assistant Manager,7256,1136,8392
18820,Benedikta,Pankhurst.,bpankhurst3w@spiegel.de,Software Engineer II,5490,862,6352
18174,Clemence,MacLardie,cmaclardie3x@prnewswire.com,VP Marketing,8282,1347,9629
18905,Elwyn,Gibbs,egibbs3y@networksolutions.com,Automation Specialist II,4639,927,5566
18791,Lolita,Tollemache,ltollemache3z@who.int,Help Desk Operator,8642,1148,9790
18543,Reinaldo,Crowson,rcrowson40@google.cn,Graphic Designer,6782,1190,7972
18965,Dukey,Yitshak,dyitshak41@hhs.gov,Account Coordinator,5778,1815,7593
18397,Darb,Spalls,dspalls42@ca.gov,Occupational Therapist,1426,1141,2567
18863,Petrina,Leathwood,pleathwood43@purevolume.com,Community Outreach Specialist,8251,1934,10185
18034,Christan,Crickmore,ccrickmore44@indiegogo.com,VP Sales,9506,1876,11382
18488,Elna,Gurney,egurney45@g.co,Clinical Specialist,8525,1382,9907
18773,Tommie,Trenholm,ttrenholm46@ucoz.ru,Safety Technician II,8992,1473,10465
18300,Merry,Clavering,mclavering47@cocolog-nifty.com,Structural Engineer,1662,797,2459
19000,Virgie,Lainge,vlainge48@disqus.com,Tax Accountant,2155,712,2867
18461,Orelle,Abotson,oabotson49@a8.net,VP Quality Control,7642,1307,8949
18484,Graehme,Hardacre,ghardacre4a@cdc.gov,Structural Analysis Engineer,1876,248,2124
18516,Myer,Steinham,msteinham4c@w3.org,Biostatistician IV,6596,1344,7940
18482,Bogart,Demead,bdemead4d@miitbeian.gov.cn,VP Marketing,2452,1079,3531
18417,Kimberly,Ruby,kruby4e@answers.com,GIS Technical Architect,7782,1098,8880
18365,Montague,Pride,mpride4f@google.de,Senior Developer,5667,1395,7062
18446,Moritz,Milner,mmilner4h@usatoday.com,Assistant Professor,4078,1719,5797
18354,Amalia,Marton,amarton4i@hud.gov,Information Systems Manager,3200,995,4195
18953,Clyve,Mallard,cmallard4j@paypal.com,Operator,9306,1465,10771
18282,Isabelle,Mylechreest,imylechreest4l@uol.com.br,Programmer Analyst IV,9101,1441,10542
18193,Josepha,Baldassi,jbaldassi4m@reference.com,Senior Editor,5466,855,6321
18728,Damon,Boncoeur,dboncoeur4n@samsung.com,Assistant Media Planner,3707,788,4495
18169,Eugine,Mallall,emallall4o@wikispaces.com,Recruiter,2749,233,2982
18642,Pearla,Varndall,pvarndall4p@yandex.ru,Automation Specialist IV,5214,1506,6720
18770,Pattie,Raycroft,praycroft4r@twitter.com,Nurse,4102,276,4378
18242,Hakim,Petrovsky,hpetrovsky4s@go.com,Occupational Therapist,1187,791,1978
18268,Connie,Gransden,cgransden4u@jiathis.com,Analyst Programmer,5729,852,6581
18733,Kristofer,Bentke,kbentke4v@ft.com,Junior Executive,7996,326,8322
18360,Marlon,Scoterbosh,mscoterbosh4w@yale.edu,Physical Therapy Assistant,1206,1191,2397
18555,Marsha,Yeabsley,myeabsley4x@cnbc.com,Sales Representative,4781,244,5025
18313,Faunie,Gradon,fgradon4y@linkedin.com,Senior Cost Accountant,3533,797,4330
18983,Jacky,Chotty,jchotty4z@nbcnews.com,Assistant Media Planner,8484,1575,10059
18581,Leslie,Fumagall,lfumagall50@shutterfly.com,Internal Auditor,6554,941,7495
18253,Saleem,Golton,sgolton54@jigsy.com,Quality Control Specialist,2028,1896,3924
18329,Julissa,Cowsby,jcowsby57@cargocollective.com,Marketing Manager,1991,708,2699
18465,Zachary,Jenkinson,zjenkinson58@devhub.com,Senior Cost Accountant,2182,253,2435
18523,Adler,Blancowe,ablancowe5a@cpanel.net,Budget/Accounting Analyst II,4614,1669,6283
18836,Clara,Chomicz,cchomicz5b@utexas.edu,Software Test Engineer IV,2738,1886,4624
18373,Lisha,Hanmer,lhanmer5c@sfgate.com,Account Representative III,3597,1457,5054
18632,Felicia,Doles,fdoles5d@berkeley.edu,Marketing Assistant,1970,923,2893
18241,Adolph,Marryatt,amarryatt5e@google.pl,Director of Sales,1361,561,1922
18924,Rhea,Westnage,rwestnage5g@networkadvertising.org,Senior Editor,8505,709,9214
18945,Kaiser,Brimblecombe,kbrimblecombe5h@booking.com,Mechanical Systems Engineer,8726,397,9123
18421,Flynn,Bodimeade,fbodimeade5i@discovery.com,Chemical Engineer,5449,1726,7175
18132,Gusty,Duquesnay,gduquesnay5j@cdbaby.com,Biostatistician II,6649,1943,8592
18234,Desirae,Poleykett,dpoleykett5k@edublogs.org,Actuary,2098,1455,3553
18260,Pet,Luis,pluis5l@usnews.com,Food Chemist,3570,780,4350
18624,Lotty,Mosedall,lmosedall5m@symantec.com,Assistant Professor,1630,1079,2709
18504,Van,Grebert,vgrebert5n@mysql.com,Safety Technician III,4381,984,5365
18735,Jacenta,Boles,jboles5p@joomla.org,VP Quality Control,8670,1409,10079
18531,Sella,Hulland,shulland5q@imgur.com,Administrative Assistant IV,5181,1509,6690
18864,Othilia,Izakov,oizakov5r@scribd.com,Web Developer I,4837,1542,6379
18682,Latisha,Lazar,llazar5s@ustream.tv,Chief Design Engineer,9018,1030,10048
18099,Ethan,Greson,egreson5t@bloglines.com,Administrative Assistant I,4391,1720,6111
18053,Hildagarde,Genthner,hgenthner5u@mediafire.com,Operator,3635,1061,4696
18702,Domenic,Camock,dcamock5w@prnewswire.com,Health Coach III,7014,1542,8556
18424,Creight,Bowland,cbowland5x@indiegogo.com,Nuclear Power Engineer,2179,1560,3739
18564,Kasper,Fisher,kfisher5y@webeden.co.uk,Help Desk Operator,3214,599,3813
18972,Willy,Lorente,wlorente61@yelp.com,Account Representative III,8156,1075,9231
18903,Clayson,Feronet,cferonet63@linkedin.com,Senior Developer,2007,1585,3592
18695,Hurleigh,Tedder,htedder64@guardian.co.uk,Account Executive,8549,1035,9584
18434,Gerick,Crevy,gcrevy65@google.com.hk,Registered Nurse,1861,283,2144
18550,Eugenia,Rickardes,erickardes6a@usa.gov,Actuary,9555,878,10433
18223,Nicholas,Pardie,npardie6b@cdc.gov,Structural Analysis Engineer,7435,582,8017
18822,Heda,Renshaw,hrenshaw6c@tuttocitta.it,Graphic Designer,6467,430,6897
18150,Celinda,Budnik,cbudnik6e@senate.gov,Recruiting Manager,6325,296,6621
18149,Biddy,Withers,bwithers6f@google.de,Junior Executive,8878,483,9361
18533,Georgiana,Haddon,ghaddon6g@dion.ne.jp,Media Manager IV,3464,912,4376
18854,Mamie,Mayoral,mmayoral6h@tuttocitta.it,Social Worker,5027,1034,6061
18122,Belva,Follit,bfollit6i@ftc.gov,Engineer II,7520,211,7731
18708,Phedra,Scrivens,pscrivens6j@angelfire.com,Environmental Specialist,5357,687,6044
18247,Milissent,Tilling,mtilling6k@google.pl,Editor,6008,386,6394
18990,Boycey,Haugh,bhaugh6l@e-recht24.de,Legal Assistant,8312,1898,10210
18908,Tabbie,Revey,trevey6m@ed.gov,Actuary,8590,1656,10246
18035,Lionel,Yakunchikov,lyakunchikov6n@elpais.com,Senior Sales Associate,8892,1090,9982
18279,Whitney,Beasant,wbeasant6o@google.nl,VP Marketing,3540,691,4231
18387,Sidonnie,Burd,sburd6p@livejournal.com,Help Desk Technician,9601,463,10064
18137,Christophorus,Schooling,cschooling6r@g.co,Senior Sales Associate,2280,955,3235
18018,Tibold,Cosham,tcosham6s@nasa.gov,Editor,3125,1096,4221
18203,Maxy,Larratt,mlarratt6t@slate.com,Professor,7135,827,7962
18677,Nevile,Blodgetts,nblodgetts6v@webmd.com,Chief Design Engineer,3714,597,4311
18960,Mada,Kempston,mkempston6w@admin.ch,Accounting Assistant II,2540,501,3041
18818,Dulsea,Derrick,dderrick6x@yolasite.com,VP Accounting,5623,1437,7060
18939,Perri,Lindegard,plindegard70@wsj.com,Dental Hygienist,8288,1214,9502
18494,Christie,Edmund,cedmund71@wix.com,Recruiting Manager,5629,1065,6694
18428,Florrie,Dwelling,fdwelling72@deviantart.com,Nurse Practicioner,8966,262,9228
18812,Genia,Lehrmann,glehrmann73@odnoklassniki.ru,Editor,2781,1764,4545
18736,Jessamyn,Jaqueminet,jjaqueminet74@businesswire.com,Geologist IV,7087,1218,8305
18698,Arther,Sumpter,asumpter75@weather.com,Teacher,7679,815,8494
18776,Karalynn,Frunks,kfrunks76@360.cn,Community Outreach Specialist,7456,1299,8755
18091,Daffie,Penticost,dpenticost77@npr.org,Staff Accountant III,6469,1222,7691
18041,Orelia,Olliar,oolliar78@amazon.de,Marketing Assistant,9948,580,10528
18483,Suzi,Bloxam,sbloxam79@unc.edu,Staff Scientist,9283,1662,10945
18396,Lenna,Dungate,ldungate7b@shop-pro.jp,Electrical Engineer,3673,757,4430
18769,Ara,Snookes,asnookes7c@europa.eu,Mechanical Systems Engineer,5420,414,5834
18491,Valeda,O'Rowane,vorowane7e@e-recht24.de,VP Accounting,2536,851,3387
18810,Fremont,Tander,ftander7f@goo.gl,VP Product Management,4058,790,4848
18183,Carola,Youel,cyouel7h@ox.ac.uk,VP Product Management,5193,857,6050
18060,Marin,Wincom,mwincom7i@hugedomains.com,Software Consultant,9682,1780,11462
18899,Avery,Lowder,alowder7j@ihg.com,Biostatistician II,5339,698,6037
18303,Aili,Stanyard,astanyard7k@hp.com,Help Desk Operator,5405,1428,6833
18078,Otis,Cuttell,ocuttell7m@bloglines.com,Legal Assistant,3204,453,3657
18778,Pace,Bricknall,pbricknall7n@nifty.com,Programmer I,6346,744,7090
18190,Suzanna,Swanton,sswanton7o@pagesperso-orange.fr,VP Marketing,4260,1040,5300
18580,Aristotle,Allflatt,aallflatt7p@fema.gov,Senior Developer,3425,1629,5054
18711,Laurel,Jachimiak,ljachimiak7q@spotify.com,Sales Associate,4503,319,4822
18707,Ailsun,Selman,aselman7r@miibeian.gov.cn,Administrative Assistant II,2269,202,2471
18271,Clemente,Ryles,cryles7s@liveinternet.ru,Staff Scientist,3766,608,4374
18509,Lorry,Di Ruggiero,ldiruggiero7t@live.com,Structural Engineer,1390,1902,3292
18013,Guthrie,Gioan,ggioan7w@lycos.com,Nurse,6117,1531,7648
18995,Ogdan,Parell,oparell7x@mac.com,Sales Associate,6268,1924,8192
18669,Lydie,Sheed,lsheed7y@washington.edu,Marketing Manager,9159,902,10061
18004,Dorolice,Dhillon,ddhillon7z@mail.ru,Paralegal,8974,636,9610
18936,Alon,Dominy,adominy80@howstuffworks.com,Data Coordiator,9159,1542,10701
18857,Law,Christofe,lchristofe81@ocn.ne.jp,Desktop Support Technician,1231,1921,3152
18318,Floria,Bruster,fbruster82@ucsd.edu,Internal Auditor,1780,351,2131
18556,Jordanna,Stamps,jstamps83@typepad.com,Staff Accountant IV,9759,248,10007
18074,Juana,Matkovic,jmatkovic84@msu.edu,Environmental Tech,7658,1518,9176
18320,Algernon,Hetterich,ahetterich85@prnewswire.com,Software Engineer II,5190,240,5430
18746,Archie,Gully,agully86@wufoo.com,Human Resources Assistant IV,2077,1541,3618
18991,Garvin,Ezzy,gezzy87@jigsy.com,Editor,8357,626,8983
18353,Della,Hulburt,dhulburt88@ustream.tv,Paralegal,4752,317,5069
18121,Miguelita,Skelton,mskelton89@tmall.com,Human Resources Assistant IV,6937,292,7229
18966,Debor,Falconar,dfalconar8a@nsw.gov.au,Executive Secretary,3545,549,4094
18515,Chadd,Leather,cleather8c@flickr.com,VP Accounting,9203,1622,10825
18411,Pierre,Dutton,pdutton8d@microsoft.com,Civil Engineer,6586,1215,7801
18292,Sophia,Behrens,sbehrens8e@nasa.gov,Recruiter,8980,1447,10427
18422,Crissie,Doylend,cdoylend8g@howstuffworks.com,VP Quality Control,9233,1085,10318
18563,Poppy,Esplin,pesplin8h@ezinearticles.com,Senior Quality Engineer,5240,1005,6245
18317,Mart,Kiendl,mkiendl8i@phpbb.com,Quality Engineer,5203,1934,7137
18664,Nicholas,Hobden,nhobden8l@state.tx.us,Recruiting Manager,7918,1912,9830
18856,Ernest,Monelli,emonelli8m@godaddy.com,Speech Pathologist,9218,1084,10302
18305,Drew,Brodeau,dbrodeau8n@cornell.edu,Nurse,2254,1080,3334
18651,Zorana,Persicke,zpersicke8o@ehow.com,Developer III,8341,1133,9474
18606,Towney,Abel,tabel8r@answers.com,Senior Financial Analyst,9422,1678,11100
18312,Bobina,Winchcomb,bwinchcomb8s@naver.com,Programmer Analyst II,4836,641,5477
18977,Rudie,Goakes,rgoakes8t@ehow.com,Budget/Accounting Analyst II,7722,1727,9449
18959,Hildagard,Lambard,hlambard8v@about.com,Marketing Manager,8129,309,8438
18129,Dix,Giannassi,dgiannassi8w@arizona.edu,Help Desk Operator,2692,1200,3892
18385,Vincenz,Matushevich,vmatushevich8x@army.mil,Technical Writer,6110,1330,7440
18925,Morgen,Staines,mstaines8y@si.edu,Civil Engineer,2732,1685,4417
18877,Eustacia,Girauld,egirauld8z@newyorker.com,Web Designer IV,3484,1999,5483
18322,Krissie,Feathersby,kfeathersby91@nydailynews.com,Tax Accountant,3564,1983,5547
18984,Hanny,Fewless,hfewless92@google.fr,Administrative Officer,9506,1640,11146
18799,Elena,Bellas,ebellas93@freewebs.com,Structural Engineer,4605,698,5303
18971,Fergus,Riha,friha96@google.com.au,Nurse,1794,1843,3637
18077,Paul,Bulbeck,pbulbeck97@aol.com,Sales Associate,1952,1378,3330
18274,Georgeanne,Stud,gstud98@tripod.com,Senior Quality Engineer,3986,493,4479
18787,Vivyan,Pridden,vpridden99@hud.gov,Assistant Manager,9002,501,9503
18694,Jean,Robe,jrobe9b@dedecms.com,Financial Advisor,1688,222,1910
18845,Elga,Mahony,emahony9d@archive.org,Database Administrator I,5623,1000,6623
18140,Sonny,De Giovanni,sdegiovanni9e@prnewswire.com,Assistant Manager,7918,433,8351
18705,Lynelle,Grigolli,lgrigolli9f@example.com,Mechanical Systems Engineer,3856,1581,5437
18637,Eran,Tosh,etosh9h@walmart.com,Editor,4826,555,5381
18915,Jenda,Klasing,jklasing9k@phoca.cz,Nurse Practicioner,3016,891,3907
18678,Veronika,Lesper,vlesper9l@upenn.edu,Civil Engineer,9208,1578,10786
18307,Federica,Gwinn,fgwinn9m@mozilla.com,Environmental Tech,8893,1309,10202
18283,Carmon,Marfe,cmarfe9n@example.com,Chief Design Engineer,6891,829,7720
18552,Orbadiah,Bris,obris9o@dmoz.org,Budget/Accounting Analyst IV,4343,618,4961
18589,Brittani,MacGorman,bmacgorman9q@posterous.com,Librarian,8084,736,8820
18170,Trace,Rogers,trogers9s@edublogs.org,Financial Advisor,5637,1045,6682
18147,Jeane,Ackroyd,jackroyd9t@cam.ac.uk,Structural Analysis Engineer,8246,1004,9250
18352,Noam,Andrichak,nandrichak9v@ebay.co.uk,Accountant IV,4815,1138,5953
18951,Lorilee,Waldren,lwaldren9x@sfgate.com,Human Resources Manager,2205,528,2733
18362,Shanna,Smorthit,ssmorthit9y@nbcnews.com,Human Resources Manager,4087,1362,5449
18956,Marinna,Bingell,mbingella0@yandex.ru,Software Test Engineer IV,7960,1626,9586
18869,Kattie,McCrorie,kmccroriea1@oaic.gov.au,Desktop Support Technician,5752,381,6133
18218,Adriana,Tourner,atournera2@independent.co.uk,Nuclear Power Engineer,7336,1217,8553
18815,Anna-maria,Piggens,apiggensa3@sohu.com,Marketing Assistant,5219,580,5799
18213,Dulci,Rawne,drawnea5@abc.net.au,Structural Engineer,6536,1793,8329
18191,Cinderella,Ladloe,cladloea7@zdnet.com,Staff Scientist,7212,428,7640
18623,Bucky,Giampietro,bgiampietroa9@house.gov,Engineer III,2795,859,3654
18117,Sterling,MacGaughey,smacgaugheyaa@icq.com,Community Outreach Specialist,2927,1874,4801
18039,Guthrey,Hartzogs,ghartzogsab@amazonaws.com,Graphic Designer,7141,733,7874
18779,Blaine,Tice,bticeae@nps.gov,Research Associate,3393,1838,5231
18527,Randall,Sweed,rsweedaf@unicef.org,Senior Editor,7298,1460,8758
18751,Adelheid,Biffen,abiffenai@cbsnews.com,Help Desk Technician,2339,1176,3515
18477,Chic,Johannes,cjohannesaj@senate.gov,Technical Writer,1493,214,1707
18592,Jerri,Argente,jargenteal@sourceforge.net,Business Systems Development Analyst,3163,1764,4927
18888,Hillier,Bingall,hbingallam@aboutads.info,Assistant Professor,4842,1186,6028
18726,Gypsy,Stonnell,gstonnellan@posterous.com,Web Designer IV,8195,1443,9638
18134,Kellsie,Moatt,kmoattao@thetimes.co.uk,Nurse,7661,1329,8990
18713,Karly,Warret,kwarretap@bbb.org,Registered Nurse,2212,1938,4150
18633,Dara,Python,dpythonaq@yale.edu,Cost Accountant,1424,372,1796
18525,Chery,Praton,cpratonar@digg.com,Office Assistant III,8891,982,9873
18886,Nickolai,Sissel,nsisselas@spotify.com,Speech Pathologist,1040,1879,2919
18644,Allis,Giraldez,agiraldezaw@ezinearticles.com,General Manager,5111,346,5457
18264,Verney,Caudwell,vcaudwellay@skype.com,Health Coach III,3891,694,4585
18712,Amy,Kember,akemberb0@webnode.com,Payment Adjustment Coordinator,7183,1797,8980
18408,Garrick,Bridges,gbridgesb1@imageshack.us,Clinical Specialist,5660,1810,7470
18249,Major,Bruhnicke,mbruhnickeb2@telegraph.co.uk,Accountant II,3789,1813,5602
18506,Helaine,Hamshere,hhamshereb4@cloudflare.com,Senior Cost Accountant,8971,614,9585
18245,Chadd,Charlewood,ccharlewoodb5@narod.ru,Research Associate,1508,282,1790
18850,Leta,Epton,leptonb7@pen.io,Staff Scientist,8865,1281,10146
18278,Percy,Carah,pcarahb8@slate.com,Compensation Analyst,7400,1217,8617
18027,Sidonnie,McClurg,smcclurgb9@wikimedia.org,Data Coordiator,3108,1989,5097
18571,Wilton,Conklin,wconklinba@toplist.cz,Operator,7990,1191,9181
18171,Steward,MacEveley,smaceveleybc@home.pl,Senior Cost Accountant,4551,1458,6009
18595,Masha,Szachniewicz,mszachniewiczbd@zimbio.com,Librarian,7802,1221,9023
18902,Con,Durtnel,cdurtnelbe@census.gov,Analyst Programmer,7401,891,8292
18235,Mitch,McWhorter,mmcwhorterbf@live.com,Teacher,2358,1793,4151
18649,Rowan,Rountree,rrountreebg@biglobe.ne.jp,Account Executive,8968,1353,10321
18635,Mara,Feakins,mfeakinsbh@lulu.com,Marketing Assistant,7383,1231,8614
18551,Muffin,Spilsbury,mspilsburybj@eventbrite.com,Web Developer II,9130,1797,10927
18503,Myron,Chaperling,mchaperlingbk@multiply.com,Help Desk Technician,8627,1500,10127
18865,Seth,Proudler,sproudlerbl@pbs.org,Editor,7110,682,7792
18992,Pearle,Farebrother,pfarebrotherbm@examiner.com,Media Manager I,6334,1816,8150
18448,Malachi,Massenhove,mmassenhovebp@google.co.jp,Systems Administrator II,7807,1074,8881
18006,Aron,Kleinpeltz,akleinpeltzbq@hostgator.com,Design Engineer,6387,1679,8066
18955,Tobit,Prugel,tprugelbs@intel.com,Office Assistant I,2291,271,2562
18658,Myranda,Southeran,msoutheranbt@ebay.com,Pharmacist,8074,671,8745
18349,Lorene,Nelm,lnelmbv@comcast.net,Paralegal,1681,1706,3387
18752,Janette,Barnet,jbarnetbw@etsy.com,Senior Developer,2287,1595,3882
18871,Jeno,Vearnals,jvearnalsbx@tinypic.com,Geological Engineer,8128,1344,9472
18577,Jacquie,Sanney,jsanneyby@japanpost.jp,Graphic Designer,9754,913,10667
18141,Marjorie,Longstreet,mlongstreetc2@constantcontact.com,Statistician III,7148,767,7915
18660,Gaylene,Cakes,gcakesc4@mtv.com,Project Manager,1483,1584,3067
18684,Marion,Mallon,mmallonc5@vistaprint.com,Geologist III,3397,1203,4600
18485,Rudyard,Tace,rtacec6@ning.com,General Manager,9787,256,10043
18048,Daren,Helks,dhelksc7@adobe.com,Account Representative III,6570,465,7035
18613,Alameda,Crosbie,acrosbieca@blogtalkradio.com,Design Engineer,8561,323,8884
18585,Lowell,Rubinowitch,lrubinowitchcc@gravatar.com,Media Manager III,6441,808,7249
18813,Mackenzie,Seawright,mseawrightcd@ihg.com,Database Administrator I,8739,1431,10170
18207,Tomkin,Olivetti,tolivettice@goo.ne.jp,Executive Secretary,4956,1535,6491
18103,Dag,Godsmark,dgodsmarkcf@cbslocal.com,Community Outreach Specialist,3720,1529,5249
18732,Hildegaard,Blunsen,hblunsencg@statcounter.com,Financial Advisor,9903,1258,11161
18783,Aviva,Georgeou,ageorgeouci@storify.com,Staff Scientist,7012,297,7309
18975,Devonna,Vedenisov,dvedenisovck@ustream.tv,Legal Assistant,5425,1766,7191
18238,Milka,Newhouse,mnewhousecl@blogspot.com,Automation Specialist IV,7184,649,7833
18221,Phillipp,Exposito,pexpositocm@prlog.org,Assistant Media Planner,4464,1886,6350
18692,Darn,Weare,dwearecn@simplemachines.org,Statistician III,2691,452,3143
18724,Cindelyn,Saph,csaphco@cdbaby.com,Software Consultant,1524,1220,2744
18987,Sharleen,Prendergrass,sprendergrasscq@ovh.net,Senior Sales Associate,6404,287,6691
18473,Pippy,Joskowitz,pjoskowitzcr@acquirethisname.com,Assistant Manager,1081,312,1393
18164,Dun,Garment,dgarmentcs@xing.com,Registered Nurse,6874,589,7463
18270,Lisette,Bowlands,lbowlandscu@utexas.edu,Help Desk Technician,4417,1876,6293
18625,Sigismondo,Heed,sheedcv@nytimes.com,Speech Pathologist,8309,254,8563
18747,Winona,Ernshaw,wernshawcw@ycombinator.com,Clinical Specialist,6305,206,6511
18622,Sarette,Martland,smartlandcy@bloomberg.com,Clinical Specialist,4404,527,4931
18138,Stefanie,Van Der Straaten,svanderstraatend2@webmd.com,Database Administrator IV,5054,1816,6870
18648,Alaine,Loadman,aloadmand5@yelp.com,Statistician II,5301,673,5974
18166,Valentijn,Cray,vcrayd6@scribd.com,Account Representative IV,8194,244,8438
18739,Essie,Etty,eettyd7@hud.gov,Junior Executive,3232,264,3496
18061,Madelin,Alkins,malkinsd9@dyndns.org,VP Quality Control,2034,1347,3381
18133,Hewett,Gerrell,hgerrellda@mlb.com,Electrical Engineer,9662,1425,11087
18336,Rubin,Mountstephen,rmountstephendc@nhs.uk,Senior Financial Analyst,4955,1296,6251
18655,Leland,Shackel,lshackelde@ucoz.com,Cost Accountant,5093,1754,6847
18614,Obie,Peedell,opeedelldg@pbs.org,Pharmacist,5195,737,5932
18510,Tod,Sadler,tsadlerdi@lulu.com,Accounting Assistant I,3587,1278,4865
18545,Bobbee,Jeanenet,bjeanenetdj@state.tx.us,Editor,4970,1256,6226
18765,Raf,Screach,rscreachdk@macromedia.com,Pharmacist,5970,697,6667
18097,Jacquette,Bonnin,jbonnindl@examiner.com,Electrical Engineer,3252,246,3498
18548,Andi,O'Dee,aodeedn@mozilla.org,Civil Engineer,9657,1001,10658
18541,Xena,Afonso,xafonsodo@mac.com,Environmental Specialist,8729,1954,10683
18296,Nat,Calles,ncallesdq@nydailynews.com,Programmer Analyst IV,8877,1782,10659
18627,Alma,Fine,afinedr@uol.com.br,Chief Design Engineer,5352,1112,6464
18192,Tommy,Dailey,tdaileyds@ted.com,General Manager,3726,1173,4899
18236,Sandie,Cowderay,scowderaydu@cam.ac.uk,Engineer IV,5267,1948,7215
18092,Levey,Patten,lpattendw@mit.edu,Data Coordiator,4619,727,5346
18368,Cate,Mullin,cmullindx@sfgate.com,Programmer Analyst IV,8621,510,9131
18685,Darrel,Vasiltsov,dvasiltsovdz@w3.org,Safety Technician III,3784,1314,5098
18367,Nichols,Tilly,ntillye0@t.co,Registered Nurse,7010,470,7480
18989,Jehanna,Van de Castele,jvandecastelee1@pinterest.com,Chief Design Engineer,7307,1179,8486
18672,Hakeem,Gras,hgrase2@etsy.com,GIS Technical Architect,5247,559,5806
18544,Derby,Heaysman,dheaysmane3@behance.net,Research Associate,7767,1085,8852
18671,Rick,Zarfati,rzarfatie6@europa.eu,Financial Advisor,4195,1635,5830
18696,Bernadette,Jonas,bjonase8@icio.us,Programmer Analyst II,8692,554,9246
18124,Arny,Brideoke,abrideokeee@abc.net.au,VP Marketing,3525,310,3835
18311,Vonni,Wallbank,vwallbankef@ft.com,Professor,5773,1106,6879
18093,Tamara,Duffield,tduffieldeh@webnode.com,Marketing Assistant,6289,248,6537
18919,Melania,Dyton,mdytonel@ucsd.edu,Legal Assistant,1893,705,2598
18609,Torre,Tolputt,ttolputtem@artisteer.com,Accountant I,8788,1415,10203
18999,Gerek,Bullivent,gbulliventeo@smh.com.au,VP Marketing,2574,807,3381
18775,Irwinn,Codrington,icodringtoneq@engadget.com,Financial Analyst,2864,493,3357
18619,Margarethe,Rossant,mrossantes@ustream.tv,Assistant Manager,9616,700,10316
18337,Grissel,Bonnette,gbonnetteet@shareasale.com,Office Assistant IV,9444,580,10024
18853,Charlena,Hoston,chostonex@omniture.com,Quality Engineer,2819,1533,4352
18200,Alric,Grocock,agrocockey@weebly.com,Developer III,1919,359,2278
18119,Darin,Trank,dtrankez@hp.com,Web Developer III,1783,1657,3440
18493,Christyna,Barefoot,cbarefootf5@ocn.ne.jp,Web Designer II,1666,881,2547
18178,Kaleena,Kebell,kkebellf6@squidoo.com,Pharmacist,3432,1880,5312
18795,Beau,Phoenix,bphoenixf9@earthlink.net,Associate Professor,8361,1525,9886
18214,Nye,Mansford,nmansfordfa@dell.com,Teacher,3180,624,3804
18404,Jeannie,Lavelle,jlavellefb@comcast.net,Financial Analyst,4317,1842,6159
18160,Liva,Dampney,ldampneyfd@yahoo.com,Quality Control Specialist,1053,1066,2119
18866,Tamar,Shoesmith,tshoesmithfe@timesonline.co.uk,Accountant II,9231,854,10085
18189,Rutger,Finlator,rfinlatorff@booking.com,Sales Representative,6787,216,7003
18907,Clemence,Clappson,cclappsonfg@plala.or.jp,Research Associate,4616,1361,5977
18988,Gerhard,Girardini,ggirardinifj@adobe.com,VP Accounting,3926,1355,5281
18088,Gearard,Filipchikov,gfilipchikovfk@youtu.be,Staff Scientist,1120,435,1555
18466,Panchito,Keane,pkeanefl@drupal.org,Accountant III,5966,1294,7260
18290,Lonni,Aldcorn,laldcornfm@salon.com,Office Assistant III,5943,630,6573
18114,Deonne,Lassell,dlassellfn@biglobe.ne.jp,Financial Analyst,4565,364,4929
18216,Josephina,Volage,jvolagefo@arstechnica.com,Programmer Analyst III,1244,782,2026
18378,Heidi,Gadson,hgadsonfp@wikia.com,Community Outreach Specialist,4602,643,5245
18824,Tommie,Puig,tpuigfq@goo.ne.jp,Environmental Tech,7518,1878,9396
18338,Gennifer,Pettecrew,gpettecrewfr@php.net,Programmer IV,8940,1028,9968
18759,Marcella,Crudginton,mcrudgintonfv@seattletimes.com,Assistant Media Planner,4672,1809,6481
18015,Fabian,Rountree,frountreefw@is.gd,Desktop Support Technician,1546,530,2076
18532,Karen,Maggiore,kmaggiorefx@homestead.com,Senior Developer,3108,872,3980
18973,Wang,Idale,widalefy@ehow.com,Nuclear Power Engineer,5499,933,6432
18025,Gordie,Bartleman,gbartlemang3@slashdot.org,Account Executive,1097,662,1759
18896,Lyndell,Hunnawill,lhunnawillg5@e-recht24.de,Programmer I,3550,1305,4855
18175,Carver,Parkhouse,cparkhouseg6@microsoft.com,Administrative Officer,9501,712,10213
18356,Amble,Cottisford,acottisfordgc@telegraph.co.uk,Programmer Analyst III,5636,946,6582
18831,Celestyn,Aberchirder,caberchirdergd@github.io,Software Engineer IV,1119,1964,3083
18246,Feliza,Tilne,ftilnegf@tripod.com,Mechanical Systems Engineer,7038,461,7499
18569,Toddie,Belz,tbelzgj@yandex.ru,Paralegal,4379,1209,5588
18263,Jorge,Pagon,jpagongk@dedecms.com,Research Associate,3647,1423,5070
18085,Ambrose,Phipp,aphippgl@stanford.edu,Financial Analyst,3842,398,4240
18792,Vivyan,Ceyssen,vceyssengm@usda.gov,Senior Developer,1331,1023,2354
18600,Ivonne,McGuckin,imcguckingp@google.de,Office Assistant III,7322,1040,8362
18068,Terrye,Brindle,tbrindlegx@hibu.com,Staff Accountant II,9797,1919,11716
18876,Charity,Cagan,ccagangz@live.com,Help Desk Technician,7786,1975,9761
18062,Gaspar,Ricardot,gricardoth0@ow.ly,Desktop Support Technician,5995,1563,7558
18120,Bartholomeo,Normabell,bnormabellh1@comsenz.com,Engineer I,3851,705,4556
18565,Matthias,MacVagh,mmacvaghh2@icio.us,Senior Quality Engineer,5619,1541,7160
18230,Lamar,Singh,lsinghh4@liveinternet.ru,VP Accounting,6159,272,6431
18325,Cirilo,Suscens,csuscensh6@oakley.com,Programmer III,5887,1019,6906
18123,Salomo,Dunkerley,sdunkerleyh7@last.fm,Product Engineer,9797,1122,10919
18419,Idelle,Eldredge,ieldredgeh9@prweb.com,Business Systems Development Analyst,4797,1475,6272
18080,Dasha,Halstead,dhalsteadha@nydailynews.com,Structural Analysis Engineer,5378,997,6375
18324,Abra,Late,alatehb@cyberchimps.com,Junior Executive,7426,1991,9417
18978,Arabel,Skelhorne,askelhornehd@gravatar.com,Mechanical Systems Engineer,3668,1674,5342
18328,Cody,Semorad,csemoradhf@rediff.com,Marketing Manager,7953,1029,8982
18930,Marvin,Sharpless,msharplesshg@jugem.jp,Junior Executive,6854,1942,8796
18458,Gabi,York,gyorkhk@ning.com,Software Engineer IV,4271,926,5197
18802,Kinnie,Hubach,khubachho@mayoclinic.com,VP Accounting,3968,1546,5514
18957,Hildagard,Chesterfield,hchesterfieldhp@nytimes.com,Electrical Engineer,9356,1171,10527
18032,Byran,Goding,bgodinghq@deviantart.com,Administrative Assistant IV,4933,337,5270
18046,Basia,Wilder,bwilderhu@wordpress.com,Operator,3885,968,4853
18870,Marijo,Tacey,mtaceyhv@npr.org,Media Manager II,1645,780,2425
18817,Robbert,Meadmore,rmeadmorehx@usatoday.com,Civil Engineer,8773,588,9361
18599,Vale,Dellenty,vdellentyhy@hc360.com,Analyst Programmer,4132,513,4645
18709,Rodrick,McBratney,rmcbratneyhz@yellowpages.com,Software Engineer III,7895,882,8777
18486,Urson,Blay,ublayi0@cloudflare.com,Budget/Accounting Analyst III,8686,1357,10043
18452,Galen,Hansmann,ghansmanni2@deliciousdays.com,Senior Quality Engineer,9126,352,9478
18601,Sena,Hoggin,shoggini3@google.com,Environmental Tech,1343,1525,2868
18497,Brier,Fitzroy,bfitzroyi4@archive.org,Marketing Manager,5426,803,6229
18539,Alla,MacSporran,amacsporrani5@berkeley.edu,Automation Specialist III,6163,479,6642
18172,Katine,Cotes,kcotesi7@gmpg.org,Mechanical Systems Engineer,6129,545,6674
18829,Nikos,Irnys,nirnysi8@ftc.gov,Safety Technician II,5525,1029,6554
18163,Hildegaard,Hevner,hhevneria@nba.com,Pharmacist,4260,1853,6113
18161,Torre,Trevorrow,ttrevorrowic@blogger.com,Account Coordinator,7092,632,7724
18734,Marika,Beavis,mbeavisid@webeden.co.uk,Quality Engineer,7210,1031,8241
18947,Jerrie,Malicki,jmalickiie@time.com,Human Resources Manager,7481,550,8031
18638,Fancy,Dayborne,fdayborneif@quantcast.com,Safety Technician IV,6713,1369,8082
18444,Efren,Netherwood,enetherwoodig@omniture.com,Software Consultant,4413,1905,6318
18442,Jaquenette,Macquire,jmacquireii@nasa.gov,Editor,6623,1281,7904
18231,Rowen,Bellew,rbellewij@storify.com,Senior Editor,2043,760,2803
18418,Pippy,Biever,pbieverik@techcrunch.com,Engineer II,1269,1894,3163
18573,Linn,Brazener,lbrazenerim@vistaprint.com,Human Resources Manager,3564,1445,5009
18439,Rinaldo,Noddings,rnoddingsin@statcounter.com,Developer I,8272,1265,9537
18244,Baryram,Blakesley,bblakesleyiq@drupal.org,Sales Associate,4091,1985,6076
18430,Axel,Pickersail,apickersailir@jiathis.com,VP Accounting,1370,887,2257
18848,Rafaello,McKeggie,rmckeggieis@usa.gov,Technical Writer,7778,1981,9759
18937,Levin,Craigheid,lcraigheidiw@wsj.com,Nurse Practicioner,8221,1153,9374
18837,Shauna,Nipper,snipperix@goo.gl,Biostatistician II,4633,276,4909
18704,Tasia,Prahl,tprahliy@diigo.com,Data Coordiator,4473,1188,5661
18974,Lonny,Behan,lbehanj0@sun.com,Geological Engineer,9163,356,9519
18940,Euell,Davidai,edavidaij1@spotify.com,Automation Specialist II,3434,718,4152
18209,Clerkclaude,Knottley,cknottleyj5@reddit.com,Legal Assistant,9276,1355,10631
18839,Godfree,Wythe,gwythej6@samsung.com,Programmer IV,3514,284,3798
18315,Launce,Scimoni,lscimonij8@cocolog-nifty.com,Data Coordiator,2482,1202,3684
18227,Darin,Stormes,dstormesj9@wiley.com,Structural Analysis Engineer,3797,1546,5343
18152,Berte,Coltart,bcoltartja@time.com,Product Engineer,3556,936,4492
18832,Demetris,Berthelmot,dberthelmotje@rambler.ru,Paralegal,4323,407,4730
18350,Garrett,Elcoux,gelcouxjf@google.es,Environmental Tech,1138,896,2034
18807,Yvon,Sotham,ysothamjh@ow.ly,VP Quality Control,8652,665,9317
18256,Debora,Levi,dlevijj@discuz.net,Programmer I,4600,1693,6293
18881,Lil,Braywood,lbraywoodjl@trellian.com,Speech Pathologist,6971,782,7753
18933,Rosanna,Houselee,rhouseleejn@usatoday.com,General Manager,7615,1519,9134
18852,Ethelda,Baggarley,ebaggarleyjp@google.co.uk,Senior Quality Engineer,8499,702,9201
18128,Donaugh,Dobrovolny,ddobrovolnyjz@latimes.com,Marketing Manager,3119,867,3986
18240,Budd,Gilmour,bgilmourk3@ifeng.com,Executive Secretary,2795,958,3753
18058,Stacee,Mewburn,smewburnk4@csmonitor.com,Chemical Engineer,8992,1308,10300
18631,Raddie,Lenz,rlenzk7@qq.com,Nuclear Power Engineer,2794,525,3319
18098,Kattie,Ferriby,kferribyk8@google.de,Pharmacist,1613,771,2384
18286,Verena,Bowler,vbowlerka@seesaa.net,Technical Writer,2125,271,2396
18205,Tremain,Trase,ttrasekb@shutterfly.com,Director of Sales,9956,1104,11060
18546,Nonnah,Le Fleming,nleflemingkd@wikispaces.com,Senior Developer,8600,1118,9718
18449,Mikol,Skaife d'Ingerthorpe,mskaifedingerthorpeke@foxnews.com,Sales Associate,6905,1043,7948
18665,Estele,Adel,eadelki@hugedomains.com,Project Manager,4800,674,5474
18197,Pedro,Digance,pdigancekk@icq.com,Statistician I,2574,967,3541
18416,Ardelle,Brauns,abraunskl@columbia.edu,Payment Adjustment Coordinator,9676,1511,11187
18591,Rahel,Allott,rallottkm@squidoo.com,Cost Accountant,8169,253,8422
18882,Cairistiona,Siddle,csiddlekn@sciencedaily.com,Help Desk Technician,7590,384,7974
18542,Seth,Domniney,sdomnineykp@opera.com,Engineer III,9102,1289,10391
18755,Jerrilee,Hastewell,jhastewellkv@abc.net.au,Graphic Designer,4977,531,5508
18683,Cornell,Vignal,cvignalkw@ca.gov,Media Manager III,3346,1751,5097
18067,Ellynn,Montez,emontezky@virginia.edu,Biostatistician IV,3597,1557,5154
18182,Clarie,Peres,cpereskz@4shared.com,Marketing Assistant,7946,776,8722
18364,Melamie,Kincla,mkinclal0@cornell.edu,Information Systems Manager,1352,477,1829
18024,Mendie,Benois,mbenoisl2@miibeian.gov.cn,Environmental Specialist,1009,1385,2394
18250,Vachel,Sproat,vsproatl3@bloomberg.com,Senior Financial Analyst,9881,1905,11786
18906,Editha,Vondracek,evondracekl4@imdb.com,Quality Engineer,3530,1434,4964
18754,Ewell,Friend,efriendla@hhs.gov,Analyst Programmer,8623,958,9581
18771,Jemimah,Stoddard,jstoddardlf@sun.com,Software Test Engineer I,8916,903,9819
18741,Stu,Donwell,sdonwellli@phoca.cz,Social Worker,8932,1590,10522
18258,Kahaleel,Van Giffen,kvangiffenll@boston.com,Systems Administrator III,2426,313,2739
18022,Faber,Scocroft,fscocroftln@free.fr,Structural Engineer,2592,1587,4179
18232,Carce,Kirrens,ckirrenslp@indiegogo.com,Senior Developer,9535,1411,10946
18403,Barnie,Middleweek,bmiddleweekls@amazon.com,Biostatistician III,1021,1486,2507
18827,Claudina,Bleue,cbleuelx@sciencedaily.com,Account Executive,9632,928,10560
18118,Annmarie,Marchelli,amarchellim0@diigo.com,Assistant Professor,8365,1671,10036
18281,Barbee,Jimeno,bjimenom1@seesaa.net,Associate Professor,6483,625,7108
18948,Costanza,Rassmann,crassmannm2@cbc.ca,Nuclear Power Engineer,1980,320,2300
18173,Kassey,McGrail,kmcgrailm5@google.co.uk,Account Executive,1137,882,2019
18289,Fianna,Baswall,fbaswallm6@ebay.com,Geologist III,6177,802,6979
18520,Nicola,Dyne,ndynem8@sogou.com,Research Associate,5905,1576,7481
18652,Bondon,Joel,bjoelmc@youku.com,Recruiter,5450,1502,6952
18148,Silvana,Caslake,scaslakemd@dot.gov,Software Engineer IV,5748,399,6147
18560,Chane,Rulten,crultenme@jiathis.com,Database Administrator III,7395,1688,9083
18304,Caresa,Whyborne,cwhybornemf@wired.com,Graphic Designer,9091,1233,10324
18481,Gustavo,Jeaffreson,gjeaffresonmh@intel.com,Account Representative III,3366,323,3689
18454,Ebba,Lissandrini,elissandrinimj@google.pl,Environmental Specialist,9770,1173,10943
18737,Berni,Jeanneau,bjeanneauml@ycombinator.com,Human Resources Assistant III,2135,1904,4039
18809,Melinde,Riddoch,mriddochmo@google.es,Senior Editor,1091,265,1356
18476,Wallis,Salman,wsalmanmq@patch.com,Systems Administrator III,2872,1276,4148
18225,Ariana,Chesterman,achestermanmt@utexas.edu,Account Representative III,3446,1644,5090
18462,Renell,Dron,rdronmv@a8.net,Assistant Manager,7875,1079,8954
18179,Cassondra,Jobbins,cjobbinsmw@psu.edu,Database Administrator II,4213,1483,5696
18629,Tory,Szymanski,tszymanskimx@discuz.net,Design Engineer,5526,1178,6704
18398,Caritta,Phebey,cphebeymz@vkontakte.ru,Human Resources Manager,5778,1882,7660
18961,Angelika,Sebrens,asebrensn0@marketwatch.com,Structural Analysis Engineer,2961,1562,4523
18108,Laurena,Danell,ldanelln2@answers.com,Web Designer II,4628,1063,5691
18346,Theodosia,Danat,tdanatn7@blinklist.com,Budget/Accounting Analyst I,3370,476,3846
18889,Harli,Demetr,hdemetrn8@elegantthemes.com,Senior Developer,6457,958,7415
18259,Kaile,Dummigan,kdummigann9@live.com,Information Systems Manager,4194,599,4793
18993,Myra,Grealy,mgrealyna@dagondesign.com,Recruiter,2037,414,2451
18731,Dianna,Debow,ddebownb@free.fr,Director of Sales,4081,1306,5387
18199,Mose,Piddlehinton,mpiddlehintonnf@instagram.com,Staff Scientist,4023,1906,5929
18102,Gilemette,Laingmaid,glaingmaidnk@fema.gov,Staff Accountant II,7232,867,8099
18981,Calhoun,Trott,ctrottnl@biblegateway.com,Professor,4594,601,5195
18050,Redford,Springham,rspringhamno@histats.com,Assistant Media Planner,1529,758,2287
18911,Geri,Jouandet,gjouandetnp@fc2.com,Geologist III,5941,1961,7902
18237,Alastair,Sweatman,asweatmannq@behance.net,Registered Nurse,3385,1887,5272
18375,Orelie,Newlands,onewlandsnr@thetimes.co.uk,Business Systems Development Analyst,4148,1016,5164
18994,Benny,McComiskey,bmccomiskeynz@ox.ac.uk,Cost Accountant,6228,740,6968
18460,Margit,Van Der Vlies,mvandervlieso4@posterous.com,Structural Engineer,1434,1464,2898
18335,Trudi,Collcott,tcollcotto5@1688.com,Occupational Therapist,3822,811,4633
18427,Hymie,Usmar,husmaro7@gov.uk,Software Consultant,5245,248,5493
18630,Esmaria,Vere,evereob@columbia.edu,Assistant Professor,7063,446,7509
18372,Deonne,Broske,dbroskeoe@loc.gov,VP Product Management,7188,1456,8644
18499,Alyss,Dowry,adowryop@acquirethisname.com,Chemical Engineer,5091,659,5750
18358,Holly,Blight,hblightor@smugmug.com,Software Consultant,9430,694,10124
18618,Kakalina,Lemm,klemmox@ezinearticles.com,Safety Technician IV,7113,406,7519
18997,Daisi,Wenger,dwengerp2@ifeng.com,Account Executive,8325,1822,10147
18002,Corliss,Hebbs,chebbsp3@cnn.com,Help Desk Operator,3709,1979,5688
18127,Ronny,Digan,rdiganp7@amazon.com,Database Administrator I,9954,1269,11223
18284,Cam,Willwood,cwillwoodpa@constantcontact.com,Software Test Engineer II,3465,803,4268
18743,Marlowe,Willarton,mwillartonpe@toplist.cz,Media Manager II,9324,964,10288
18040,West,Fletham,wflethampg@jugem.jp,Senior Sales Associate,6917,200,7117
18472,Cammie,Stove,cstoveph@netlog.com,Registered Nurse,4891,947,5838
18095,Lise,Petranek,lpetranekpl@bing.com,Quality Control Specialist,5814,630,6444
18059,Lorin,Shakesbye,lshakesbyepn@stumbleupon.com,Desktop Support Technician,4357,1544,5901
18341,Hamid,Meconi,hmeconipo@huffingtonpost.com,Accountant I,7722,1498,9220
18834,Darla,Guisler,dguislerpq@theatlantic.com,Financial Analyst,5441,666,6107
18593,Marlon,Presdie,mpresdiepr@harvard.edu,Operator,1200,1436,2636
18154,Michelina,Andrew,mandrewps@vistaprint.com,Civil Engineer,4072,1873,5945
18395,Frieda,Penman,fpenmanpu@artisteer.com,Design Engineer,1252,1335,2587
18615,Frederique,Bouts,fboutspw@dedecms.com,Electrical Engineer,3460,460,3920
18089,Kendra,Cuberley,kcuberleypx@soup.io,Community Outreach Specialist,2090,1045,3135
18144,Anya,Eveleigh,aeveleighpy@bbc.co.uk,VP Sales,5994,248,6242
18969,Paquito,Gormally,pgormallypz@army.mil,Administrative Officer,9035,879,9914
18679,Marion,Gawith,mgawithq3@spotify.com,Sales Representative,5996,1591,7587
18142,Ardith,Moorwood,amoorwoodq4@altervista.org,VP Quality Control,7838,836,8674
18785,Constantia,Standon,cstandonq5@weebly.com,Geological Engineer,5700,1537,7237
18327,Flynn,Venner,fvennerqa@utexas.edu,Professor,4245,335,4580
18517,Clifford,Rubenfeld,crubenfeldqb@buzzfeed.com,Senior Quality Engineer,6116,309,6425
18420,Randal,Baudesson,rbaudessonqd@addtoany.com,Quality Control Specialist,9742,1445,11187
18298,Sydel,Dahmke,sdahmkeqe@nbcnews.com,Recruiting Manager,9478,619,10097
18500,Sol,Devo,sdevoqh@mapquest.com,Human Resources Assistant III,8317,1143,9460
18851,Corie,Hembery,chemberyqp@opensource.org,Recruiting Manager,2211,1025,3236
18435,Niall,Titterton,ntittertonqs@discuz.net,Recruiter,2158,1420,3578
18251,Ruthe,Wimbush,rwimbushqv@illinois.edu,Clinical Specialist,7519,325,7844
18043,Anya,Arber,aarberr1@usatoday.com,Media Manager II,9424,838,10262
18293,Jocelyn,Botwood,jbotwoodr5@yandex.ru,Structural Analysis Engineer,2164,344,2508
18064,Lewiss,Adriaens,ladriaensr8@wordpress.com,Web Developer IV,4055,1172,5227
18950,Fairleigh,Ivanov,fivanovra@hhs.gov,Nurse,9017,656,9673
18280,Lori,McCane,lmccanerc@cocolog-nifty.com,Business Systems Development Analyst,9778,560,10338
18079,Addi,Bladen,abladenrd@patch.com,Assistant Media Planner,6200,566,6766
18921,Elsinore,Bastiman,ebastimanre@gravatar.com,Systems Administrator I,4451,1886,6337
18576,Abran,Jinkinson,ajinkinsonrg@webmd.com,Administrative Assistant IV,1709,1556,3265
18528,Nelia,Paddingdon,npaddingdonrh@deliciousdays.com,Administrative Assistant III,1338,914,2252
18621,Rahel,Davidai,rdavidairi@mozilla.com,Physical Therapy Assistant,9782,845,10627
18659,Corine,Wilkie,cwilkierp@un.org,VP Sales,9106,1589,10695
18469,Natty,Sawart,nsawartrq@wp.com,Environmental Specialist,3267,549,3816
18333,Sharl,O'Loinn,soloinnrr@360.cn,Geologist II,1977,1613,3590
19840,Rourke,McGavin,rmcgavin0@businesswire.com,Editor,2558,1556,4114
19647,Nicky,McCheyne,nmccheyne1@columbia.edu,Accountant II,7559,729,8288
19061,Giulia,Nan Carrow,gnancarrow2@apache.org,Web Developer IV,3166,1347,4513
19504,Caresse,Casaccia,ccasaccia3@barnesandnoble.com,Office Assistant IV,9649,1676,11325
19366,Augustine,Siddens,asiddens4@amazon.co.uk,Structural Engineer,5515,1160,6675
19721,Kirsteni,Goundsy,kgoundsy5@businessinsider.com,Nuclear Power Engineer,5222,250,5472
19030,Greta,Kachel,gkachel6@cbsnews.com,Assistant Manager,1443,1109,2552
19093,Shadow,Simondson,ssimondson7@prweb.com,Structural Engineer,5644,1073,6717
19347,Gunter,Iacomo,giacomo8@techcrunch.com,Director of Sales,3803,715,4518
19968,Hirsch,Moncaster,hmoncaster9@sogou.com,Business Systems Development Analyst,1377,1478,2855
19490,Bancroft,Casbourne,bcasbournea@house.gov,Administrative Assistant I,6472,957,7429
19745,Leonhard,Hastelow,lhastelowb@macromedia.com,Legal Assistant,4511,1374,5885
19656,Tarah,McComb,tmccombc@liveinternet.ru,Research Assistant IV,9705,224,9929
19989,Ethelred,Mawditt,emawditte@list-manage.com,Quality Engineer,7489,884,8373
19466,Kelly,MacLaverty,kmaclavertyf@dailymail.co.uk,Sales Representative,5317,841,6158
19783,Ida,O'Dare,iodareg@noaa.gov,Statistician IV,3481,1803,5284
19286,Lana,Dax,ldaxh@simplemachines.org,Actuary,5211,1114,6325
19073,Bil,Cockroft,bcockrofti@homestead.com,GIS Technical Architect,9295,955,10250
19201,Lynnett,Colpus,lcolpusj@jalbum.net,Teacher,3303,1450,4753
19340,Ulberto,Lightollers,ulightollersk@prweb.com,Pharmacist,4886,346,5232
19125,Farra,Emilien,femilienl@zimbio.com,Budget/Accounting Analyst I,4855,1627,6482
19564,Bondie,Fattori,bfattorim@ihg.com,Account Executive,6556,1407,7963
19330,Markus,Lendon,mlendonn@bluehost.com,Structural Analysis Engineer,7111,226,7337
19889,Vivia,Sheber,vshebero@tmall.com,Staff Scientist,5977,236,6213
19053,Milo,Kauble,mkaublep@yellowpages.com,Automation Specialist IV,8800,1090,9890
19651,Karylin,Haburne,khaburneq@trellian.com,Computer Systems Analyst III,3894,817,4711
19715,Giacinta,Pomphrey,gpomphreyr@washington.edu,Help Desk Operator,6946,918,7864
19785,Vallie,Ewens,vewenss@icio.us,Electrical Engineer,8444,1720,10164
19453,Ekaterina,Cops,ecopst@biblegateway.com,Data Coordiator,5941,1731,7672
19208,Raleigh,Glynn,rglynnu@sina.com.cn,Geologist II,7413,1291,8704
19213,Celestina,Colbrun,ccolbrunv@addtoany.com,Senior Sales Associate,8942,753,9695
19819,Livvie,Shutt,lshuttw@gravatar.com,Food Chemist,6265,1122,7387
19427,Giustino,Grennan,ggrennanx@google.pl,Senior Financial Analyst,8564,1501,10065
19393,Dacey,Turl,dturly@blogtalkradio.com,Safety Technician IV,1702,448,2150
19561,Cort,McConnell,cmcconnellz@nsw.gov.au,Quality Engineer,3563,1142,4705
19909,Brandea,Brierly,bbrierly10@phpbb.com,Business Systems Development Analyst,1552,1685,3237
19826,Brandon,Boarer,bboarer11@paginegialle.it,Developer I,2053,1007,3060
19050,Broddy,Redsull,bredsull12@zimbio.com,Chemical Engineer,1729,1463,3192
19119,Gale,Fairbrass,gfairbrass13@paginegialle.it,Account Coordinator,5700,1676,7376
19418,Jaynell,Acutt,jacutt14@netscape.com,Financial Analyst,7734,794,8528
19420,Sybyl,Olenin,solenin15@ustream.tv,Software Consultant,1456,489,1945
19843,Quentin,Armstrong,qarmstrong16@aboutads.info,Assistant Media Planner,1039,1176,2215
19362,Tynan,Cassel,tcassel18@squarespace.com,Senior Cost Accountant,6407,1801,8208
19359,Morie,Birdsall,mbirdsall19@businessweek.com,Paralegal,9001,1831,10832
19650,Riannon,Parish,rparish1a@google.it,Director of Sales,3883,1239,5122
19448,Gawain,Venturoli,gventuroli1b@alexa.com,Speech Pathologist,5682,1307,6989
19623,Marinna,Print,mprint1c@ycombinator.com,Account Executive,5759,1733,7492
19907,Ame,Sartin,asartin1e@boston.com,Human Resources Manager,3450,1174,4624
19574,Tremain,Oubridge,toubridge1f@desdev.cn,Senior Sales Associate,1983,1216,3199
19349,Amata,Giacomazzo,agiacomazzo1g@prlog.org,Computer Systems Analyst I,2404,832,3236
19742,Bellina,Ferriere,bferriere1h@squarespace.com,Automation Specialist I,2437,1395,3832
19123,Inger,Bierton,ibierton1i@altervista.org,Operator,9937,992,10929
19216,Eleanor,Allebone,eallebone1j@is.gd,Nurse,4466,897,5363
19025,Manya,Bentham,mbentham1k@wiley.com,Financial Analyst,8792,1039,9831
19707,Merridie,Shalloo,mshalloo1l@hubpages.com,Chief Design Engineer,4092,701,4793
19757,Garrick,Lermouth,glermouth1m@taobao.com,Editor,3630,1756,5386
19485,Kerianne,Stitson,kstitson1n@weibo.com,Programmer Analyst II,3282,633,3915
19441,Reid,Rampton,rrampton1o@opera.com,Software Test Engineer III,6616,455,7071
19703,Hester,Rushmere,hrushmere1p@chicagotribune.com,Physical Therapy Assistant,5722,926,6648
19070,Valentine,Riach,vriach1q@vk.com,Product Engineer,2903,1821,4724
19260,Rex,Wagner,rwagner1r@harvard.edu,Sales Representative,4636,960,5596
19534,Boy,Hovell,bhovell1s@live.com,Chemical Engineer,5316,1858,7174
19922,Theresa,Stummeyer,tstummeyer1t@usatoday.com,Computer Systems Analyst III,4967,1352,6319
19237,Winn,Hanway,whanway1v@gravatar.com,Social Worker,7813,972,8785
19117,Giffy,Stollenbecker,gstollenbecker1w@goo.ne.jp,Web Designer I,1483,380,1863
19684,Clotilda,Lethley,clethley1x@tinypic.com,Analyst Programmer,5129,1405,6534
19521,Garrick,Ilyenko,gilyenko1y@posterous.com,Sales Associate,1254,983,2237
19973,Allx,Kime,akime1z@java.com,Software Test Engineer IV,3976,1304,5280
19012,Gaynor,Voller,gvoller20@goodreads.com,Executive Secretary,2557,1205,3762
19632,Isadora,Ferras,iferras21@paginegialle.it,Operator,4200,1010,5210
19960,Benedetta,Minney,bminney22@ask.com,Structural Engineer,5775,588,6363
19315,Elysee,O'Fairy,eofairy23@hatena.ne.jp,Office Assistant IV,6396,1693,8089
19690,Denver,Kerrigan,dkerrigan24@gnu.org,Junior Executive,5524,1190,6714
19169,Reece,Eronie,reronie25@163.com,GIS Technical Architect,4121,1628,5749
19841,Lionello,Bedell,lbedell27@jalbum.net,Programmer III,4910,1680,6590
19618,Consalve,Macconachy,cmacconachy28@huffingtonpost.com,Safety Technician I,4669,1117,5786
19211,Madelyn,Celiz,mceliz29@wufoo.com,Executive Secretary,5028,945,5973
19161,Birdie,Lemonby,blemonby2a@apache.org,Director of Sales,5871,660,6531
19126,Nevile,Twohig,ntwohig2b@aol.com,Research Nurse,5658,205,5863
19639,Bette-ann,Muress,bmuress2c@si.edu,Help Desk Technician,5090,1769,6859
19223,Barbabra,Menear,bmenear2d@biblegateway.com,VP Sales,3935,537,4472
19102,Loutitia,Kidston,lkidston2e@go.com,Computer Systems Analyst IV,3678,204,3882
19672,Jordana,Mcettrick,jmcettrick2f@dmoz.org,Software Test Engineer IV,6227,1013,7240
19709,Griselda,Brigg,gbrigg2g@mediafire.com,Help Desk Operator,6898,1568,8466
19406,Carolee,Brislawn,cbrislawn2h@jiathis.com,Mechanical Systems Engineer,7992,650,8642
19368,Felice,Proffitt,fproffitt2i@scientificamerican.com,Quality Control Specialist,4950,919,5869
19759,Shantee,Challens,schallens2j@bloglovin.com,Research Nurse,6164,899,7063
19812,Germaine,Kubasek,gkubasek2l@liveinternet.ru,Data Coordiator,4140,657,4797
19538,Marlo,Tows,mtows2m@51.la,Nurse,7583,1909,9492
19124,Leia,Proven,lproven2n@devhub.com,Research Assistant III,3694,772,4466
19563,Aldin,Bickersteth,abickersteth2o@hubpages.com,Geological Engineer,9671,1171,10842
19573,Darda,Rogge,drogge2p@istockphoto.com,Geological Engineer,6506,1477,7983
19107,Joline,Perri,jperri2q@printfriendly.com,Web Designer I,4760,1956,6716
19495,Ede,Sturton,esturton2r@hao123.com,Office Assistant III,5567,592,6159
19753,Aurora,Bachnic,abachnic2s@51.la,Account Executive,1637,386,2023
19235,Chickie,Malloy,cmalloy2t@weebly.com,Senior Quality Engineer,9679,1594,11273
19474,Johnna,Aven,javen2u@discovery.com,VP Product Management,2634,1882,4516
19725,Lanita,Hulme,lhulme2v@cmu.edu,Desktop Support Technician,8550,617,9167
19695,Lenette,Symon,lsymon2w@hud.gov,Associate Professor,8371,1289,9660
19674,Jeff,Pevsner,jpevsner2x@altervista.org,Community Outreach Specialist,9349,1395,10744
19202,Rickard,Hanaford,rhanaford2y@discuz.net,Editor,7539,869,8408
19523,Nettie,Danilevich,ndanilevich2z@dell.com,Software Engineer II,3679,1479,5158
19038,Rusty,Innman,rinnman30@shutterfly.com,Programmer Analyst II,1546,1925,3471
19129,Kirstyn,Stanier,kstanier31@vk.com,Speech Pathologist,4539,1426,5965
19259,Hugibert,Ruzek,hruzek32@ibm.com,Biostatistician I,4150,846,4996
19301,Lorne,Wrench,lwrench33@vk.com,Actuary,8451,428,8879
19016,Kaitlyn,Monsey,kmonsey34@samsung.com,Assistant Media Planner,4872,914,5786
19948,Berna,Sommerville,bsommerville35@furl.net,Community Outreach Specialist,5821,1450,7271
19171,Dasya,Shelford,dshelford36@wikimedia.org,Human Resources Assistant IV,3435,579,4014
19778,Caesar,MacGragh,cmacgragh37@time.com,Sales Associate,6342,649,6991
19206,Essa,Chritchlow,echritchlow38@nifty.com,Programmer II,9412,1170,10582
19338,Duky,Learmonth,dlearmonth39@godaddy.com,Product Engineer,4053,319,4372
19553,Guthry,Burkart,gburkart3b@imdb.com,Project Manager,2947,819,3766
19192,Dag,Orsman,dorsman3d@desdev.cn,Nurse,6466,705,7171
19820,Teriann,Gladwish,tgladwish3e@craigslist.org,Senior Quality Engineer,1568,1758,3326
19387,Hartley,Lockier,hlockier3f@dailymail.co.uk,Database Administrator I,4588,424,5012
19465,Marty,Dwane,mdwane3g@wix.com,Computer Systems Analyst III,1976,1086,3062
19739,Ermentrude,Hexam,ehexam3h@ameblo.jp,Media Manager III,1925,1536,3461
19106,Joletta,Samet,jsamet3i@blogger.com,Recruiting Manager,1630,823,2453
19020,Harmony,Moniker,hmoniker3j@yellowpages.com,Physical Therapy Assistant,5501,1020,6521
19874,Barnebas,De Bischof,bdebischof3k@mail.ru,Physical Therapy Assistant,9263,345,9608
19571,Gayel,Guenther,gguenther3l@smugmug.com,Human Resources Assistant IV,7084,1856,8940
19762,Carl,Lenihan,clenihan3m@prlog.org,Developer II,9697,1256,10953
19932,Klemens,Grasner,kgrasner3n@nydailynews.com,Health Coach I,9625,1076,10701
19024,Kaycee,Letterick,kletterick3o@census.gov,Engineer I,7601,1020,8621
19402,Ruben,Conrath,rconrath3p@yellowpages.com,Librarian,6414,1465,7879
19588,Bess,Goulden,bgoulden3q@google.ca,Food Chemist,2360,849,3209
19039,Shawnee,Gorick,sgorick3r@amazonaws.com,Software Test Engineer I,3752,594,4346
19959,Dottie,MacCosto,dmaccosto3s@smugmug.com,Marketing Assistant,9649,1511,11160
19244,Bobette,Quin,bquin3t@slashdot.org,Help Desk Technician,3152,1859,5011
19986,Antony,Cruise,acruise3u@bloglines.com,Graphic Designer,4300,511,4811
19713,Irvine,Suffield,isuffield3w@imdb.com,Financial Advisor,2678,546,3224
19913,Brit,McLevie,bmclevie3x@google.com.hk,Product Engineer,1907,717,2624
19766,Radcliffe,Devanney,rdevanney3y@cisco.com,Recruiting Manager,6902,1772,8674
19599,Lorne,Lorait,llorait3z@dmoz.org,Software Engineer II,9955,859,10814
19786,Brita,Belton,bbelton40@discuz.net,VP Product Management,5664,1997,7661
19165,Clio,Wontner,cwontner41@com.com,Geological Engineer,9532,1439,10971
19325,Renie,Puttick,rputtick42@yale.edu,Internal Auditor,5233,1316,6549
19848,Inness,Dickie,idickie43@alibaba.com,Desktop Support Technician,8426,1516,9942
19999,Hall,Clilverd,hclilverd44@prnewswire.com,Research Associate,4235,1972,6207
19661,Meaghan,Alphege,malphege45@blogtalkradio.com,Help Desk Operator,8329,972,9301
19729,Mercie,Glassopp,mglassopp46@engadget.com,Web Designer IV,3058,1285,4343
19692,Izaak,Raubenheimer,iraubenheimer47@newyorker.com,VP Marketing,9651,1212,10863
19988,Osmund,Loddy,oloddy48@github.com,Account Representative II,9023,1397,10420
19663,Matilda,Olivera,molivera4a@fastcompany.com,Internal Auditor,3287,209,3496
19329,Cameron,Walrond,cwalrond4b@apple.com,Health Coach IV,7296,1679,8975
19308,Theodosia,Trounson,ttrounson4c@europa.eu,Internal Auditor,5657,673,6330
19220,Rufus,Alltimes,ralltimes4d@123-reg.co.uk,VP Marketing,7123,670,7793
19883,Loni,Maty,lmaty4e@wunderground.com,Community Outreach Specialist,9318,788,10106
19995,Killie,Menauteau,kmenauteau4f@digg.com,Librarian,1800,329,2129
19168,Maggy,Deniske,mdeniske4h@zimbio.com,Technical Writer,7474,1425,8899
19500,Gayle,Jansen,gjansen4i@mashable.com,Legal Assistant,5462,590,6052
19856,Renie,Lamplough,rlamplough4j@slashdot.org,Administrative Assistant IV,1484,334,1818
19043,Shaine,Yggo,syggo4k@uiuc.edu,Research Assistant III,3727,1935,5662
19364,Sigfrid,Boutcher,sboutcher4l@jiathis.com,VP Sales,5460,884,6344
19997,Zared,Swaton,zswaton4m@histats.com,Nuclear Power Engineer,2703,475,3178
19803,Leland,Zuanazzi,lzuanazzi4n@devhub.com,VP Marketing,3870,881,4751
19687,Rachelle,Vouls,rvouls4o@reddit.com,Legal Assistant,5299,1133,6432
19724,Joletta,Kedge,jkedge4p@fc2.com,Speech Pathologist,9202,855,10057
19551,Vincenty,Ehrat,vehrat4q@parallels.com,Junior Executive,2084,1771,3855
19878,Fergus,McGaw,fmcgaw4r@netlog.com,Assistant Media Planner,3377,1967,5344
19326,Eleen,Duchart,educhart4s@nytimes.com,Associate Professor,7636,741,8377
19731,Arri,Leuren,aleuren4t@pcworld.com,Executive Secretary,3507,808,4315
19421,Artemis,Tawton,atawton4v@wordpress.org,Data Coordiator,9738,1627,11365
19693,Denise,Assel,dassel4w@fotki.com,Systems Administrator IV,6665,516,7181
19037,Wendy,Crose,wcrose4x@wikipedia.org,Account Representative I,5189,1816,7005
19496,Giuditta,O'Neil,goneil4y@clickbank.net,Help Desk Technician,6556,525,7081
19781,Lucine,Formigli,lformigli4z@ox.ac.uk,Junior Executive,8160,1711,9871
19311,Vale,O'Finan,vofinan50@macromedia.com,Cost Accountant,6732,1498,8230
19900,Collin,Gormally,cgormally51@chronoengine.com,Product Engineer,4712,561,5273
19898,Nicholle,Dudney,ndudney52@studiopress.com,Associate Professor,5861,1492,7353
19205,Skipper,Benito,sbenito54@addthis.com,Sales Representative,2497,1286,3783
19385,Krishnah,Loffhead,kloffhead55@wikipedia.org,Administrative Assistant III,7388,1820,9208
19292,Eleanore,Warlock,ewarlock56@yellowbook.com,Quality Control Specialist,9594,1551,11145
19472,Jeni,Brien,jbrien58@cafepress.com,Account Coordinator,6634,1761,8395
19921,Brooks,Swan,bswan59@geocities.jp,Financial Advisor,8681,772,9453
19282,Minna,Brizland,mbrizland5a@networkadvertising.org,Paralegal,1774,500,2274
19906,Hanan,Cominello,hcominello5c@so-net.ne.jp,Nurse Practicioner,1621,371,1992
19481,Mord,Clowton,mclowton5e@npr.org,Registered Nurse,5798,226,6024
19851,Vicki,Chazotte,vchazotte5f@answers.com,Research Assistant III,3057,1474,4531
19252,Sonnie,Dunabie,sdunabie5g@hibu.com,Graphic Designer,4555,520,5075
19676,Miner,Bims,mbims5h@google.fr,Financial Analyst,4663,1776,6439
19236,Elwin,Meadway,emeadway5j@wordpress.com,Senior Cost Accountant,7071,327,7398
19018,Evelina,Bondy,ebondy5k@admin.ch,Systems Administrator III,4756,502,5258
19557,Orelee,Tyrer,otyrer5l@exblog.jp,Programmer Analyst IV,1589,1134,2723
19011,Reggi,Ratke,rratke5m@symantec.com,Administrative Assistant II,9487,1263,10750
19305,Irv,Indruch,iindruch5o@altervista.org,Human Resources Assistant II,4757,1510,6267
19930,Garry,Bennetts,gbennetts5p@domainmarket.com,Programmer Analyst I,2258,626,2884
19545,Keene,Pietroni,kpietroni5q@constantcontact.com,Social Worker,3671,816,4487
19828,Susanne,Sidaway,ssidaway5r@eventbrite.com,Human Resources Assistant II,4221,675,4896
19950,Inger,Brader,ibrader5s@china.com.cn,Professor,7627,555,8182
19549,Melany,Tordoff,mtordoff5t@bandcamp.com,Information Systems Manager,7117,1423,8540
19434,Hettie,Worling,hworling5w@webs.com,Junior Executive,2044,1032,3076
19619,Aluino,Petit,apetit5x@blogger.com,Research Nurse,4947,664,5611
19013,Jena,Cumberledge,jcumberledge5z@behance.net,Senior Cost Accountant,7038,1260,8298
19629,Lulita,Kiehnlt,lkiehnlt60@studiopress.com,Media Manager II,5710,1143,6853
19239,Zelda,Stouther,zstouther61@meetup.com,Librarian,2633,1090,3723
19343,Kally,Llopis,kllopis63@goo.ne.jp,Cost Accountant,5652,1196,6848
19017,Andrei,Truitt,atruitt64@diigo.com,Office Assistant II,9899,719,10618
19142,Keven,Cleminshaw,kcleminshaw65@sogou.com,Web Designer I,7270,1618,8888
19698,Cos,Giacomo,cgiacomo66@flickr.com,Teacher,4783,424,5207
19080,Sylvester,Hurles,shurles67@biglobe.ne.jp,GIS Technical Architect,5191,348,5539
19160,Richy,Rendbaek,rrendbaek68@ibm.com,Electrical Engineer,6733,655,7388
19612,Antoni,Coggles,acoggles69@dyndns.org,Librarian,6358,1113,7471
19103,Sue,Kermitt,skermitt6a@nytimes.com,GIS Technical Architect,8656,769,9425
19548,Orren,Donnachie,odonnachie6b@1und1.de,Geological Engineer,2330,706,3036
19071,Jillana,Halcro,jhalcro6c@sina.com.cn,Recruiting Manager,7695,1903,9598
19150,Carly,Ricart,cricart6d@skype.com,Geological Engineer,4958,272,5230
19701,Gwenore,Dymocke,gdymocke6e@desdev.cn,Legal Assistant,9957,1788,11745
19704,Emilie,Thompstone,ethompstone6f@slate.com,Marketing Assistant,3691,849,4540
19934,Grenville,Lovie,glovie6g@tripadvisor.com,Safety Technician III,6135,481,6616
19494,Shayne,Gockeler,sgockeler6h@google.nl,Civil Engineer,1742,489,2231
19354,Julianna,Cottingham,jcottingham6j@macromedia.com,Computer Systems Analyst III,5347,924,6271
19214,Orland,D'Ruel,odruel6k@netlog.com,Software Consultant,5734,1743,7477
19804,Sherman,Meharry,smeharry6m@stanford.edu,Accounting Assistant II,1666,1211,2877
19844,Augustus,Ewence,aewence6n@tumblr.com,Staff Accountant III,8021,1809,9830
19063,Clare,Alred,calred6o@answers.com,Associate Professor,1193,1036,2229
19191,Kelila,Gniewosz,kgniewosz6p@about.com,Graphic Designer,7642,1891,9533
19328,Lanette,Dodshun,ldodshun6q@nydailynews.com,Chemical Engineer,5144,1288,6432
19009,Belinda,Boodell,bboodell6s@hhs.gov,Analyst Programmer,8225,1242,9467
19478,Flinn,Mark,fmark6t@icio.us,Operator,6089,1440,7529
19751,Cordey,Spivie,cspivie6u@vkontakte.ru,Civil Engineer,3010,1871,4881
19279,Lisbeth,Twidell,ltwidell6w@reference.com,Recruiting Manager,3634,650,4284
19655,Glenden,Mountjoy,gmountjoy6x@edublogs.org,Senior Quality Engineer,1602,1173,2775
19817,Kori,Goadby,kgoadby6y@baidu.com,Financial Analyst,6895,1542,8437
19758,Jeniffer,Mardle,jmardle6z@moonfruit.com,Project Manager,3202,1246,4448
19104,Serena,Buard,sbuard70@slashdot.org,Pharmacist,2338,602,2940
19413,Latrena,Pearcehouse,lpearcehouse71@vk.com,Environmental Specialist,9627,1014,10641
19965,Petronille,Harburtson,pharburtson72@seattletimes.com,Nurse,7099,976,8075
19295,Idelle,Knightsbridge,iknightsbridge73@webnode.com,Professor,9646,1263,10909
19374,Waly,Round,wround74@pinterest.com,Systems Administrator II,3191,494,3685
19777,Moira,Hillin,mhillin75@netvibes.com,Design Engineer,1972,1425,3397
19006,Selig,Sallery,ssallery76@photobucket.com,Software Engineer I,5276,439,5715
19076,Cortie,Patria,cpatria78@google.it,Project Manager,3466,1890,5356
19198,Kari,Toplin,ktoplin7a@squarespace.com,Business Systems Development Analyst,2530,1045,3575
19032,Sheffie,Gwyneth,sgwyneth7b@epa.gov,Tax Accountant,9932,343,10275
19109,Juditha,Killingworth,jkillingworth7c@opensource.org,Human Resources Manager,6953,463,7416
19780,Faun,Maylour,fmaylour7d@unc.edu,Media Manager IV,3923,1822,5745
19550,Sholom,Phippin,sphippin7e@weibo.com,Assistant Media Planner,4480,806,5286
19923,Bil,Brimfield,bbrimfield7f@freewebs.com,Chemical Engineer,4408,1662,6070
19722,Celina,Vaune,cvaune7g@ocn.ne.jp,Teacher,6452,525,6977
19755,Vitia,Siviter,vsiviter7h@ovh.net,Research Associate,4497,1342,5839
19284,Jeanna,Medlar,jmedlar7i@mediafire.com,Assistant Manager,2388,468,2856
19872,Huberto,McKeown,hmckeown7j@washingtonpost.com,Legal Assistant,5151,762,5913
19598,Devora,Ludman,dludman7k@unesco.org,Assistant Media Planner,2106,253,2359
19489,Yvette,Oloman,yoloman7l@umich.edu,Database Administrator IV,4613,987,5600
19871,Karie,Arnould,karnould7m@ihg.com,Account Coordinator,2754,762,3516
19316,Hube,Regis,hregis7n@studiopress.com,Marketing Assistant,1092,1275,2367
19519,Chickie,O'Monahan,comonahan7p@multiply.com,VP Marketing,1263,1040,2303
19404,Alic,Ervine,aervine7q@liveinternet.ru,Geological Engineer,1143,1398,2541
19937,Aura,Barley,abarley7r@comsenz.com,Nurse,5188,1015,6203
19980,Carma,Dusting,cdusting7s@umn.edu,Statistician I,1081,1355,2436
19583,Irina,Mattusevich,imattusevich7t@businessinsider.com,Administrative Officer,5700,927,6627
19335,Brandie,Champe,bchampe7v@home.pl,Analog Circuit Design manager,5972,1800,7772
19823,Jeannie,O'Gready,jogready7w@comcast.net,Quality Engineer,5753,750,6503
19513,Roda,Matthensen,rmatthensen7y@salon.com,Quality Engineer,2037,1668,3705
19327,Pauline,Perassi,pperassi7z@miitbeian.gov.cn,VP Sales,2051,1610,3661
19714,Ofelia,Screwton,oscrewton80@ucoz.com,Senior Developer,9933,1916,11849
19005,Angelita,Josefsen,ajosefsen81@businessinsider.com,Dental Hygienist,4985,1008,5993
19318,Dalli,Najera,dnajera82@google.pl,Programmer Analyst I,1354,524,1878
19281,Denver,Closs,dcloss83@sfgate.com,Graphic Designer,3687,955,4642
19317,Elyn,Mercer,emercer85@jigsy.com,Dental Hygienist,5340,1221,6561
19689,Yuri,Hort,yhort86@devhub.com,Assistant Manager,7367,1467,8834
19077,Abbe,Buttery,abuttery87@theguardian.com,General Manager,7195,1199,8394
19487,Dorena,Branford,dbranford88@gravatar.com,Research Nurse,6941,847,7788
19253,Rica,Lipprose,rlipprose8a@miibeian.gov.cn,Accountant II,4565,1582,6147
19671,Mackenzie,Bevan,mbevan8f@mysql.com,Director of Sales,6833,794,7627
19901,Winnah,Gercken,wgercken8g@chicagotribune.com,Mechanical Systems Engineer,3493,375,3868
19648,Retha,Ogelsby,rogelsby8i@marketwatch.com,Social Worker,1022,494,1516
19051,Ewell,Tylor,etylor8j@geocities.jp,Senior Quality Engineer,9381,1489,10870
19807,Muffin,Pucknell,mpucknell8k@drupal.org,Senior Financial Analyst,7937,963,8900
19022,Kara-lynn,Joan,kjoan8l@mapy.cz,Professor,1361,1815,3176
19036,Gayel,Scotchmur,gscotchmur8m@sohu.com,Chemical Engineer,2852,952,3804
19732,Demetri,Tippell,dtippell8n@joomla.org,Environmental Specialist,4941,1909,6850
19531,Priscella,Fraschetti,pfraschetti8o@fda.gov,General Manager,2261,681,2942
19842,Jarrett,Bagehot,jbagehot8p@hao123.com,Associate Professor,7448,601,8049
19114,Sly,Van der Linde,svanderlinde8q@blogs.com,Mechanical Systems Engineer,4736,1644,6380
19591,Ursala,Castan,ucastan8s@homestead.com,Software Test Engineer IV,5944,538,6482
19491,Illa,Frankiss,ifrankiss8w@chronoengine.com,Account Coordinator,10000,895,10895
19164,Jarvis,Burl,jburl8x@nature.com,Research Associate,4330,526,4856
19769,Dolly,Bernardt,dbernardt8y@hibu.com,Analyst Programmer,7893,1374,9267
19818,Brittani,Dagnall,bdagnall8z@privacy.gov.au,VP Quality Control,3019,1155,4174
19194,Wallache,Pawnsford,wpawnsford90@boston.com,Human Resources Manager,5690,673,6363
19679,Byrle,Poultney,bpoultney93@archive.org,Internal Auditor,7532,206,7738
19696,Clarence,Cullingford,ccullingford95@posterous.com,Information Systems Manager,5864,752,6616
19342,Stanwood,Gealy,sgealy98@mail.ru,Help Desk Technician,2938,1946,4884
19075,Vergil,Cherrie,vcherrie9a@cnbc.com,Assistant Manager,5195,329,5524
19128,Selina,Bellelli,sbellelli9b@ow.ly,Marketing Manager,7680,1568,9248
19247,Stillmann,Caseley,scaseley9c@a8.net,Database Administrator IV,4093,459,4552
19682,Fredrick,Gregorin,fgregorin9d@arstechnica.com,Payment Adjustment Coordinator,6720,1323,8043
19809,Reginald,Wildbore,rwildbore9e@vistaprint.com,Web Developer II,4956,1951,6907
19750,Duffie,Quennell,dquennell9f@sogou.com,Sales Representative,2377,1400,3777
19139,Alene,Hay,ahay9g@fotki.com,Operator,8230,1071,9301
19468,Sauncho,Easdon,seasdon9h@vkontakte.ru,Health Coach IV,3717,1782,5499
19830,Swen,McHan,smchan9i@google.it,Engineer IV,3328,1746,5074
19028,Lyon,Savile,lsavile9j@dailymotion.com,Mechanical Systems Engineer,3073,426,3499
19174,Merrili,De la Harpe,mdelaharpe9k@wix.com,Junior Executive,8881,641,9522
19770,Tanhya,Amthor,tamthor9l@pcworld.com,Technical Writer,9058,872,9930
19542,Orella,Tower,otower9m@businessinsider.com,Mechanical Systems Engineer,2048,822,2870
19609,Barny,Wohlers,bwohlers9n@globo.com,Budget/Accounting Analyst I,4839,1400,6239
19130,Gretel,Scothron,gscothron9p@1688.com,Safety Technician IV,9341,1085,10426
19497,Romy,Chalcraft,rchalcraft9q@comcast.net,Web Designer III,1964,1526,3490
19046,Lynsey,Larwood,llarwood9r@rambler.ru,Administrative Officer,1135,1983,3118
19662,Alasteir,Corro,acorro9t@angelfire.com,Environmental Specialist,9096,764,9860
19727,Kristine,Mansfield,kmansfield9u@histats.com,Financial Analyst,9724,752,10476
19556,Glynnis,Rohlfing,grohlfing9v@scientificamerican.com,Occupational Therapist,8630,1722,10352
19439,Hinze,Keedy,hkeedy9w@themeforest.net,Nurse Practicioner,6995,612,7607
19132,Erl,Sealeaf,esealeaf9x@networksolutions.com,Health Coach III,8260,965,9225
20000,Raoul,Durrand,rdurrand9z@desdev.cn,Geologist II,6607,1918,8525
19787,Aviva,Kainz,akainza0@craigslist.org,Information Systems Manager,2517,1454,3971
19351,Neill,Barwise,nbarwisea2@g.co,Tax Accountant,6829,1683,8512
19737,Vina,Landa,vlandaa3@clickbank.net,VP Product Management,7580,1102,8682
19271,Base,Boadby,bboadbya4@twitter.com,Office Assistant IV,9821,1975,11796
19730,Ker,Calcott,kcalcotta5@github.com,Office Assistant III,4500,1732,6232
19859,Hedwig,Olivia,holiviaa6@wiley.com,Office Assistant II,4682,725,5407
19261,Moyra,Harding,mhardinga7@europa.eu,Senior Cost Accountant,7651,543,8194
19636,Morley,Dinnis,mdinnisa8@eepurl.com,Occupational Therapist,3619,1746,5365
19167,Horatius,Downton,hdowntona9@marketwatch.com,Research Assistant III,6447,434,6881
19449,Hilda,Brownstein,hbrownsteinaa@a8.net,Speech Pathologist,9185,925,10110
19517,Wilbur,Cockshut,wcockshutab@yahoo.co.jp,Social Worker,8646,1458,10104
19182,Guillermo,Wessing,gwessingac@discovery.com,Nurse Practicioner,1320,1871,3191
19173,Jimmy,Skoughman,jskoughmanad@addtoany.com,Actuary,3105,749,3854
19879,Gray,Pesselt,gpesseltaf@clickbank.net,Financial Advisor,5301,550,5851
19082,Gabey,Whooley,gwhooleyag@people.com.cn,Recruiting Manager,7959,1751,9710
19544,Evangelin,Munnion,emunnionai@php.net,Media Manager I,2495,254,2749
19580,Kristel,Gilberthorpe,kgilberthorpeal@w3.org,Human Resources Assistant II,5620,1318,6938
19776,Holly-anne,Steffans,hsteffansam@yellowpages.com,Marketing Manager,4605,1741,6346
19157,Norrie,Sinney,nsinneyan@google.de,Analyst Programmer,7198,344,7542
19293,Dillie,Albasiny,dalbasinyao@joomla.org,Software Consultant,8820,1740,10560
19222,Ax,Orht,aorhtaq@craigslist.org,Paralegal,8168,1593,9761
19953,Davis,Coye,dcoyear@mysql.com,Systems Administrator I,3669,516,4185
19772,Mallory,Howsley,mhowsleyas@free.fr,Research Associate,6615,414,7029
19526,Stewart,Bullas,sbullasat@shop-pro.jp,Administrative Assistant I,9438,1165,10603
19389,Genvieve,Ledrun,gledrunau@tinyurl.com,Quality Control Specialist,8486,1008,9494
19547,Jaquith,Vaan,jvaanay@fda.gov,Senior Financial Analyst,3903,1581,5484
19181,Bibi,MacElroy,bmacelroyaz@comsenz.com,Senior Developer,5948,210,6158
19712,Clayborn,Dougliss,cdouglissb0@hc360.com,Senior Sales Associate,8851,820,9671
19525,Rici,Gatherell,rgatherellb2@paginegialle.it,Senior Cost Accountant,8108,1171,9279
19113,Kaia,Griffin,kgriffinb5@kickstarter.com,Staff Scientist,7417,496,7913
19822,Illa,Videneev,ivideneevb6@xing.com,Senior Quality Engineer,3968,667,4635
19825,Pamela,Peto,ppetoba@disqus.com,VP Product Management,5991,1492,7483
19775,Shaine,Gingell,sgingellbb@naver.com,Technical Writer,4025,871,4896
19600,Norman,Issac,nissacbc@privacy.gov.au,Chief Design Engineer,7227,682,7909
19532,Thedrick,Gallego,tgallegobf@eepurl.com,Office Assistant III,3487,1390,4877
19288,Siffre,Amerighi,samerighibg@independent.co.uk,Accountant I,4892,1672,6564
19088,Trixy,Olek,tolekbh@un.org,Developer IV,9808,1202,11010
19297,Misty,Esson,messonbi@accuweather.com,Desktop Support Technician,6204,1048,7252
19322,Piper,Bauldrey,pbauldreybj@hibu.com,VP Sales,3955,1158,5113
19044,Ilaire,Probbin,iprobbinbk@wufoo.com,Marketing Assistant,5129,1876,7005
19307,Hew,Medforth,hmedforthbl@smh.com.au,Structural Analysis Engineer,6619,1943,8562
19892,Letti,Gunderson,lgundersonbm@mysql.com,Biostatistician III,1392,1806,3198
19814,Piper,Bradnum,pbradnumbn@geocities.jp,Project Manager,5104,1380,6484
19447,Fred,Orr,forrbo@cargocollective.com,Recruiting Manager,2490,297,2787
19782,Ailina,Seers,aseersbp@spiegel.de,VP Marketing,3479,1097,4576
19383,Cleveland,Farlambe,cfarlambebq@free.fr,Help Desk Technician,7631,1985,9616
19405,Colby,Siward,csiwardbs@printfriendly.com,Paralegal,9591,1702,11293
19348,Ortensia,Seabourne,oseabournebv@usatoday.com,Information Systems Manager,6044,1634,7678
19186,Jerald,Northen,jnorthenbw@ycombinator.com,Paralegal,7380,1732,9112
19886,Mil,McDonnell,mmcdonnellbz@chron.com,Nurse Practicioner,5904,290,6194
19412,Griffin,Fass,gfassc0@google.com.au,Nurse,7897,1892,9789
19432,Armand,Morsom,amorsomc1@ft.com,Structural Analysis Engineer,7265,1978,9243
19430,Margarette,Vankin,mvankinc2@buzzfeed.com,Help Desk Operator,7114,1108,8222
19554,Gherardo,Deedes,gdeedesc3@skyrock.com,Office Assistant III,1378,1178,2556
19280,Sawyere,Hourihane,shourihanec6@github.com,Sales Representative,1481,1113,2594
19178,Thurstan,Striker,tstrikerc9@barnesandnoble.com,Mechanical Systems Engineer,9177,597,9774
19052,Andre,Filipputti,afilipputtica@toplist.cz,Food Chemist,6335,267,6602
19815,Oswell,Halversen,ohalversencb@soup.io,Nurse,8459,1268,9727
19461,Kamilah,Milmoe,kmilmoecc@google.com,Librarian,5009,432,5441
19833,Celestia,Samarth,csamarthcd@loc.gov,Food Chemist,7713,1137,8850
19744,Franklyn,Brownbill,fbrownbillce@wp.com,VP Product Management,6538,549,7087
19979,Jo-anne,Jaouen,jjaouencf@wisc.edu,Senior Developer,9305,1534,10839
19363,Jerome,Le Fevre,jlefevrech@stanford.edu,Librarian,9991,1944,11935
19506,Hammad,Dows,hdowsck@wired.com,Geologist I,9611,274,9885
19151,Bettina,Meiklejohn,bmeiklejohncm@whitehouse.gov,Staff Accountant IV,4286,1291,5577
19939,Averyl,Hynson,ahynsoncn@pen.io,VP Sales,4963,387,5350
19929,Darn,Adrienne,dadriennect@nba.com,Research Associate,5528,868,6396
19258,Izabel,Philcock,iphilcockcw@gravatar.com,Dental Hygienist,6376,1906,8282
19861,Oran,Povall,opovallcx@marriott.com,Editor,6312,740,7052
19353,Avery,Avramovic,aavramoviccy@surveymonkey.com,Help Desk Operator,6323,1137,7460
19083,Fleurette,Lambeth,flambethcz@xing.com,Senior Cost Accountant,4153,1468,5621
19269,Vinnie,O' Cuolahan,vocuolahand1@geocities.com,Payment Adjustment Coordinator,8637,478,9115
19381,Cello,Kenworth,ckenworthd2@cargocollective.com,Internal Auditor,7180,1072,8252
19361,Barney,Tremellier,btremellierd6@issuu.com,Legal Assistant,1791,905,2696
19601,Haskell,Heaford,hheafordd9@bloglines.com,Financial Advisor,6630,1475,8105
19096,Gonzalo,Kinchley,gkinchleyda@admin.ch,Database Administrator I,7900,1014,8914
19752,Sharleen,Inglese,singlesedd@blogtalkradio.com,General Manager,2910,236,3146
19938,Ailyn,Klimkiewich,aklimkiewichde@nytimes.com,Accounting Assistant IV,7380,1951,9331
19535,Heriberto,Chislett,hchislettdf@reddit.com,Chief Design Engineer,5343,1569,6912
19321,Corabella,Blowes,cblowesdh@ed.gov,Design Engineer,5877,1067,6944
19875,Eran,MacPhee,emacpheedi@forbes.com,GIS Technical Architect,1297,1323,2620
19002,Frederico,Beer,fbeerdj@ihg.com,VP Accounting,5749,1243,6992
19579,Alidia,Pavinese,apavinesedl@opera.com,Web Developer II,9101,870,9971
19245,Tucker,Juhruke,tjuhrukedm@ucla.edu,Physical Therapy Assistant,1985,360,2345
19834,Ainslie,Cyseley,acyseleydn@theguardian.com,Clinical Specialist,8338,1707,10045
19645,Freida,Petren,fpetrendp@mozilla.org,Biostatistician I,1214,215,1429
19492,Kamila,Vaen,kvaendq@4shared.com,Programmer Analyst II,2930,340,3270
19459,Baryram,Kirimaa,bkirimaadr@weebly.com,Developer II,6079,1916,7995
19943,Roderic,Cawte,rcawteds@list-manage.com,Project Manager,5895,1621,7516
19176,Darsey,Kinchley,dkinchleydt@archive.org,Biostatistician II,4370,1047,5417
19558,Bamby,Sangra,bsangradw@github.com,Speech Pathologist,1280,1551,2831
19069,Jewel,Sparwell,jsparwelle0@blogs.com,Senior Editor,4130,1502,5632
19972,Albrecht,Whatmough,awhatmoughe2@list-manage.com,Senior Sales Associate,8567,624,9191
19634,Benjamen,Francescuccio,bfrancescuccioe3@ycombinator.com,Data Coordiator,9767,1766,11533
19078,Kristel,Muncie,kmunciee4@lulu.com,Account Executive,5555,1663,7218
19120,Frans,Yu,fyue6@webeden.co.uk,Registered Nurse,6528,947,7475
19416,Durant,Chesney,dchesneye7@stumbleupon.com,Media Manager I,8805,598,9403
19539,Blinny,Pattemore,bpattemoreec@miibeian.gov.cn,Programmer Analyst IV,2070,426,2496
19243,Cale,Pounder,cpounderef@booking.com,Senior Developer,5010,213,5223
19256,Kerwin,Bolliver,kbollivereg@icio.us,Quality Engineer,9548,1048,10596
19717,Gage,Guerreiro,gguerreiroeh@shinystat.com,Senior Sales Associate,3024,1332,4356
19613,Kimberley,Milazzo,kmilazzoei@sciencedirect.com,Help Desk Operator,6679,278,6957
19881,Kingsly,Cavan,kcavanej@statcounter.com,Computer Systems Analyst III,6493,743,7236
19646,Leslie,Mackrill,lmackrillek@cam.ac.uk,Recruiter,8995,777,9772
19941,Walliw,Tash,wtashel@google.ca,Help Desk Operator,2464,1124,3588
19172,Jerry,Wardingley,jwardingleyem@issuu.com,Marketing Assistant,7380,531,7911
19761,Marius,Rippen,mrippenen@bizjournals.com,Senior Financial Analyst,7161,1209,8370
19512,Lonny,Spurr,lspurreo@surveymonkey.com,Engineer I,6624,1564,8188
19765,Barthel,Wyss,bwysseq@ucoz.ru,Senior Editor,2457,1347,3804
19718,Allyce,Ingley,aingleyes@hexun.com,VP Product Management,3552,531,4083
19710,Francyne,Banasiak,fbanasiakeu@cbsnews.com,Engineer IV,7461,1250,8711
19916,Rowen,Erickson,rericksonev@netvibes.com,Research Nurse,3116,1898,5014
19994,Waylon,Moreno,wmorenoew@sfgate.com,Dental Hygienist,4652,216,4868
19334,Merl,Davenell,mdavenelley@netvibes.com,Graphic Designer,1040,522,1562
19984,Connie,Penna,cpennaez@1688.com,Statistician III,1322,1376,2698
19620,Gisella,Champkins,gchampkinsf0@google.ca,Junior Executive,2785,1083,3868
19414,Lucas,Cressey,lcresseyf1@slideshare.net,Web Designer IV,7339,990,8329
19552,Isidora,Barabisch,ibarabischf2@auda.org.au,Software Test Engineer I,3260,294,3554
19121,Amy,M'Quharge,amquhargef3@cbsnews.com,Business Systems Development Analyst,8391,424,8815
19190,Bessie,Winwood,bwinwoodf5@rambler.ru,Senior Developer,6643,926,7569
19302,Lanny,Caldero,lcalderof6@bbc.co.uk,Software Consultant,4328,1406,5734
19229,Noelle,Malthouse,nmalthousef7@statcounter.com,VP Quality Control,7559,890,8449
19409,Huntley,Lambdean,hlambdeanfa@mapquest.com,Food Chemist,6037,1602,7639
19238,Carny,Gyenes,cgyenesfd@creativecommons.org,Staff Scientist,5223,1957,7180
19681,Emilia,Crighton,ecrightonfe@cam.ac.uk,VP Sales,6598,1738,8336
19852,Odessa,Edmunds,oedmundsfh@naver.com,VP Marketing,3221,548,3769
19581,Billy,Brand-Hardy,bbrandhardyfj@drupal.org,Internal Auditor,9109,904,10013
19079,Mamie,Crickmer,mcrickmerfk@house.gov,Design Engineer,1293,619,1912
19816,Brien,Gelling,bgellingfl@sitemeter.com,Budget/Accounting Analyst I,3877,1666,5543
19187,Alfred,Headly,aheadlyfr@yale.edu,Food Chemist,3062,1683,4745
19054,Ebenezer,Wickling,ewicklingfs@webmd.com,Data Coordiator,4379,1706,6085
19711,Lynda,Gaytor,lgaytorft@google.ca,Recruiter,7370,735,8105
19774,Jermaine,Rennebeck,jrennebeckfu@theglobeandmail.com,Project Manager,1283,1032,2315
19540,Gilles,Kupis,gkupisfw@indiegogo.com,Information Systems Manager,5571,1525,7096
19291,Franny,Barke,fbarkefy@lulu.com,Geological Engineer,1197,235,1432
19395,Essy,Knapp,eknappg0@purevolume.com,GIS Technical Architect,4383,955,5338
19914,Silvie,Bullen,sbulleng1@drupal.org,Programmer II,9050,478,9528
19985,Joshua,Filyukov,jfilyukovg2@csmonitor.com,Account Representative I,5227,1936,7163
19417,Tucky,MacAskie,tmacaskieg3@skype.com,Financial Advisor,5363,1638,7001
19862,Jasper,Jagoe,jjagoeg5@tripadvisor.com,Senior Financial Analyst,2646,1384,4030
19520,Weston,Stutely,wstutelyg6@t.co,Technical Writer,1808,524,2332
19023,Kathrine,Greest,kgreestg7@businesswire.com,Software Test Engineer I,9031,1394,10425
19723,Berenice,Lafrentz,blafrentzg9@forbes.com,Cost Accountant,3445,1830,5275
19266,Ashly,Issacof,aissacofgb@trellian.com,Director of Sales,9284,1271,10555
19004,Kippy,Pickthall,kpickthallge@dedecms.com,Chief Design Engineer,9048,1860,10908
19508,Tatiania,Diwell,tdiwellgg@google.com.au,Safety Technician IV,6685,1111,7796
19007,Riccardo,Geldard,rgeldardgi@ucla.edu,Nuclear Power Engineer,8316,1338,9654
19270,Stan,Baxandall,sbaxandallgk@discuz.net,GIS Technical Architect,7805,828,8633
19177,Lay,Stainton,lstaintongo@google.pl,Administrative Officer,1623,274,1897
19428,Aldridge,Beevens,abeevensgu@ucoz.ru,Web Developer III,5650,408,6058
19304,Windy,Bartle,wbartlegx@amazon.com,Legal Assistant,9456,1323,10779
19400,Hatti,Harcombe,hharcombegy@geocities.com,Structural Engineer,9718,1493,11211
19657,Barry,Fardon,bfardongz@google.com.hk,Technical Writer,9019,323,9342
19275,Dewey,Langford,dlangfordh0@sun.com,Speech Pathologist,5232,458,5690
19365,Rosemary,O'Fogarty,rofogartyh1@businesswire.com,Marketing Manager,2689,1020,3709
19627,Em,Lanmeid,elanmeidh2@vkontakte.ru,Marketing Assistant,6296,591,6887
19193,Therese,Vallens,tvallensh4@sciencedaily.com,Electrical Engineer,5745,1438,7183
19323,Kailey,O'Loinn,koloinnh5@xing.com,Director of Sales,5516,1398,6914
19166,Earle,Albertson,ealbertsonh7@ucla.edu,Tax Accountant,8465,521,8986
19228,Christy,Dashper,cdashperha@opera.com,Help Desk Technician,5060,1665,6725
19133,Artemis,Bohills,abohillshb@google.com,Staff Scientist,8807,1430,10237
19267,Aubert,Pillington,apillingtonhc@typepad.com,Web Developer I,7020,783,7803
19919,Cosme,Francis,cfrancishe@who.int,Senior Sales Associate,1215,799,2014
19675,Vevay,Shropsheir,vshropsheirhf@github.io,Tax Accountant,4193,1048,5241
19015,Camey,Wigin,cwiginhh@illinois.edu,Quality Engineer,3013,1375,4388
19306,Trumann,Stollwerk,tstollwerkhi@weather.com,Associate Professor,4412,1172,5584
19189,Jodi,Coupman,jcoupmanhk@ibm.com,Research Assistant II,1937,951,2888
19974,Boony,Ingram,bingramhl@google.it,Senior Financial Analyst,1575,867,2442
19576,Amy,Nockalls,anockallshm@theglobeandmail.com,Media Manager I,8700,1418,10118
19882,Alena,Abel,aabelhn@imdb.com,Environmental Tech,1593,442,2035
19145,Alaster,Spur,aspurho@bravesites.com,Structural Engineer,5370,278,5648
19057,Maritsa,Gaskin,mgaskinhp@devhub.com,Senior Developer,7877,1743,9620
19912,Kori,Ferris,kferrishq@ibm.com,Account Executive,8446,457,8903
19864,Whitney,Siaskowski,wsiaskowskiht@themeforest.net,Recruiter,6177,918,7095
19854,Ciro,Yearnsley,cyearnsleyhu@jigsy.com,Quality Engineer,6004,1603,7607
19346,Leora,Blanc,lblanchv@gnu.org,Nurse Practicioner,4373,1276,5649
19808,Vivianne,Kordes,vkordeshx@apache.org,Software Engineer II,9435,1594,11029
19224,Hamil,Fabry,hfabryhz@xrea.com,Senior Editor,3979,1075,5054
19401,Dominica,Caslett,dcasletti1@redcross.org,Information Systems Manager,6722,1563,8285
19456,Rheba,Jolley,rjolleyi2@bloomberg.com,Programmer Analyst III,8994,818,9812
19499,Kain,Please,kpleasei4@yahoo.co.jp,VP Sales,5954,798,6752
19931,Sylas,Dalgetty,sdalgettyi5@yale.edu,Financial Analyst,4702,200,4902
19505,Bill,Leavesley,bleavesleyi7@multiply.com,Pharmacist,1446,1993,3439
19683,Bili,Vellden,bvelldeni8@ebay.co.uk,Director of Sales,5388,1608,6996
19831,Corissa,Nial,cniali9@51.la,Cost Accountant,9050,1205,10255
19688,Licha,Palatini,lpalatiniib@e-recht24.de,Operator,4820,1929,6749
19170,Cinderella,Kelk,ckelkic@narod.ru,Health Coach II,1973,1663,3636
19653,Farica,Rosie,frosieid@msu.edu,Environmental Tech,6722,889,7611
19101,Olly,Haddleston,ohaddlestonie@fema.gov,Editor,1474,1217,2691
19059,Austina,Barden,abardenin@storify.com,Design Engineer,6428,1254,7682
19801,Gilburt,Olufsen,golufsenip@wufoo.com,Senior Cost Accountant,2909,1736,4645
19952,Sharlene,Bramwich,sbramwichir@exblog.jp,Health Coach IV,1106,1487,2593
19179,Janenna,Redmire,jredmireis@fastcompany.com,Assistant Professor,5871,1700,7571
19355,Enrichetta,Harriday,eharridayiu@w3.org,Nurse,8480,431,8911
19424,Maddy,Kemp,mkempiw@earthlink.net,Legal Assistant,9379,302,9681
19251,Rooney,Hof,rhofix@163.com,Analog Circuit Design manager,2710,1430,4140
19533,Drona,Edgett,dedgettiz@google.pl,Account Coordinator,1325,1762,3087
19595,Josefa,Babcock,jbabcockj0@opera.com,Compensation Analyst,3295,1258,4553
19477,Jennee,Smooth,jsmoothj1@cafepress.com,Programmer I,6734,1776,8510
19720,Inger,Croci,icrocij2@homestead.com,Human Resources Assistant IV,2007,979,2986
19537,Allx,Skegg,askeggj3@soup.io,Software Consultant,6981,1740,8721
19691,Llewellyn,Trynor,ltrynorj4@dyndns.org,Systems Administrator III,2990,746,3736
19622,Emlyn,Trundle,etrundlej5@123-reg.co.uk,Systems Administrator I,5259,1803,7062
19642,Caroline,Ornelas,cornelasjc@redcross.org,Administrative Assistant III,2436,654,3090
19159,Linn,Cranmere,lcranmerejd@vimeo.com,Analog Circuit Design manager,9108,716,9824
19873,Sinclare,Callan,scallanjf@phpbb.com,Web Designer IV,3553,286,3839
19849,Roby,Glazyer,rglazyerji@ning.com,Financial Analyst,2186,1158,3344
19587,Carleton,Wraxall,cwraxalljj@eepurl.com,Quality Control Specialist,4808,928,5736
19507,Barry,Brumen,bbrumenjk@smh.com.au,Staff Accountant I,7767,1229,8996
19565,Brenna,Linkin,blinkinjl@webs.com,Compensation Analyst,8869,1937,10806
19289,Viki,Welbeck,vwelbeckjq@pagesperso-orange.fr,Food Chemist,5047,1833,6880
19341,Kelsey,Tomblings,ktomblingsjt@slashdot.org,Legal Assistant,2065,1915,3980
19961,Rosamund,Bosden,rbosdenjv@wikia.com,Occupational Therapist,7220,1977,9197
19976,Guillermo,Remirez,gremirezjz@goo.gl,Sales Associate,5048,1202,6250
19700,Marwin,Duplock,mduplockk1@squidoo.com,Cost Accountant,5846,260,6106
19983,Archibald,Allmann,aallmannk5@networksolutions.com,Office Assistant I,6260,1113,7373
19604,Barbee,Stothard,bstothardk6@com.com,Operator,1359,1677,3036
19058,Peder,Kilty,pkiltyk7@cloudflare.com,Internal Auditor,4421,1437,5858
19097,Vin,Bogays,vbogayskb@yahoo.com,Director of Sales,8771,204,8975
19866,Lavinie,Kemmons,lkemmonskc@google.co.jp,Food Chemist,1670,1267,2937
19567,Sherm,Adiscot,sadiscotkd@sfgate.com,Operator,9297,1162,10459
19027,Kiah,Noods,knoodskf@geocities.jp,Sales Representative,9257,754,10011
19614,Alidia,Champkins,achampkinski@google.pl,Civil Engineer,4662,1151,5813
19234,Alaster,Phythien,aphythienkk@angelfire.com,Nurse Practicioner,2985,312,3297
19768,Harvey,Gaine of England,hgaineofenglandkl@ucoz.com,Accounting Assistant III,6576,1430,8006
19628,Cameron,Garred,cgarredkn@ow.ly,Account Coordinator,4259,1499,5758
19397,Vinnie,Peddowe,vpeddoweko@google.ru,Internal Auditor,2713,1563,4276
19754,Joelynn,Celes,jcelesks@goodreads.com,Sales Representative,1075,373,1448
19895,Court,McIlroy,cmcilroykv@goo.gl,Senior Quality Engineer,9370,1511,10881
19035,Cairistiona,Exroll,cexrollkx@mapy.cz,Account Coordinator,8609,217,8826
19445,Fletch,Challender,fchallenderky@disqus.com,Financial Analyst,9880,1798,11678
19248,Freddy,Dalling,fdallingkz@timesonline.co.uk,VP Marketing,4691,586,5277
19231,Ewell,Heinreich,eheinreichl0@oaic.gov.au,VP Accounting,1531,1703,3234
19747,Audry,Jehan,ajehanl8@bloomberg.com,Analog Circuit Design manager,1644,1710,3354
19853,Gerhardt,Luck,gluckla@w3.org,Accountant I,1125,1152,2277
19925,Neil,Bools,nboolslb@cornell.edu,Executive Secretary,6727,1284,8011
19072,August,Dict,adictld@reddit.com,VP Quality Control,2269,405,2674
19116,Doe,Schermick,dschermickli@epa.gov,Computer Systems Analyst IV,4008,1710,5718
19582,Harold,Rutgers,hrutgerslk@alexa.com,Junior Executive,2885,557,3442
19471,Vyky,Londer,vlonderlo@cisco.com,Systems Administrator IV,1875,640,2515
19444,Bertie,Ballsdon,bballsdonlp@marketwatch.com,Desktop Support Technician,6962,1470,8432
19246,Phillip,Gregh,pgreghlq@wikipedia.org,Financial Analyst,9773,1826,11599
19970,Sonni,Suerz,ssuerzls@jimdo.com,VP Quality Control,4978,1188,6166
19644,Nathaniel,Lundbeck,nlundbecklu@usgs.gov,Software Test Engineer II,7933,1866,9799
19633,Isac,Bilborough,ibilboroughlv@163.com,Staff Accountant III,5519,1072,6591
19122,Siegfried,Seres,ssereslx@ehow.com,Marketing Manager,6363,1326,7689
19455,Merralee,Ebbles,mebblesm1@omniture.com,Office Assistant III,3352,1864,5216
19225,Berthe,Dunkley,bdunkleym3@si.edu,Environmental Tech,1664,620,2284
19669,Deidre,Ilott,dilottm5@tiny.cc,Account Executive,9486,1795,11281
19837,Coop,Trebble,ctrebblem6@instagram.com,Office Assistant I,5053,1649,6702
19794,Esme,Spendlove,espendlovemb@npr.org,Staff Accountant II,5691,708,6399
19942,Herschel,Rowling,hrowlingmc@deliciousdays.com,Recruiter,5577,726,6303
19518,Melissa,Fonte,mfontemf@businesswire.com,Biostatistician II,9764,1954,11718
19388,Elbertine,Haselhurst,ehaselhurstmh@eepurl.com,VP Sales,2589,1682,4271
19436,Ebony,Morbey,emorbeymi@squidoo.com,GIS Technical Architect,5446,1712,7158
19606,Uriah,Fanner,ufannerml@prweb.com,Web Designer III,4190,567,4757
19617,Matelda,Lempke,mlempkemn@mediafire.com,Geologist II,8912,622,9534
19493,Tallie,Coverlyn,tcoverlynmo@pinterest.com,Payment Adjustment Coordinator,1169,1005,2174
19331,Cicely,McEnteggart,cmcenteggartmp@paginegialle.it,Recruiting Manager,8748,1077,9825
19527,Giovanna,Collip,gcollipmq@dyndns.org,Graphic Designer,9049,227,9276
19226,Cyb,Deble,cdeblems@foxnews.com,Social Worker,6274,1262,7536
19333,Rochelle,Capper,rcappermu@amazon.co.jp,Computer Systems Analyst IV,1469,762,2231
19218,Silvan,Lillicrap,slillicrapmv@apple.com,Data Coordiator,5552,869,6421
19003,Karalynn,Tuffley,ktuffleyn1@techcrunch.com,Marketing Manager,4427,751,5178
19008,Raina,Pyvis,rpyvisn6@hostgator.com,VP Marketing,2535,1681,4216
19462,Dennie,Thorndycraft,dthorndycraftnc@flickr.com,Speech Pathologist,9173,1417,10590
19677,Meredithe,Bohike,mbohikend@angelfire.com,Nurse,9653,1087,10740
19423,Eve,Simmonds,esimmondsne@surveymonkey.com,VP Quality Control,8214,454,8668
19360,Solly,Petersen,spetersenni@auda.org.au,Registered Nurse,8315,896,9211
19877,Enid,Videan,evideannl@technorati.com,Nurse Practicioner,8344,1169,9513
19014,Devinne,Roggero,droggerono@msn.com,Legal Assistant,5176,395,5571
19240,Giorgi,Fautly,gfautlynr@usa.gov,Recruiting Manager,2561,1250,3811
19045,Erskine,Macveigh,emacveighnt@sfgate.com,Editor,4688,1334,6022
19212,Jock,Tams,jtamso1@bbc.co.uk,Programmer IV,9562,604,10166
19502,Von,Piper,vpipero2@wisc.edu,Electrical Engineer,4626,1450,6076
19705,Louella,Ealden,lealdeno3@scientificamerican.com,Pharmacist,1476,509,1985
19320,Dyann,Kubach,dkubacho4@free.fr,Structural Analysis Engineer,2946,514,3460
19263,Maura,Seabright,mseabrighto7@techcrunch.com,Electrical Engineer,2453,746,3199
19033,Nichols,Stetlye,nstetlyeo9@stumbleupon.com,Programmer II,9462,1251,10713
19262,Bev,Fenn,bfennoc@is.gd,Environmental Tech,6103,1427,7530
19049,Risa,Witts,rwittsod@shutterfly.com,Occupational Therapist,1061,971,2032
19890,Shandeigh,Grigori,sgrigorioi@zdnet.com,Staff Scientist,4407,979,5386
19386,Godfree,Pettengell,gpettengelloj@ucoz.com,Engineer III,4916,1767,6683
19384,Seymour,Scopes,sscopesol@t-online.de,Physical Therapy Assistant,8672,971,9643
19736,Saunderson,Androsik,sandrosikom@sakura.ne.jp,VP Product Management,7731,730,8461
19105,Byram,Candie,bcandieoo@wp.com,Administrative Officer,3217,1490,4707
19528,Kasey,Pledger,kpledgerop@springer.com,Human Resources Assistant I,5011,1953,6964
19652,Roz,Angood,rangoodot@friendfeed.com,Clinical Specialist,1945,1676,3621
19274,Rosemary,Jeannaud,rjeannaudou@wunderground.com,Associate Professor,5956,1821,7777
19092,Jonathon,Slade,jsladeov@scribd.com,Product Engineer,9158,526,9684
19221,Bebe,Berthelmot,bberthelmotow@ocn.ne.jp,Librarian,1556,897,2453
19590,Audrie,Gorgl,agorgloy@bbc.co.uk,Technical Writer,3700,713,4413
19896,Lorenza,Kennedy,lkennedyp2@mysql.com,Recruiting Manager,8482,634,9116
19536,Anastasia,Jedraszek,ajedraszekp3@livejournal.com,Office Assistant IV,6696,780,7476
19454,Lilian,Hillaby,lhillabyp4@google.nl,Pharmacist,3052,1976,5028
19867,Lowrance,Alans,lalansp9@washingtonpost.com,Mechanical Systems Engineer,3601,1858,5459
19569,Townsend,Jozwicki,tjozwickipd@oakley.com,Software Engineer II,5326,816,6142
19998,Lesley,Desouza,ldesouzape@answers.com,Professor,3920,1218,5138
19060,Costa,Sherrocks,csherrockspi@ovh.net,Administrative Officer,6044,757,6801
19668,Rozanna,Filan,rfilanpj@amazon.de,Technical Writer,9302,1822,11124
19287,Paulie,Wanek,pwanekpl@alexa.com,Analog Circuit Design manager,2888,1324,4212
19593,Micah,Jorcke,mjorckepo@kickstarter.com,Occupational Therapist,7148,246,7394
19586,Nadeen,Harker,nharkerpp@list-manage.com,VP Accounting,5229,1936,7165
19310,Hanan,Fanning,hfanningpq@hao123.com,Product Engineer,2371,1182,3553
19324,Ignatius,Stickings,istickingspr@qq.com,Mechanical Systems Engineer,8562,1367,9929
19358,Genovera,Bushnell,gbushnellpu@nih.gov,Structural Analysis Engineer,2842,396,3238
19376,Kahaleel,Kobera,kkoberapv@gov.uk,Budget/Accounting Analyst III,2694,473,3167
19924,Perry,Duly,pdulypw@sakura.ne.jp,Software Engineer II,9860,206,10066
19475,Nicholas,Paley,npaleypz@tumblr.com,Senior Sales Associate,4071,1482,5553
19398,Fallon,Sieghart,fsieghartq5@mediafire.com,Analog Circuit Design manager,6625,640,7265
19529,Griffith,Vasyunin,gvasyuninq6@hexun.com,Financial Advisor,3588,1350,4938
19524,Audre,Kingsmill,akingsmillqb@umn.edu,Electrical Engineer,2907,1238,4145
19484,Leonerd,Cano,lcanoqc@dell.com,Executive Secretary,2527,1186,3713
19643,Tally,Conrath,tconrathqf@bigcartel.com,Marketing Assistant,4766,1364,6130
19367,Scott,Penrith,spenrithqg@admin.ch,Automation Specialist III,5118,364,5482
19660,Lane,Mahaddy,lmahaddyqi@typepad.com,Programmer Analyst II,4968,1644,6612
19437,Lawton,Terzi,lterziql@acquirethisname.com,Programmer III,1304,1970,3274
19566,Edmund,Blance,eblanceqm@list-manage.com,Senior Cost Accountant,3203,997,4200
19067,Marti,Rydzynski,mrydzynskiqp@rambler.ru,Nuclear Power Engineer,5805,1865,7670
19377,Dill,Frowen,dfrowenqq@lulu.com,Clinical Specialist,5833,526,6359
19394,Alexandr,Van Daalen,avandaalenqs@google.ru,Senior Developer,5668,1272,6940
19158,Reider,Putterill,rputterillqt@independent.co.uk,Software Engineer IV,2841,1564,4405
19749,Ellene,Jakeman,ejakemanqu@smugmug.com,Paralegal,6195,1820,8015
19838,Hercule,O'Heaney,hoheaneyqz@ted.com,Teacher,8599,810,9409
19480,Johnny,McIlvaney,jmcilvaneyr5@unesco.org,Administrative Officer,1600,1587,3187
19963,Janene,Bosch,jboschr6@nymag.com,Sales Representative,3417,1658,5075
19085,Ruddie,Breston,rbrestonrc@wsj.com,Statistician III,3872,1306,5178
19987,Zita,Testin,ztestinri@booking.com,Nuclear Power Engineer,8836,1762,10598
19850,Iago,Eilhersen,ieilhersenrj@youtube.com,Product Engineer,5877,1594,7471
19741,Dosi,Dockwra,ddockwrarm@networkadvertising.org,Cost Accountant,9762,626,10388
19746,Bree,Proswell,bproswellro@soup.io,VP Accounting,5204,1106,6310
19144,Annalise,Uccello,auccellorp@ucsd.edu,VP Product Management,4771,1577,6348
19514,Colas,Maud,cmaudrq@microsoft.com,Business Systems Development Analyst,9744,1338,11082
19411,Delcine,Fyrth,dfyrthrr@soup.io,Information Systems Manager,4707,1682,6389
20538,Kellie,Kermit,kkermit0@aboutads.info,Human Resources Assistant III,7581,1322,8903
20462,Lorilyn,Mattiuzzi,lmattiuzzi1@hostgator.com,Health Coach IV,8380,1599,9979
20669,Roberta,Cockett,rcockett2@craigslist.org,Design Engineer,8835,988,9823
20520,Sherwynd,Garaway,sgaraway3@51.la,Librarian,2436,1930,4366
20970,Shelly,Wellstood,swellstood4@unesco.org,Mechanical Systems Engineer,2553,1210,3763
20758,Jerrilyn,Pollins,jpollins5@jiathis.com,Structural Engineer,1746,513,2259
20390,Hetti,Minchinton,hminchinton6@biglobe.ne.jp,Administrative Officer,2810,1857,4667
20824,Crawford,Vasyunin,cvasyunin7@163.com,Assistant Media Planner,9543,233,9776
20106,Dominique,Headingham,dheadingham8@phpbb.com,Structural Analysis Engineer,5836,464,6300
20835,Tammy,Croxley,tcroxley9@pcworld.com,VP Marketing,2817,1635,4452
20391,Aguie,Bakster,abakstera@ihg.com,Programmer II,4630,858,5488
20188,Lulita,Gaylor,lgaylorb@themeforest.net,Analog Circuit Design manager,4417,946,5363
20213,Yelena,Arstall,yarstallc@wix.com,Programmer IV,5304,696,6000
20547,Maxie,Wennam,mwennamd@harvard.edu,Nuclear Power Engineer,5420,1073,6493
20815,Oona,Battaille,obattaillee@army.mil,Senior Financial Analyst,9515,833,10348
20605,Rhody,Sawkin,rsawkinf@123-reg.co.uk,Structural Engineer,8586,819,9405
20637,Kimberlyn,Morlon,kmorlong@jugem.jp,Tax Accountant,5387,624,6011
20848,Ilyse,Hakonsson,ihakonssonh@altervista.org,Operator,7707,1692,9399
20025,Tressa,Franzman,tfranzmani@epa.gov,Occupational Therapist,9073,1672,10745
20186,Rosaline,Figg,rfiggj@topsy.com,Senior Financial Analyst,7795,1691,9486
20858,Florie,Glavin,fglavink@rakuten.co.jp,Clinical Specialist,5669,1524,7193
20411,Kelcie,Scranedge,kscranedgel@kickstarter.com,Teacher,2133,1866,3999
20609,Cherise,Gogay,cgogaym@jimdo.com,Accounting Assistant I,3105,230,3335
20684,Debbi,Benditt,dbenditto@marriott.com,Teacher,2028,394,2422
20212,Montgomery,Cattle,mcattlep@engadget.com,General Manager,5912,1293,7205
20728,Aloisia,Gresch,agreschq@tripadvisor.com,Registered Nurse,3266,441,3707
20012,Andeee,Verdun,averdunr@clickbank.net,Accountant III,3317,614,3931
20105,Baudoin,Abbey,babbeys@tuttocitta.it,Quality Engineer,4697,1274,5971
20804,Etti,McLarnon,emclarnont@reuters.com,Environmental Specialist,5393,383,5776
20301,Brianna,Lodin,blodinu@dailymail.co.uk,Business Systems Development Analyst,1073,510,1583
20439,Chevalier,Showte,cshowtev@wordpress.com,Help Desk Technician,2102,1030,3132
20993,Melloney,Brunsdon,mbrunsdonw@artisteer.com,Senior Editor,6116,1167,7283
20265,Kelley,Yukhnov,kyukhnovx@google.co.jp,Physical Therapy Assistant,8614,1384,9998
20662,Anatola,Schnitter,aschnitterz@hp.com,Senior Financial Analyst,8273,1711,9984
20658,Curr,Leupold,cleupold10@reddit.com,Accountant I,7221,1595,8816
20061,Cleveland,Dain,cdain11@zdnet.com,Staff Accountant IV,8510,412,8922
20735,Rock,Castilla,rcastilla12@sun.com,Graphic Designer,8903,701,9604
20282,Janey,Postgate,jpostgate13@spotify.com,Senior Editor,1283,835,2118
20516,Damien,Bohden,dbohden14@wunderground.com,Editor,5404,430,5834
20004,Enriqueta,Deackes,edeackes15@dagondesign.com,Quality Engineer,7187,712,7899
20769,Verile,Order,vorder16@chicagotribune.com,Compensation Analyst,6272,1143,7415
20076,Bibby,Fridd,bfridd17@pbs.org,Structural Analysis Engineer,9723,1832,11555
20454,Berri,Dummer,bdummer18@harvard.edu,Legal Assistant,8199,204,8403
20327,Jannel,Crayke,jcrayke19@free.fr,Quality Engineer,5148,1750,6898
20332,Chickie,Gartan,cgartan1a@wordpress.com,Operator,6655,359,7014
20350,Walther,Follows,wfollows1b@sourceforge.net,Accountant IV,1228,332,1560
20941,Paul,Gosnell,pgosnell1c@wiley.com,GIS Technical Architect,8661,1479,10140
20611,Amerigo,Berard,aberard1d@geocities.jp,Nurse Practicioner,9331,875,10206
20766,Gayle,Coyish,gcoyish1e@google.cn,Information Systems Manager,2606,1673,4279
20641,Griff,Coyle,gcoyle1f@sogou.com,Accounting Assistant III,7655,1555,9210
20358,Roth,Stockton,rstockton1g@bravesites.com,Account Representative III,8908,1194,10102
20807,Maynord,Ubsdell,mubsdell1h@nydailynews.com,Business Systems Development Analyst,6045,1839,7884
20422,Winifield,Jacqueme,wjacqueme1i@drupal.org,Chemical Engineer,8373,1381,9754
20650,Berkie,Eggins,beggins1j@goodreads.com,Physical Therapy Assistant,6841,215,7056
20679,Hurlee,Chang,hchang1k@umich.edu,Sales Representative,2130,1598,3728
20673,Donnie,Lutwidge,dlutwidge1l@mapquest.com,Analyst Programmer,9960,248,10208
20300,Gherardo,Hedgeman,ghedgeman1m@ed.gov,Staff Scientist,3889,1257,5146
20737,Ellis,Gillhespy,egillhespy1n@google.cn,Teacher,9264,1858,11122
20481,Lorelei,Fowley,lfowley1o@amazon.co.jp,Sales Representative,9508,758,10266
20079,Chester,Olliar,colliar1r@ning.com,Legal Assistant,4138,1933,6071
20287,Marita,Carle,mcarle1s@oracle.com,Registered Nurse,8422,1823,10245
20196,Cory,Chisnell,cchisnell1t@google.fr,Accounting Assistant I,3260,957,4217
20874,Dorothea,Killner,dkillner1u@cocolog-nifty.com,Mechanical Systems Engineer,8181,1978,10159
20406,Virge,Langdon,vlangdon1v@who.int,General Manager,3370,521,3891
20808,Claudio,Node,cnode1w@upenn.edu,Software Consultant,7996,326,8322
20199,Beatrice,Ewdale,bewdale1x@twitpic.com,Geological Engineer,3126,1164,4290
20601,Marc,Leborgne,mleborgne1y@bravesites.com,Compensation Analyst,5884,677,6561
20389,Evangelia,De Luna,edeluna1z@liveinternet.ru,Graphic Designer,9373,1496,10869
20342,Earl,Relton,erelton20@cdbaby.com,Junior Executive,4704,1219,5923
20816,Mady,Coughlin,mcoughlin21@sbwire.com,Product Engineer,3735,349,4084
20931,Dukie,Lawlan,dlawlan22@multiply.com,Associate Professor,7394,1021,8415
20779,Claire,Rae,crae23@wp.com,Geologist III,2557,895,3452
20168,Faustine,Lyptrit,flyptrit25@reverbnation.com,Statistician IV,3177,1362,4539
20392,Rina,Jaskiewicz,rjaskiewicz26@theguardian.com,Product Engineer,8221,1023,9244
20345,Bianka,Hort,bhort27@cnet.com,Product Engineer,7079,980,8059
20015,Mandel,Alelsandrovich,malelsandrovich28@marketwatch.com,Accountant III,8305,872,9177
20030,Orelee,Bedding,obedding29@hexun.com,Software Engineer II,9100,1575,10675
20129,Jock,Vaskov,jvaskov2a@paginegialle.it,Project Manager,6103,780,6883
20261,Irwin,Carnew,icarnew2b@hud.gov,Financial Analyst,4264,268,4532
20773,Brittne,Lawrenz,blawrenz2c@trellian.com,Professor,5988,722,6710
20930,Noell,Dottrell,ndottrell2d@google.de,Teacher,5675,359,6034
20039,Danya,Jent,djent2e@deviantart.com,Graphic Designer,8298,510,8808
20303,Stanford,Frentz,sfrentz2h@issuu.com,Nurse,3264,915,4179
20900,Jaynell,Bonson,jbonson2i@samsung.com,Human Resources Assistant II,3015,776,3791
20640,Monte,Hakking,mhakking2j@ibm.com,Legal Assistant,2079,644,2723
20734,Titos,Nortcliffe,tnortcliffe2k@cisco.com,Staff Scientist,8985,1433,10418
20235,Dede,Moores,dmoores2l@t.co,VP Sales,9939,1495,11434
20181,Berkie,Danovich,bdanovich2m@elegantthemes.com,Professor,2371,305,2676
20302,Jedidiah,Marchetti,jmarchetti2n@wsj.com,Teacher,5737,1203,6940
20347,Nikki,Cawson,ncawson2o@smugmug.com,Desktop Support Technician,6722,427,7149
20412,Elvis,Basili,ebasili2q@typepad.com,Editor,6090,1950,8040
20876,Marcos,Steadman,msteadman2r@histats.com,Accounting Assistant IV,8869,1240,10109
20027,Dorene,Dedenham,ddedenham2s@163.com,Administrative Assistant IV,5587,945,6532
20494,Lucky,Lowings,llowings2t@techcrunch.com,Help Desk Technician,9988,396,10384
20589,Gideon,Sharkey,gsharkey2u@ucoz.com,Chief Design Engineer,4133,1710,5843
20002,Yoko,Hebbard,yhebbard2v@house.gov,Data Coordiator,2889,1149,4038
20334,Rex,Ferrige,rferrige2w@google.ru,Account Executive,2118,437,2555
20598,Cayla,MacCollom,cmaccollom2x@clickbank.net,Tax Accountant,2601,1033,3634
20607,Greta,Forsbey,gforsbey2y@cloudflare.com,Chief Design Engineer,9668,1409,11077
20500,Sibeal,Deakan,sdeakan2z@sourceforge.net,Analog Circuit Design manager,5420,1253,6673
20747,Kinsley,Anwyl,kanwyl30@parallels.com,Recruiter,3440,1326,4766
20596,Alley,Helks,ahelks31@unicef.org,Technical Writer,8902,612,9514
20185,Flory,Cissell,fcissell32@nba.com,Occupational Therapist,7698,724,8422
20434,Xenia,Elmore,xelmore34@youtu.be,Software Consultant,9109,1987,11096
20289,Jerrylee,Gudd,jgudd35@oakley.com,Food Chemist,9625,1746,11371
20906,Raina,Fishleigh,rfishleigh36@desdev.cn,Clinical Specialist,8296,1182,9478
20383,Sherline,Ivanov,sivanov38@berkeley.edu,Community Outreach Specialist,8429,1713,10142
20935,Pansie,Hartless,phartless3a@eepurl.com,Systems Administrator I,4923,1950,6873
20532,Cleavland,Rutgers,crutgers3b@devhub.com,Librarian,8238,225,8463
20635,Morganica,Setter,msetter3c@360.cn,Assistant Media Planner,1945,1898,3843
20654,Roslyn,Duignan,rduignan3d@bigcartel.com,Nurse,1453,1138,2591
20404,Fernanda,Rozycki,frozycki3f@state.gov,Accountant III,8046,612,8658
20340,Miquela,Hayward,mhayward3g@fda.gov,Social Worker,4395,1506,5901
20357,Elene,Batrim,ebatrim3h@bbb.org,Data Coordiator,8034,426,8460
20981,Kincaid,Keene,kkeene3j@deliciousdays.com,VP Sales,3651,1017,4668
20590,Clemmy,Meysham,cmeysham3k@aboutads.info,Quality Engineer,4280,1554,5834
20161,Urbano,Massinger,umassinger3l@microsoft.com,Research Nurse,8600,563,9163
20117,Hughie,Erni,herni3m@taobao.com,Sales Representative,7321,1946,9267
20600,Rivkah,Lindemann,rlindemann3n@elpais.com,General Manager,9181,877,10058
20279,Hewe,Farquar,hfarquar3p@aol.com,Safety Technician IV,8839,530,9369
20719,Caterina,Blackboro,cblackboro3q@pagesperso-orange.fr,General Manager,2568,497,3065
20060,Ivory,Obin,iobin3t@mediafire.com,Analyst Programmer,5101,545,5646
20852,Darin,Prigg,dprigg3u@nyu.edu,Associate Professor,5995,1107,7102
20140,Bartie,Nickels,bnickels3v@whitehouse.gov,Clinical Specialist,7673,1797,9470
20624,Ilario,Leefe,ileefe3w@oracle.com,Administrative Assistant I,9249,420,9669
20081,Werner,Bugge,wbugge3x@about.me,Analog Circuit Design manager,6187,1628,7815
20772,Miof mela,Indge,mindge3y@ucoz.ru,Compensation Analyst,1634,1272,2906
20251,Poul,Milnes,pmilnes3z@ifeng.com,Teacher,2649,371,3020
20800,Jodi,Mount,jmount40@utexas.edu,Structural Engineer,7541,1239,8780
20197,Marji,Triggel,mtriggel41@google.it,Human Resources Assistant IV,5461,277,5738
20694,Sky,Crewes,screwes42@icq.com,Recruiter,8386,1356,9742
20730,Dulcy,Gircke,dgircke43@1und1.de,Sales Representative,8075,1419,9494
20934,Midge,Iacobucci,miacobucci44@wikimedia.org,Tax Accountant,7647,1982,9629
20652,Darryl,Edgeler,dedgeler45@microsoft.com,Media Manager IV,1838,580,2418
20744,Geoffry,Neasam,gneasam46@freewebs.com,Office Assistant II,3709,879,4588
20460,Rafaello,Sline,rsline47@alexa.com,VP Accounting,4976,1866,6842
20049,Jemimah,Brakespear,jbrakespear48@vkontakte.ru,Account Executive,2840,1448,4288
20450,Simone,MacArthur,smacarthur49@prlog.org,Computer Systems Analyst I,5759,847,6606
20465,Denna,Greenhalgh,dgreenhalgh4a@blogs.com,Executive Secretary,5190,1101,6291
20006,Nalani,Jamary,njamary4b@alibaba.com,Staff Scientist,5999,1602,7601
20782,Monro,MacCrachen,mmaccrachen4c@github.io,Executive Secretary,8140,948,9088
20991,Temple,Lennie,tlennie4d@tinyurl.com,Health Coach II,8822,695,9517
20467,Anastassia,Fildery,afildery4f@independent.co.uk,Junior Executive,1308,1059,2367
20582,Jaquenette,Worsell,jworsell4g@dagondesign.com,Geologist IV,9963,1434,11397
20653,Maynord,Keighly,mkeighly4h@barnesandnoble.com,Assistant Manager,4421,843,5264
20746,Ettore,Elwel,eelwel4i@cyberchimps.com,Recruiting Manager,6521,1810,8331
20507,Daryl,Batson,dbatson4j@businesswire.com,Civil Engineer,2261,1574,3835
20155,Terrill,Dabbs,tdabbs4k@webeden.co.uk,Software Engineer II,9095,266,9361
20062,Norbert,McSaul,nmcsaul4l@naver.com,Research Assistant III,5056,935,5991
20174,Wain,Shepcutt,wshepcutt4m@google.com.hk,Safety Technician III,6102,1517,7619
20447,Pren,Bremner,pbremner4n@gnu.org,Pharmacist,6539,1575,8114
20996,Prentiss,Vaney,pvaney4p@cargocollective.com,Dental Hygienist,5323,1992,7315
20567,Giacomo,Pilfold,gpilfold4q@google.de,Research Nurse,2718,244,2962
20924,Ivory,Cuchey,icuchey4r@goodreads.com,Quality Engineer,1673,1293,2966
20825,Brodie,Olivetta,bolivetta4s@sitemeter.com,Product Engineer,4407,278,4685
20686,Valera,Paynter,vpaynter4t@ow.ly,Software Consultant,3718,750,4468
20291,Syd,Chrystie,schrystie4u@newsvine.com,Business Systems Development Analyst,4564,1790,6354
20139,Leisha,Greenan,lgreenan4v@zdnet.com,Computer Systems Analyst III,2633,1446,4079
20623,Corissa,Streat,cstreat4w@hatena.ne.jp,Programmer IV,3205,1449,4654
20157,Elmira,Gaskarth,egaskarth4x@tumblr.com,Financial Advisor,6211,502,6713
20070,Horace,Fibben,hfibben4y@quantcast.com,Technical Writer,2755,1700,4455
20632,Claus,Andreichik,candreichik50@va.gov,Programmer II,6830,1691,8521
20394,Hewe,Gorries,hgorries51@quantcast.com,Desktop Support Technician,4653,493,5146
20471,Deb,Rock,drock52@cocolog-nifty.com,Dental Hygienist,2075,1394,3469
20296,Danell,Kubacek,dkubacek53@yellowbook.com,Web Developer III,2397,1084,3481
20328,Pierson,Simone,psimone54@nature.com,Nurse,2502,1081,3583
20755,Nanny,Menendez,nmenendez55@theatlantic.com,Director of Sales,6403,437,6840
20832,Sigfried,Tomasicchio,stomasicchio57@japanpost.jp,Biostatistician I,4689,1787,6476
20100,Tessi,Timmermann,ttimmermann58@toplist.cz,Senior Financial Analyst,4553,1093,5646
20823,Cynthia,Macro,cmacro59@reverbnation.com,VP Accounting,9750,1237,10987
21000,Ariadne,Ellingford,aellingford5a@soup.io,Safety Technician IV,8225,1530,9755
20983,Arly,Colby,acolby5b@taobao.com,Senior Quality Engineer,8948,963,9911
20205,Coralyn,Boulding,cboulding5c@altervista.org,Database Administrator III,6374,1680,8054
20774,Austina,Wickmann,awickmann5d@state.tx.us,Design Engineer,4776,1149,5925
20359,Tobie,Eckart,teckart5f@harvard.edu,Data Coordiator,9717,710,10427
20966,Gabriell,Skone,gskone5g@people.com.cn,VP Marketing,7312,321,7633
20458,Gerri,Buntain,gbuntain5h@about.me,Professor,9497,605,10102
20131,Coral,Golsworthy,cgolsworthy5i@deviantart.com,VP Marketing,4562,1101,5663
20085,Tammie,Briand,tbriand5j@cdbaby.com,Sales Representative,4085,1278,5363
20948,Kissee,Zanetti,kzanetti5k@dagondesign.com,Software Test Engineer II,1956,1812,3768
20367,Angel,Bartolomeotti,abartolomeotti5m@artisteer.com,Senior Quality Engineer,6639,1225,7864
20701,Cathe,Olyff,colyff5n@squarespace.com,Accountant III,3972,944,4916
20156,Nappy,Alu,nalu5p@intel.com,Accounting Assistant II,7161,1520,8681
20559,Addie,Curneen,acurneen5q@t.co,Assistant Professor,4544,1930,6474
20842,Jesselyn,D'Ugo,jdugo5r@w3.org,Analog Circuit Design manager,2735,317,3052
20093,Rivi,Tinham,rtinham5s@europa.eu,Operator,1899,941,2840
20164,Steffie,Birtwisle,sbirtwisle5t@ow.ly,Computer Systems Analyst I,5406,906,6312
20928,Herb,Gouldthorp,hgouldthorp5v@elpais.com,Software Engineer IV,3092,1717,4809
20024,Jessamyn,Wanderschek,jwanderschek5w@addtoany.com,Paralegal,1747,1322,3069
20089,D'arcy,Rubinsaft,drubinsaft5x@scribd.com,General Manager,9268,510,9778
20578,Anselm,Davidove,adavidove5y@nhs.uk,Clinical Specialist,4994,1652,6646
20250,Retha,Elgie,relgie5z@privacy.gov.au,Research Assistant I,1851,1854,3705
20953,Petr,Coltart,pcoltart60@example.com,Registered Nurse,1212,1395,2607
20339,Bourke,Hathway,bhathway61@i2i.jp,Food Chemist,8744,826,9570
20785,Symon,Abrahmovici,sabrahmovici62@ihg.com,VP Product Management,4162,1187,5349
20731,Brant,Preddy,bpreddy64@prnewswire.com,Senior Sales Associate,4795,728,5523
20736,Susan,Aimson,saimson65@php.net,Administrative Assistant III,2576,1064,3640
20249,Isidora,Hillock,ihillock66@facebook.com,Paralegal,9379,1382,10761
20295,Lena,Osinin,losinin67@ucoz.com,GIS Technical Architect,4346,552,4898
20274,Janeczka,Borer,jborer68@hatena.ne.jp,Marketing Manager,4820,1099,5919
20992,Jackie,Tutchings,jtutchings6b@nydailynews.com,Help Desk Operator,7445,660,8105
20344,Jess,Standring,jstandring6c@1688.com,Account Executive,7087,601,7688
20877,Lou,Perillio,lperillio6d@gov.uk,Account Representative III,6004,496,6500
20472,Hermione,Tittletross,htittletross6e@walmart.com,Tax Accountant,5533,526,6059
20599,Manya,Outridge,moutridge6f@narod.ru,Registered Nurse,5336,1919,7255
20167,Kenton,Pendlington,kpendlington6g@salon.com,Senior Financial Analyst,8082,935,9017
20068,Jerald,Rotherforth,jrotherforth6h@va.gov,Physical Therapy Assistant,1173,1146,2319
20218,Bili,Culpin,bculpin6i@scientificamerican.com,Associate Professor,7462,655,8117
20663,Ahmad,Tommasetti,atommasetti6j@theglobeandmail.com,Account Coordinator,5879,615,6494
20537,Beverley,Dahlen,bdahlen6k@zimbio.com,Media Manager III,9039,257,9296
20845,Kirsti,Adenet,kadenet6l@ow.ly,Technical Writer,4300,1245,5545
20549,Andie,Wartnaby,awartnaby6m@bloomberg.com,Database Administrator II,8292,1622,9914
20614,Johann,Mattusevich,jmattusevich6n@jimdo.com,Director of Sales,2505,1037,3542
20656,Norean,Stang-Gjertsen,nstanggjertsen6o@archive.org,Engineer III,6739,1734,8473
20421,Peri,Iddison,piddison6p@ow.ly,Chemical Engineer,3503,1246,4749
20104,Kirby,Glentworth,kglentworth6r@multiply.com,Mechanical Systems Engineer,8762,1495,10257
20095,Culley,Domnick,cdomnick6s@umich.edu,Health Coach IV,9235,1617,10852
20427,Ettore,Short,eshort6t@addtoany.com,VP Accounting,3180,878,4058
20724,Adda,Farryan,afarryan6v@va.gov,Analyst Programmer,4276,1694,5970
20486,Denys,Hedde,dhedde6w@imdb.com,Operator,2337,650,2987
20533,Lin,Ossipenko,lossipenko6x@odnoklassniki.ru,Health Coach I,7411,391,7802
20135,Phaidra,Mc Faul,pmcfaul6z@behance.net,Quality Engineer,5171,462,5633
20751,Taite,Hallen,thallen70@cbsnews.com,Web Developer II,1574,1060,2634
20219,Carlotta,Boutwell,cboutwell71@usgs.gov,Electrical Engineer,9650,536,10186
20077,Ethan,Balducci,ebalducci74@godaddy.com,Librarian,8133,1391,9524
20183,Jacobo,Arsnell,jarsnell75@nature.com,Analog Circuit Design manager,4901,662,5563
20280,Rosalyn,Mauvin,rmauvin76@google.cn,Marketing Manager,9174,901,10075
20307,Lorrin,Yuryshev,lyuryshev77@icq.com,Research Assistant III,4699,1846,6545
20997,Judas,Dober,jdober78@blogger.com,Accountant II,4747,1145,5892
20020,Maurizia,Patterfield,mpatterfield79@google.fr,Structural Engineer,7393,1916,9309
20119,Caryl,Arstingall,carstingall7a@xrea.com,Statistician I,7469,1664,9133
20043,Tedman,Simonyi,tsimonyi7b@naver.com,Professor,6917,838,7755
20032,Lindy,Janssens,ljanssens7d@google.com,Recruiter,5694,1949,7643
20490,Bron,Crohan,bcrohan7e@feedburner.com,Internal Auditor,6615,1286,7901
20088,Malachi,Bertolin,mbertolin7f@loc.gov,Registered Nurse,9296,1816,11112
20072,Angelo,Deakan,adeakan7g@webs.com,Cost Accountant,5107,223,5330
20950,Marcelo,Dumbrill,mdumbrill7h@mozilla.com,Sales Representative,9829,637,10466
20240,Becki,Hamlin,bhamlin7i@imdb.com,Actuary,6874,783,7657
20461,Cullen,Papachristophorou,cpapachristophorou7j@google.com.hk,Help Desk Technician,1741,645,2386
20428,Ad,Boobier,aboobier7k@craigslist.org,Senior Sales Associate,2552,1073,3625
20718,Lemar,Jerram,ljerram7l@soundcloud.com,Health Coach II,9664,1950,11614
20883,Rochella,Heinle,rheinle7m@tamu.edu,Help Desk Operator,4722,793,5515
20563,Gradey,Rushsorth,grushsorth7n@barnesandnoble.com,Quality Control Specialist,4903,428,5331
20124,Sean,Rapi,srapi7o@multiply.com,Project Manager,2557,1760,4317
20084,Risa,Greenly,rgreenly7p@sogou.com,Account Representative IV,1473,680,2153
20974,Kalvin,Maly,kmaly7q@dailymail.co.uk,Nurse Practicioner,6678,937,7615
20158,Clementina,Kauschke,ckauschke7r@google.it,Biostatistician I,4668,1308,5976
20469,Munmro,Batch,mbatch7s@mapquest.com,Senior Editor,6999,1429,8428
20872,Earle,O'Hannen,eohannen7u@google.ca,Environmental Tech,1478,474,1952
20401,Nikolai,Mailes,nmailes7v@hibu.com,Accountant III,7594,1550,9144
20482,Perry,Yankin,pyankin7x@google.it,VP Accounting,2267,1945,4212
20103,Matteo,Heggadon,mheggadon7y@1und1.de,Sales Representative,1889,1583,3472
20368,Aubree,Gatman,agatman7z@howstuffworks.com,Paralegal,5443,1074,6517
20346,Francesca,Genicke,fgenicke81@devhub.com,Administrative Assistant II,1390,1593,2983
20962,Brucie,Vickars,bvickars83@myspace.com,Automation Specialist III,8815,221,9036
20435,Hugo,Itzkovitch,hitzkovitch84@xrea.com,Professor,5851,932,6783
20080,Abbye,Mudie,amudie87@harvard.edu,Account Representative III,3133,1016,4149
20844,Ottilie,Dahlberg,odahlberg88@skyrock.com,Financial Analyst,2330,1109,3439
20864,Lewes,Philipet,lphilipet89@angelfire.com,Technical Writer,5199,915,6114
20979,Iago,Bunner,ibunner8a@soup.io,Structural Engineer,5771,453,6224
20440,Berton,Trundle,btrundle8b@salon.com,Biostatistician I,8193,527,8720
20965,Hunter,Wisniewski,hwisniewski8c@mayoclinic.com,Account Representative IV,8752,1436,10188
20283,Thomasina,Pinder,tpinder8d@google.cn,Dental Hygienist,3164,1528,4692
20887,Tonia,Sorey,tsorey8e@jalbum.net,Paralegal,2312,686,2998
20504,Nye,Martinetto,nmartinetto8f@plala.or.jp,Software Consultant,8597,984,9581
20956,Ninon,Nottle,nnottle8i@epa.gov,Registered Nurse,4492,937,5429
20947,Kriste,Vyse,kvyse8n@google.nl,Director of Sales,3091,753,3844
20478,Pamelina,Chessor,pchessor8o@fema.gov,Biostatistician III,4227,614,4841
20995,Brenna,Ferreli,bferreli8p@discuz.net,Research Nurse,6708,1731,8439
20474,Homerus,Vigneron,hvigneron8q@tripadvisor.com,Data Coordiator,5781,1174,6955
20797,Colline,Axtonne,caxtonne8t@washingtonpost.com,Teacher,7588,1440,9028
20159,Clem,Ganders,cganders8w@psu.edu,Compensation Analyst,3118,927,4045
20309,Daffi,Mathew,dmathew8x@xrea.com,Environmental Specialist,5477,795,6272
20314,Nert,Barnewall,nbarnewall8y@jimdo.com,Nuclear Power Engineer,5540,413,5953
20696,Ruthi,Clemenceau,rclemenceau8z@w3.org,Financial Advisor,2823,684,3507
20429,Briggs,Jendrassik,bjendrassik90@tmall.com,Internal Auditor,9759,759,10518
20967,Lynda,Fidell,lfidell91@gov.uk,VP Product Management,8151,303,8454
20225,Serge,Keitch,skeitch92@google.de,Biostatistician I,9607,463,10070
20323,Paxon,Meynell,pmeynell93@thetimes.co.uk,VP Marketing,9620,612,10232
20241,Isacco,Fawlkes,ifawlkes94@chronoengine.com,Office Assistant II,3537,1732,5269
20616,Leslie,Fairbridge,lfairbridge95@linkedin.com,Quality Control Specialist,2544,513,3057
20313,Livvy,Hatch,lhatch97@vimeo.com,Marketing Manager,3038,1235,4273
20978,Octavia,O'Hagan,oohagan98@arizona.edu,Occupational Therapist,7148,1534,8682
20535,Elvis,Ballendine,eballendine99@va.gov,General Manager,4576,1553,6129
20271,Miriam,Cockrem,mcockrem9b@google.ca,Account Representative II,6548,1497,8045
20630,Mercedes,Gallehock,mgallehock9c@springer.com,Senior Cost Accountant,6839,1793,8632
20920,Alessandro,Umpleby,aumpleby9d@ca.gov,Sales Representative,9202,982,10184
20723,Sharity,Hazeup,shazeup9e@acquirethisname.com,Community Outreach Specialist,2816,1981,4797
20442,Allsun,O'Feeney,aofeeney9f@amazon.co.jp,Cost Accountant,3747,1668,5415
20067,Steve,Landsbury,slandsbury9g@europa.eu,Financial Analyst,9003,499,9502
20568,Roshelle,Stoyles,rstoyles9h@japanpost.jp,Editor,6486,848,7334
20522,Emmanuel,Brinded,ebrinded9i@wisc.edu,Quality Engineer,5148,1673,6821
20763,Desiri,Peart,dpeart9j@tiny.cc,Human Resources Assistant II,5643,1724,7367
20552,Massimo,Henkens,mhenkens9k@1und1.de,VP Marketing,7658,1878,9536
20379,Magdalene,Marsy,mmarsy9l@nhs.uk,Graphic Designer,3617,470,4087
20828,Ira,Gynne,igynne9m@vkontakte.ru,Cost Accountant,6018,296,6314
20944,Sianna,Frays,sfrays9n@nih.gov,Executive Secretary,9639,1060,10699
20078,Berty,Le febre,blefebre9p@ftc.gov,Speech Pathologist,7681,670,8351
20643,Jemimah,Rangeley,jrangeley9q@ycombinator.com,Analog Circuit Design manager,6042,918,6960
20665,Joyan,Lindwasser,jlindwasser9r@printfriendly.com,Geologist IV,3298,1006,4304
20927,Brigida,Gittens,bgittens9s@ed.gov,Nuclear Power Engineer,4623,1753,6376
20508,Benjy,Grayshan,bgrayshan9t@theguardian.com,Nurse,5415,1606,7021
20064,Trumann,Wakeford,twakeford9u@bloglines.com,Account Coordinator,5848,1987,7835
20717,Heriberto,Chavrin,hchavrin9w@wsj.com,Geological Engineer,4602,1912,6514
20757,Karmen,Geraudel,kgeraudel9z@purevolume.com,Internal Auditor,8020,797,8817
20562,Harrison,Avo,havoa1@comcast.net,Assistant Professor,2202,1863,4065
20221,Rosalynd,Shooter,rshootera2@biglobe.ne.jp,Sales Representative,6526,1013,7539
20275,Farand,Solley,fsolleya3@shareasale.com,Office Assistant IV,3166,556,3722
20097,Delcina,Yirrell,dyirrella4@wikipedia.org,Office Assistant III,9378,1370,10748
20144,Filberte,Fransinelli,ffransinellia5@goo.ne.jp,Senior Cost Accountant,3982,1203,5185
20284,Arly,Bastin,abastina7@freewebs.com,Director of Sales,2877,1745,4622
20268,Harlan,Kellog,hkelloga8@cyberchimps.com,Office Assistant III,2439,1812,4251
20029,Florencia,Philippson,fphilippsonab@time.com,Biostatistician I,1194,814,2008
20203,Norrie,Wenham,nwenhamad@google.cn,Biostatistician IV,3918,426,4344
20788,Alla,Masselin,amasselinae@jalbum.net,Sales Associate,3094,1012,4106
20057,Dukey,Rudyard,drudyardaf@github.io,Social Worker,6472,1851,8323
20688,Joby,Vina,jvinaag@imgur.com,Senior Developer,4192,1263,5455
20022,Zahara,Skpsey,zskpseyai@amazon.co.jp,Systems Administrator II,6443,1781,8224
20053,Jaymie,Giacovetti,jgiacovettiaj@toplist.cz,Professor,7537,662,8199
20397,Linn,Leggan,llegganak@google.com.br,Product Engineer,5417,1102,6519
20897,Jackson,Lammert,jlammertal@techcrunch.com,Food Chemist,8399,1782,10181
20889,Orland,Steeples,osteeplesao@auda.org.au,Project Manager,2987,1599,4586
20514,Peri,Seden,psedenar@opensource.org,Environmental Specialist,1643,1459,3102
20315,Hank,Vaughton,hvaughtonas@bing.com,Internal Auditor,5781,1331,7112
20263,Nedi,Mattersley,nmattersleyau@example.com,Financial Analyst,4828,715,5543
20239,Job,Stirrip,jstirripaz@craigslist.org,Software Engineer I,1374,213,1587
20419,Belvia,Kuller,bkullerb0@dropbox.com,Geological Engineer,7540,1346,8886
20163,Blondy,Curley,bcurleyb1@4shared.com,Analog Circuit Design manager,4896,1965,6861
20403,Iggy,oldey,ioldeyb5@psu.edu,Junior Executive,8202,1643,9845
20306,Bert,Deeley,bdeeleyb6@1und1.de,VP Quality Control,9311,375,9686
20687,Mar,Leynton,mleyntonb8@va.gov,Staff Accountant IV,2912,1171,4083
20233,Audi,Headley,aheadleyb9@dmoz.org,Biostatistician IV,2843,1643,4486
20802,Kaitlin,Pocknell,kpocknellba@sfgate.com,VP Quality Control,9144,583,9727
20382,Lena,Cheverell,lcheverellbb@cisco.com,Environmental Specialist,2036,1715,3751
20437,Beulah,Allom,ballombc@chronoengine.com,Chemical Engineer,3207,205,3412
20952,Wilhelmine,Cotterell,wcotterellbd@ibm.com,Financial Analyst,6031,1253,7284
20756,Carolin,Bergeau,cbergeaubg@sbwire.com,Cost Accountant,5581,1775,7356
20510,Arabella,Grubey,agrubeybj@shinystat.com,Teacher,5319,1963,7282
20134,Linn,Nealy,lnealybl@weebly.com,VP Marketing,8178,1663,9841
20430,Ashien,Scrannage,ascrannagebm@theguardian.com,Librarian,2570,1330,3900
20709,Merle,Kleinert,mkleinertbn@theatlantic.com,Programmer III,2426,623,3049
20362,Meredeth,Curr,mcurrbp@vistaprint.com,Nurse,6592,1009,7601
20642,Chryste,Cornes,ccornesbq@seesaa.net,Product Engineer,7182,1057,8239
20365,Esme,Lindblad,elindbladbs@cisco.com,Software Consultant,2578,1507,4085
20316,Myrah,Ketchaside,mketchasidebt@angelfire.com,Director of Sales,1388,1476,2864
20040,Tedra,Harrild,tharrildbu@yelp.com,Chief Design Engineer,8820,422,9242
20791,Carline,Selwyne,cselwynebv@sohu.com,Health Coach I,8265,1048,9313
20620,Gabey,Extil,gextilbw@usgs.gov,Operator,7334,1212,8546
20272,Cass,Eddy,ceddybx@yandex.ru,Actuary,6400,1711,8111
20618,Siouxie,Behnke,sbehnkeby@free.fr,Web Developer I,1965,401,2366
20415,Marlin,Gauld,mgauldbz@drupal.org,Biostatistician III,1712,329,2041
20907,Whitaker,Edgson,wedgsonc0@last.fm,Quality Engineer,1962,1259,3221
20837,Jacynth,Featherstone,jfeatherstonec1@newyorker.com,Financial Analyst,9075,311,9386
20165,Gage,Frowde,gfrowdec4@discovery.com,Data Coordiator,4676,800,5476
20565,Law,Allmark,lallmarkc5@e-recht24.de,VP Quality Control,4798,1865,6663
20645,Bianca,McMurrugh,bmcmurrughc8@umich.edu,Safety Technician I,4022,247,4269
20378,Ralina,Tilberry,rtilberryc9@prlog.org,VP Quality Control,7369,1168,8537
20127,Minetta,Giaomozzo,mgiaomozzoca@dion.ne.jp,Senior Developer,2716,1236,3952
20326,Vina,Harcus,vharcuscc@comsenz.com,Assistant Professor,8327,921,9248
20554,Humphrey,Armsden,harmsdencd@cmu.edu,Software Test Engineer III,8682,1780,10462
20762,Nolana,Kibbel,nkibbelce@stanford.edu,Technical Writer,4645,737,5382
20445,Michele,Glasman,mglasmanch@youtube.com,Clinical Specialist,8148,837,8985
20855,Georgette,Seaborn,gseabornci@vimeo.com,Environmental Specialist,7540,1717,9257
20910,Ricard,Blunsom,rblunsomcm@alibaba.com,Social Worker,7241,1901,9142
20776,Olenka,Ingold,oingoldcp@tinyurl.com,Civil Engineer,2921,944,3865
20917,Nick,Lathaye,nlathayecq@wufoo.com,Desktop Support Technician,1581,1075,2656
20267,Brietta,Elger,belgercr@un.org,Senior Financial Analyst,2883,1763,4646
20692,Chance,Lavrinov,clavrinovcu@soup.io,Desktop Support Technician,1628,538,2166
20033,Tadeo,Caves,tcavescv@lulu.com,Editor,4347,628,4975
20752,Clay,Halsall,chalsallcx@elegantthemes.com,Senior Sales Associate,5703,1016,6719
20789,Felix,Nunnerley,fnunnerleycy@hostgator.com,Health Coach II,1722,440,2162
20891,Hoebart,Laxtonne,hlaxtonnecz@technorati.com,Sales Representative,4988,886,5874
20330,Marissa,Capell,mcapelld2@mayoclinic.com,Nuclear Power Engineer,6721,1719,8440
20958,Karylin,McCarly,kmccarlyd3@comcast.net,Pharmacist,9718,258,9976
20231,Martainn,Laxston,mlaxstond5@gov.uk,Help Desk Technician,8736,651,9387
20976,Fields,Goodridge,fgoodridged6@g.co,Systems Administrator III,8410,1039,9449
20384,Maximilien,Yerrill,myerrilld7@elegantthemes.com,Nurse Practicioner,2559,588,3147
20715,Ginnifer,Hillam,ghillamd8@spotify.com,Programmer Analyst II,4489,1589,6078
20894,Karia,Badby,kbadbyd9@ocn.ne.jp,Internal Auditor,1562,539,2101
20011,Dniren,Pilger,dpilgerda@samsung.com,Web Developer I,7048,681,7729
20951,Giacomo,Lerwill,glerwilldc@twitpic.com,Chief Design Engineer,3799,1861,5660
20531,Hilary,Cruse,hcrusede@people.com.cn,Structural Analysis Engineer,8025,469,8494
20107,Cori,Leeson,cleesondf@netlog.com,Quality Engineer,9326,1220,10546
20001,Ezri,Stanning,estanningdh@youtu.be,Account Executive,4804,1889,6693
20151,Elita,Seymer,eseymerdj@hhs.gov,Account Executive,8888,1245,10133
20576,Vivienne,Warman,vwarmandm@youtu.be,Research Associate,7537,1306,8843
20457,Koren,Wyne,kwynedn@ebay.co.uk,Operator,2365,289,2654
20519,Morgan,Godbehere,mgodbeheredo@state.gov,Food Chemist,1127,1207,2334
20007,Rick,Cockshoot,rcockshootdp@theguardian.com,Clinical Specialist,8264,936,9200
20052,Leesa,Brocklehurst,lbrocklehurstdr@123-reg.co.uk,Research Associate,8697,704,9401
20476,Grant,Hartill,ghartilldu@cnbc.com,Operator,1479,795,2274
20366,Egon,Beaconsall,ebeaconsalldy@hud.gov,Recruiter,9313,1940,11253
20182,Joyan,Hurd,jhurddz@globo.com,Programmer I,8977,1519,10496
20857,Emmi,Szreter,eszretere1@hc360.com,Structural Engineer,4891,950,5841
20515,Cinderella,Cloney,ccloneye2@huffingtonpost.com,Programmer I,8654,1004,9658
20046,Thedrick,Channing,tchanninge3@amazon.co.uk,Nurse Practicioner,3613,502,4115
20683,Lindie,Trevan,ltrevane4@naver.com,Editor,1518,280,1798
20236,Huey,Brommage,hbrommagee8@blogspot.com,Biostatistician I,4850,238,5088
20770,Merle,Woolatt,mwoolatte9@omniture.com,Project Manager,1707,417,2124
20990,Dorothee,Paylie,dpaylieea@rediff.com,Nurse Practicioner,2309,1534,3843
20058,Katie,Ort,korteb@godaddy.com,Mechanical Systems Engineer,2109,331,2440
20047,Barbette,Tweddell,btweddellec@delicious.com,Data Coordiator,4859,1284,6143
20121,Clementina,Blune,cbluneef@discuz.net,Environmental Specialist,3142,1828,4970
20473,Edlin,Proback,eprobackeg@ustream.tv,Quality Engineer,2944,954,3898
20133,Ailbert,McGaraghan,amcgaraghaneh@elpais.com,Biostatistician III,2513,1611,4124
20943,Shanna,Thaw,sthawei@home.pl,VP Quality Control,5460,572,6032
20527,Lane,Croan,lcroanek@skype.com,Director of Sales,4724,406,5130
20984,Mathilda,Hamments,mhammentsel@homestead.com,Financial Analyst,2966,1329,4295
20402,Chick,Chambers,cchambersen@addtoany.com,Product Engineer,5263,1735,6998
20243,Margette,Synnot,msynnoteo@globo.com,Account Executive,4428,663,5091
20247,Jude,Byass,jbyasses@posterous.com,Information Systems Manager,3528,647,4175
20126,Bird,Giorgetti,bgiorgettieu@wordpress.org,Computer Systems Analyst I,9717,1773,11490
20035,Laurens,Hayman,lhaymanew@chicagotribune.com,Senior Quality Engineer,5159,416,5575
20016,Parsifal,Ledgerton,pledgertoney@vistaprint.com,Senior Quality Engineer,5765,798,6563
20689,Deeyn,Hewkin,dhewkinf0@domainmarket.com,Recruiting Manager,2289,1864,4153
20933,Cosetta,Edgeson,cedgesonf5@ehow.com,Graphic Designer,6421,958,7379
20400,Skippy,Vasyaev,svasyaevf9@digg.com,Internal Auditor,6828,1047,7875
20945,Sibeal,Benbow,sbenbowfa@google.pl,VP Quality Control,7761,1314,9075
20008,Essie,Terese,eteresefb@mysql.com,Senior Cost Accountant,6733,1268,8001
20708,Norbie,Hopkynson,nhopkynsonfc@nba.com,Payment Adjustment Coordinator,6039,772,6811
20859,Carlynn,Say,csayfe@toplist.cz,Safety Technician IV,8050,871,8921
20259,Derrik,Tangye,dtangyeff@mysql.com,Recruiting Manager,9267,1340,10607
20335,Igor,Hatherall,ihatherallfh@prweb.com,Accountant IV,5089,410,5499
20884,Floria,Cars,fcarsfj@uol.com.br,Sales Associate,9319,968,10287
20448,Arte,Marler,amarlerfk@creativecommons.org,Budget/Accounting Analyst II,1314,1346,2660
20651,Wyatan,Depper,wdepperfl@acquirethisname.com,Senior Financial Analyst,6905,322,7227
20502,Ellary,Ashwood,eashwoodfn@seattletimes.com,Help Desk Operator,8046,1561,9607
20705,Casey,Scathard,cscathardfp@google.ca,Programmer Analyst IV,7828,1766,9594
20849,Evangelia,Baudino,ebaudinofr@timesonline.co.uk,Quality Engineer,4699,257,4956
20972,Ingunna,Tantrum,itantrumft@hubpages.com,Clinical Specialist,4720,1190,5910
20228,Margarette,Risson,mrissonfy@cisco.com,Statistician I,4089,488,4577
20850,Fons,Mussared,fmussaredfz@bizjournals.com,Web Developer IV,1900,1539,3439
20146,Cindi,Echlin,cechling1@xing.com,Nurse,9920,664,10584
20693,Wendell,Bertlin,wbertling2@dell.com,Project Manager,7071,1390,8461
20528,Carree,Galsworthy,cgalsworthyg5@networksolutions.com,Programmer Analyst IV,6766,768,7534
20517,Charlotte,Trace,ctraceg6@sourceforge.net,Registered Nurse,6289,1008,7297
20720,Christoper,Scotson,cscotsong7@ucla.edu,Paralegal,9229,658,9887
20210,Raquela,Reddings,rreddingsg8@delicious.com,Information Systems Manager,8867,268,9135
20463,Mariya,Huett,mhuettg9@samsung.com,Food Chemist,7669,1816,9485
20961,Alexis,Hobgen,ahobgenga@linkedin.com,Account Coordinator,3985,878,4863
20627,Si,Nockells,snockellsgb@house.gov,Software Engineer IV,8687,1108,9795
20613,Shelley,Lodovichi,slodovichigc@prnewswire.com,Teacher,8882,610,9492
20321,Gabe,Janota,gjanotagf@bing.com,VP Sales,8525,1257,9782
20281,Khalil,Whorlow,kwhorlowgg@theguardian.com,Analog Circuit Design manager,1643,237,1880
20034,Lucinda,Skentelbury,lskentelburygh@google.com,Software Test Engineer II,7180,1921,9101
20636,Floyd,Davidai,fdavidaigj@sourceforge.net,Structural Engineer,9643,1347,10990
20893,Cortney,Imesson,cimessongk@comcast.net,Speech Pathologist,9315,544,9859
20668,Ed,Huygens,ehuygensgl@netscape.com,Librarian,2391,1418,3809
20707,Gwynne,Evensden,gevensdengm@dmoz.org,VP Quality Control,8572,1257,9829
20308,Wilie,Koeppke,wkoeppkegn@archive.org,Research Assistant III,8535,1348,9883
20256,Babette,Attenburrow,battenburrowgp@boston.com,Senior Quality Engineer,1092,1513,2605
20257,Lydia,Lawtie,llawtiegq@marketwatch.com,Financial Analyst,3000,788,3788
20795,Audra,Cartman,acartmangu@goo.ne.jp,Business Systems Development Analyst,4279,1451,5730
20592,Kellby,Chasle,kchaslegv@seattletimes.com,Computer Systems Analyst III,4459,813,5272
20610,Felike,Livard,flivardgw@linkedin.com,Administrative Officer,4384,1634,6018
20868,Nicol,Doolan,ndoolangy@guardian.co.uk,Biostatistician III,5741,732,6473
20760,Hollie,O'Sheilds,hosheildsh2@altervista.org,Recruiter,8348,1610,9958
20162,Ana,McKern,amckernh3@printfriendly.com,Programmer III,6739,1403,8142
20074,Antonella,Gouny,agounyh6@blogspot.com,Information Systems Manager,4178,1243,5421
20320,Alec,Brittain,abrittainh8@skyrock.com,Environmental Specialist,5796,931,6727
20555,Ivette,Pougher,ipougherhd@chron.com,Product Engineer,4909,988,5897
20799,Robena,Edling,redlinghf@tinypic.com,Administrative Assistant I,9725,929,10654
20706,Humberto,Dulanty,hdulantyhh@yellowbook.com,Editor,9903,1915,11818
20586,Dasie,Keson,dkesonhj@prweb.com,Civil Engineer,8421,1326,9747
20810,Kaitlynn,Bartozzi,kbartozzihk@mail.ru,Design Engineer,7533,1079,8612
20130,Gladi,O'Criane,gocrianehl@wikia.com,General Manager,4045,1562,5607
20741,Wallie,Lurriman,wlurrimanhn@yelp.com,Senior Sales Associate,3931,792,4723
20198,Morgen,Larcombe,mlarcombehq@jugem.jp,Financial Analyst,7900,797,8697
20912,Rey,Lello,rlellohr@constantcontact.com,Software Test Engineer II,4521,1350,5871
20936,Helga,Bauldrey,hbauldreyht@wikimedia.org,VP Marketing,4638,1083,5721
20553,Cordelia,Tibbetts,ctibbettshv@irs.gov,Community Outreach Specialist,3912,1941,5853
20177,Ethelyn,Eckert,eeckerthx@123-reg.co.uk,Nuclear Power Engineer,9560,1170,10730
20071,Mary,Tremelling,mtremellinghy@infoseek.co.jp,Paralegal,7185,1417,8602
20615,Thurston,Bignold,tbignoldhz@diigo.com,Developer III,5196,1774,6970
20153,Bentley,Armal,barmalie@ning.com,VP Marketing,5934,878,6812
20540,Margo,Stockman,mstockmanif@miibeian.gov.cn,Librarian,7042,1323,8365
20575,Daffie,Cattel,dcattelii@patch.com,Developer III,3283,1440,4723
20892,Jenda,Grain,jgrainik@posterous.com,Nurse,8192,864,9056
20028,Devora,Sheard,dsheardin@gov.uk,Account Representative IV,3425,737,4162
20834,Thane,Caddell,tcaddelliq@princeton.edu,Web Designer III,7282,1898,9180
20054,Mordy,Nassau,mnassauir@ebay.co.uk,Nurse,7027,663,7690
20677,Maribelle,Wilgar,mwilgarit@businessweek.com,Geologist III,4319,670,4989
20985,Dur,Mollene,dmolleneiy@macromedia.com,VP Accounting,7759,366,8125
20184,Norris,Merdew,nmerdewiz@mozilla.com,Software Test Engineer III,5194,1431,6625
20449,Ashien,Vahl,avahlj0@gnu.org,Operator,1334,1908,3242
20373,Marie,Mingasson,mmingassonj1@yellowpages.com,Graphic Designer,7161,1594,8755
20690,Ddene,Greenrodd,dgreenroddj2@storify.com,Sales Associate,9705,732,10437
20530,Gae,Andryushchenko,gandryushchenkoj4@jimdo.com,Dental Hygienist,7968,517,8485
20659,Gisela,Villar,gvillarj5@narod.ru,Statistician I,6778,556,7334
20484,Betty,Kibbee,bkibbeej7@bbc.co.uk,VP Marketing,3040,949,3989
20023,Eartha,Vandrill,evandrillj9@exblog.jp,GIS Technical Architect,7243,1899,9142
20937,Othello,Millbank,omillbankja@simplemachines.org,Assistant Manager,8961,1838,10799
20604,Leia,Ritter,lritterjc@goo.gl,Marketing Assistant,7479,1143,8622
20150,Andre,Jump,ajumpjf@marriott.com,Quality Control Specialist,3493,1153,4646
20242,Lynn,Wickrath,lwickrathjh@zimbio.com,Account Coordinator,8469,432,8901
20634,Corinne,Messam,cmessamji@cornell.edu,Geological Engineer,3246,222,3468
20019,Babette,Braam,bbraamjj@cnet.com,Design Engineer,9143,1842,10985
20940,Hercules,Eadington,headingtonjk@prlog.org,Senior Financial Analyst,5324,1126,6450
20801,Jobina,Brewis,jbrewisjl@theglobeandmail.com,Research Nurse,4155,1290,5445
20899,Karl,McPike,kmcpikejm@friendfeed.com,Help Desk Operator,6832,1592,8424
20010,Wendall,Ralls,wrallsjn@1und1.de,Director of Sales,9627,623,10250
20644,Judie,Farfull,jfarfulljo@instagram.com,Administrative Assistant II,9145,1518,10663
20639,Nikolaos,Pindar,npindarjr@twitpic.com,Financial Advisor,7567,503,8070
20479,Pru,Chiplen,pchiplenjx@netscape.com,Geological Engineer,3156,1332,4488
20685,Emelen,Quennell,equennelljz@flavors.me,Research Associate,8705,1922,10627
20541,Gabrielle,Jakubczyk,gjakubczykk0@hatena.ne.jp,Developer II,6398,363,6761
20865,Christabel,Featenby,cfeatenbyk1@whitehouse.gov,Staff Scientist,5578,1988,7566
20160,Emlyn,De Morena,edemorenak2@delicious.com,Internal Auditor,4597,1208,5805
20666,Jada,Leal,jlealk3@printfriendly.com,Quality Engineer,2532,1408,3940
20602,Ivory,Rase,irasek6@dell.com,Director of Sales,7401,1954,9355
20207,Krysta,Eagar,keagarka@ca.gov,Developer III,1132,1065,2197
20649,Blythe,Kasperski,bkasperskikb@biblegateway.com,Senior Cost Accountant,3045,1080,4125
20885,Alexandro,Huggens,ahuggenske@dropbox.com,Recruiter,8717,512,9229
20232,Muffin,Alner,malnerkf@mtv.com,Sales Associate,1147,394,1541
20418,Papageno,Jencken,pjenckenkg@oracle.com,Financial Analyst,7136,954,8090
20794,Edna,de Clerq,edeclerqkh@exblog.jp,Electrical Engineer,7292,730,8022
20803,Olivero,Garcia,ogarciaki@bandcamp.com,Payment Adjustment Coordinator,8697,1439,10136
20612,Tillie,De Bischof,tdebischofkj@spotify.com,Junior Executive,2526,1713,4239
20138,Lissy,Elster,lelsterkm@mail.ru,Help Desk Technician,2117,1795,3912
20237,Alfy,Augie,aaugiekn@skyrock.com,Statistician II,2103,440,2543
20793,Chan,Mowsdale,cmowsdaleko@hibu.com,Assistant Professor,2223,456,2679
20204,Valentin,Hydes,vhydeskq@istockphoto.com,Graphic Designer,9177,1867,11044
20812,Ethe,Chitty,echittyks@opera.com,Data Coordiator,9572,264,9836
20655,Kelila,Rizzi,krizzikv@behance.net,Engineer I,5815,1952,7767
20838,Desmond,Behan,dbehankx@utexas.edu,VP Marketing,5132,1414,6546
20416,Lombard,Langrick,llangrickl0@networksolutions.com,Database Administrator III,4700,1313,6013
20464,Cyrille,Salmons,csalmonsl3@admin.ch,Actuary,3377,1985,5362
20051,Alec,Owbridge,aowbridgel8@sun.com,Office Assistant IV,5326,1461,6787
20048,Johan,Eveque,jevequel9@twitpic.com,Director of Sales,4423,335,4758
20101,Molli,Juzek,mjuzekla@infoseek.co.jp,GIS Technical Architect,3530,1147,4677
20660,Arlina,Stillwell,astillwelllb@edublogs.org,Operator,3555,1870,5425
20066,Ximenes,Shambroke,xshambrokele@blogs.com,Quality Control Specialist,8641,540,9181
20187,Rodolfo,Adolfson,radolfsonlf@icq.com,Professor,5239,1941,7180
20436,Brit,Duffield,bduffieldlh@sohu.com,Health Coach IV,4879,947,5826
20761,Gussi,Blakeslee,gblakesleelk@lycos.com,Software Engineer II,5692,1620,7312
20444,Neall,Thrower,nthrowerlm@bluehost.com,Computer Systems Analyst II,9677,1516,11193
20056,Ade,Diaper,adiaperlp@goo.gl,VP Quality Control,6064,1563,7627
20426,Urbain,Bowcock,ubowcocklu@google.de,Analog Circuit Design manager,5116,1514,6630
20110,Syman,Esbrook,sesbrooklv@wp.com,VP Product Management,6403,930,7333
20041,Robinet,Coneron,rconeronly@merriam-webster.com,Quality Control Specialist,8389,1716,10105
20780,Lawton,Bartke,lbartkelz@irs.gov,Assistant Manager,8465,1376,9841
20778,Fifi,Aysik,faysikm3@amazon.co.jp,Clinical Specialist,6189,1361,7550
20191,Ginny,Druett,gdruettm4@wired.com,Librarian,6547,893,7440
20971,Reinhold,Tatum,rtatumm7@statcounter.com,Compensation Analyst,5563,1081,6644
20216,Demetris,Freeman,dfreemanm8@homestead.com,Safety Technician III,1901,1745,3646
20922,Maximilien,Assante,massantemi@aboutads.info,Chemical Engineer,9638,443,10081
20745,Tedd,Brydie,tbrydiemj@ibm.com,Nuclear Power Engineer,2561,562,3123
20125,Roselia,Goodlud,rgoodludmm@whitehouse.gov,Office Assistant IV,4887,694,5581
20091,Astrix,Mertsching,amertschingmo@nba.com,Social Worker,1659,1075,2734
20407,Amye,Assante,aassantemq@soundcloud.com,Automation Specialist I,1445,397,1842
20108,Meridith,Sermin,mserminmy@theatlantic.com,Accountant II,1714,771,2485
20860,Ciel,Siaskowski,csiaskowskimz@technorati.com,Paralegal,3927,270,4197
20841,Nikita,Rackham,nrackhamn4@newsvine.com,Software Test Engineer III,9404,475,9879
20881,Valentine,Kernaghan,vkernaghann5@macromedia.com,Geological Engineer,6194,956,7150
20376,Rodd,Gathercole,rgathercolenc@google.es,Desktop Support Technician,8719,1997,10716
20083,Carolus,Danett,cdanettnd@tinypic.com,Help Desk Technician,2323,456,2779
20511,Robinetta,Scotchbourouge,rscotchbourougene@prnewswire.com,Software Engineer I,2427,1557,3984
20886,Wilhelmine,Currum,wcurrumng@behance.net,Human Resources Manager,1429,878,2307
20545,Dexter,Newhouse,dnewhousenh@thetimes.co.uk,GIS Technical Architect,6991,527,7518
20483,Dusty,Troth,dtrothnl@wired.com,Programmer Analyst IV,8881,1674,10555
20374,Lenora,Crebo,lcrebonr@cyberchimps.com,Help Desk Technician,1101,1452,2553
20704,Pepe,Ewbanke,pewbankens@cpanel.net,Staff Accountant II,9693,1867,11560
20192,Bartholemy,Giannini,bgiannininu@chronoengine.com,Nurse,7976,821,8797
20853,Wait,Neame,wneamenw@csmonitor.com,General Manager,7158,1573,8731
20278,Lavina,Dable,ldableny@wisc.edu,Web Designer III,9226,1246,10472
20031,Larry,Umbert,lumberto3@geocities.jp,Chief Design Engineer,1046,738,1784
20870,Halette,Jantel,hjantelo7@sciencedaily.com,Registered Nurse,3272,1751,5023
20954,Danna,Surmeyer,dsurmeyero9@google.fr,Recruiting Manager,8371,1857,10228
20230,Bryana,D'Alwis,bdalwisob@list-manage.com,Marketing Manager,9172,1413,10585
20432,Ettie,Bursnall,ebursnalloc@ask.com,Financial Advisor,6001,499,6500
20667,Rebbecca,Comben,rcombenoe@nasa.gov,Actuary,1670,1539,3209
20468,Maxwell,Cornill,mcornilloh@reddit.com,Operator,6372,341,6713
20017,Zachery,St Clair,zstclairom@istockphoto.com,Administrative Assistant IV,2735,644,3379
20529,Adore,Calam,acalamoo@unc.edu,Financial Analyst,2899,224,3123
20364,Cullan,Aslen,caslenoq@blog.com,Chief Design Engineer,9392,1792,11184
20252,Dorella,Eadington,deadingtonov@patch.com,GIS Technical Architect,8346,1789,10135
20324,Deedee,Bour,dbourox@zdnet.com,Civil Engineer,9972,1996,11968
20856,Minta,Ascrofte,mascroftep1@blog.com,VP Marketing,3359,1060,4419
20727,Friedrich,Francklyn,ffrancklynp2@weibo.com,Director of Sales,8538,1120,9658
20729,Manfred,Malletratt,mmalletrattp4@fc2.com,Actuary,2195,1517,3712
20921,Urbano,Websdale,uwebsdalep5@census.gov,GIS Technical Architect,2966,1752,4718
20819,Eldon,Giacomi,egiacomip6@furl.net,Engineer I,7833,1023,8856
20571,Verge,Floyed,vfloyedp8@wikipedia.org,Systems Administrator IV,6677,1519,8196
20606,Roxi,Doughartie,rdoughartiepa@disqus.com,Sales Representative,4477,502,4979
20363,Nisse,Dummer,ndummerpc@virginia.edu,Business Systems Development Analyst,4545,559,5104
20968,Eolande,Hugnin,ehugninpd@yolasite.com,Mechanical Systems Engineer,4783,1160,5943
20255,Hope,Petto,hpettopf@qq.com,Design Engineer,2648,1715,4363
20698,Ulric,Boynes,uboynespg@xing.com,Software Engineer II,9708,1617,11325
20980,Charlie,Fleetham,cfleethamph@arstechnica.com,General Manager,7983,1231,9214
20523,Brynna,Dendon,bdendonpi@yahoo.co.jp,Junior Executive,2654,1042,3696
20820,Spenser,Spurgeon,sspurgeonpj@eepurl.com,VP Quality Control,3194,377,3571
20293,Ruthie,Baudry,rbaudrypk@github.com,Administrative Officer,4931,751,5682
20423,Onfre,Levane,olevanepm@gravatar.com,Developer I,8089,1662,9751
20890,Giffer,Breawood,gbreawoodpn@facebook.com,Data Coordiator,7431,1016,8447
20513,Hetti,Tillard,htillardpo@springer.com,Librarian,8064,454,8518
20505,Eliot,Yegorovnin,eyegorovninpq@tripod.com,Analog Circuit Design manager,8712,889,9601
20497,Meredith,Owain,mowainpr@omniture.com,Dental Hygienist,6308,627,6935
20209,Reginald,Danby,rdanbypx@over-blog.com,Human Resources Assistant II,9354,1114,10468
20700,Jena,Muncey,jmunceypz@elpais.com,Speech Pathologist,9374,285,9659
20360,Milton,Fee,mfeeq0@clickbank.net,Research Nurse,4712,864,5576
20417,Daffi,Pailin,dpailinq2@usda.gov,Human Resources Manager,5784,783,6567
20286,Cody,Methven,cmethvenq3@sphinn.com,Chemical Engineer,6589,662,7251
20128,Maris,Lassey,mlasseyq5@hhs.gov,Engineer I,7663,687,8350
20297,Marie-jeanne,Hessentaler,mhessentalerq8@ted.com,Technical Writer,8883,632,9515
20065,Lisle,Whenham,lwhenhamqc@disqus.com,Computer Systems Analyst IV,8552,1530,10082
20633,Francisca,McLurg,fmclurgqe@typepad.com,Desktop Support Technician,7701,786,8487
20050,Janeta,Dy,jdyqg@cnet.com,Legal Assistant,7174,294,7468
20393,Abigale,Frohock,afrohockqk@ebay.com,VP Marketing,3354,220,3574
20577,Derby,Jannaway,djannawayqr@github.com,Junior Executive,9358,761,10119
20714,Karylin,Birtle,kbirtleqv@sfgate.com,Senior Editor,6463,1739,8202
20331,Elias,Corrao,ecorraoqw@sakura.ne.jp,Internal Auditor,7762,930,8692
20456,Arlette,Dabell,adabellqz@hao123.com,Senior Cost Accountant,9633,824,10457
20986,Vasili,Castagna,vcastagnar0@msn.com,Business Systems Development Analyst,1915,1647,3562
20055,Olwen,Layman,olaymanr2@weibo.com,VP Accounting,5442,580,6022
20680,Loreen,Linnell,llinnellr9@clickbank.net,Analyst Programmer,3587,1075,4662
20254,Nicolea,Tighe,ntighera@shop-pro.jp,Marketing Manager,8123,1665,9788
20796,Leia,Soldner,lsoldnerrb@tumblr.com,Data Coordiator,4790,1297,6087
20396,Em,MacDavitt,emacdavittrf@multiply.com,Budget/Accounting Analyst IV,3572,922,4494
20294,Jase,Tweedy,jtweedyrg@g.co,Media Manager IV,8366,1157,9523
20546,Pauly,Lowrance,plowrancerh@reddit.com,Project Manager,4161,877,5038
20908,Damaris,Martellini,dmartelliniri@blogger.com,Junior Executive,2348,224,2572
20862,Teressa,Saffer,tsafferrn@issuu.com,Database Administrator II,3983,1476,5459
20722,Raynard,Nuton,rnutonrr@state.gov,Teacher,6895,679,7574
21899,Sloan,Cruz,scruz0@skype.com,Social Worker,2056,1127,3183
21771,Brody,Kester,bkester1@wired.com,Executive Secretary,7943,1037,8980
21550,Daryle,Fetherby,dfetherby2@rediff.com,Professor,7316,1845,9161
21371,Nicky,Longford,nlongford3@webs.com,Programmer I,5502,1789,7291
21980,Rem,Dowker,rdowker4@google.co.jp,Software Test Engineer I,8792,278,9070
21897,Bertie,Madeley,bmadeley5@epa.gov,Marketing Assistant,2635,746,3381
21238,Marianna,Colston,mcolston6@4shared.com,Help Desk Operator,1527,1065,2592
21643,Janos,Ricarde,jricarde7@qq.com,Biostatistician III,5403,1286,6689
21781,Calypso,Mansbridge,cmansbridge8@webeden.co.uk,Quality Control Specialist,2297,992,3289
21923,Merrile,Oliveti,moliveti9@csmonitor.com,Human Resources Manager,4095,556,4651
21044,Stanford,Hickin,shickina@google.cn,Programmer Analyst I,9447,495,9942
21642,Patten,Dawks,pdawksb@hp.com,Senior Sales Associate,8239,689,8928
21558,Estel,Losel,eloselc@usatoday.com,Technical Writer,9239,1073,10312
21944,Grethel,Whyley,gwhyleyd@desdev.cn,Dental Hygienist,8048,344,8392
21134,Frederich,Ireson,firesone@buzzfeed.com,Database Administrator III,2503,313,2816
21377,Mitchel,Haeslier,mhaeslierf@ed.gov,Director of Sales,7094,346,7440
21203,Betty,Rubinfeld,brubinfeldg@netvibes.com,Graphic Designer,6306,710,7016
21882,Lainey,Toothill,ltoothillh@rakuten.co.jp,Geologist III,5474,1878,7352
21182,Roslyn,Giraudat,rgiraudati@accuweather.com,Biostatistician I,1346,1859,3205
21269,Bobby,Standing,bstandingj@unc.edu,Food Chemist,1998,1842,3840
21434,Florian,Nissle,fnisslek@sitemeter.com,Assistant Manager,5005,697,5702
21644,Caroline,Comberbach,ccomberbachl@reference.com,Software Test Engineer III,5992,458,6450
21366,Peri,Cluely,pcluelym@java.com,Assistant Professor,4781,1221,6002
21017,Michelina,Sauvage,msauvagen@theatlantic.com,Biostatistician IV,8432,496,8928
21671,Ardeen,Ragbourn,aragbourno@hp.com,Help Desk Technician,8127,1231,9358
21263,Teodora,Leven,tlevenp@github.com,Paralegal,6498,219,6717
21289,Harland,Gergher,hgergherq@lycos.com,Account Coordinator,6661,1639,8300
21811,Murdoch,Jeannesson,mjeannessonr@home.pl,Senior Quality Engineer,7561,449,8010
21964,Sherilyn,Lancetter,slancetters@edublogs.org,Research Associate,3101,820,3921
21906,Audy,Fareweather,afareweathert@google.ca,Programmer Analyst IV,8909,1260,10169
21561,Bastien,Reicherz,breicherzu@barnesandnoble.com,Geologist I,7663,1659,9322
21193,Jacques,Barles,jbarlesv@oakley.com,VP Quality Control,2165,1954,4119
21221,Caron,Colles,ccollesw@bizjournals.com,Director of Sales,4772,1845,6617
21069,Lonna,Boshard,lboshardx@pbs.org,Clinical Specialist,3682,1720,5402
21257,Obidiah,Koeppe,okoeppey@amazonaws.com,Paralegal,6292,450,6742
21492,Ned,Galletley,ngalletleyz@bravesites.com,VP Sales,2946,539,3485
21005,Silvana,Grimble,sgrimble10@ebay.co.uk,Chemical Engineer,2364,1850,4214
21940,Calv,Mathys,cmathys11@reuters.com,Occupational Therapist,1818,1717,3535
21223,Vince,Curtois,vcurtois12@arstechnica.com,Research Nurse,4880,877,5757
21892,Charmian,Kemshell,ckemshell13@jalbum.net,Chief Design Engineer,3506,736,4242
21687,Gizela,Bittlestone,gbittlestone14@google.es,Project Manager,8017,410,8427
21992,Winonah,Farrens,wfarrens15@ca.gov,Payment Adjustment Coordinator,8936,1938,10874
21830,Feodor,Stare,fstare16@shop-pro.jp,Paralegal,1747,687,2434
21030,Leontine,Wayne,lwayne17@usda.gov,Design Engineer,2094,914,3008
21730,Corrie,Morrell,cmorrell18@umn.edu,Recruiting Manager,9874,644,10518
21959,Melamie,Reavell,mreavell19@mapy.cz,Programmer IV,5341,1549,6890
21549,Isidro,Loy,iloy1a@slideshare.net,Sales Representative,6969,1807,8776
21529,Jules,Measham,jmeasham1b@tinyurl.com,Editor,3349,577,3926
21822,Reid,Cattermull,rcattermull1c@ustream.tv,Director of Sales,8907,820,9727
21670,Lauritz,Jirousek,ljirousek1d@illinois.edu,Clinical Specialist,6909,932,7841
21059,Benita,Gibbings,bgibbings1e@wix.com,Analyst Programmer,9274,1980,11254
21375,Oralla,Jacob,ojacob1f@ycombinator.com,Geological Engineer,3861,1238,5099
21310,Corbin,Binton,cbinton1g@berkeley.edu,Quality Control Specialist,9358,1846,11204
21225,Christoffer,Backhouse,cbackhouse1i@rediff.com,Statistician II,3777,951,4728
21141,Hendrika,Del Monte,hdelmonte1j@oracle.com,Recruiting Manager,5152,1651,6803
21022,Kaleb,Traill,ktraill1k@hatena.ne.jp,Database Administrator I,9716,956,10672
21825,Babara,Woodhouse,bwoodhouse1l@flavors.me,Tax Accountant,7081,1451,8532
21361,Hube,Camings,hcamings1m@odnoklassniki.ru,VP Sales,2401,474,2875
21693,Rosemonde,Righy,rrighy1n@paginegialle.it,Administrative Officer,7228,356,7584
21232,Eachelle,Fetherby,efetherby1o@blog.com,Human Resources Assistant I,2247,890,3137
21421,Martelle,Marven,mmarven1p@cbc.ca,Assistant Media Planner,9709,209,9918
21025,Sosanna,Shippam,sshippam1q@berkeley.edu,Office Assistant I,6534,1319,7853
21653,Dennie,Facey,dfacey1r@salon.com,Chief Design Engineer,1827,1538,3365
21297,Martainn,Wagstaff,mwagstaff1s@sciencedaily.com,Financial Analyst,4488,1795,6283
21194,Chelsy,Fairest,cfairest1t@va.gov,Clinical Specialist,8334,1485,9819
21972,Beverlie,Ibbitt,bibbitt1u@engadget.com,Nurse Practicioner,6783,1095,7878
21312,Alonzo,Wandless,awandless1v@yellowbook.com,Business Systems Development Analyst,6555,298,6853
21937,Gwenore,Cushelly,gcushelly1w@histats.com,VP Product Management,9067,1393,10460
21041,Fey,Willmetts,fwillmetts1x@sciencedirect.com,Chemical Engineer,3244,824,4068
21309,Elliot,Bicknell,ebicknell1y@yelp.com,VP Marketing,4551,1444,5995
21318,Maxie,Applebee,mapplebee1z@tamu.edu,Assistant Media Planner,2732,1077,3809
21345,Garth,Whimpenny,gwhimpenny20@boston.com,Software Consultant,1079,1398,2477
21317,Sal,Petrollo,spetrollo22@wix.com,Registered Nurse,9109,411,9520
21261,Erminie,Leeds,eleeds23@wikimedia.org,Help Desk Operator,9615,1386,11001
21841,Riccardo,Brighty,rbrighty24@archive.org,Software Engineer IV,3600,1349,4949
21740,Hinda,Domingues,hdomingues25@skype.com,Information Systems Manager,6542,1962,8504
21448,Lela,Long,llong26@godaddy.com,Operator,8645,802,9447
21758,Ariel,Winsor,awinsor28@europa.eu,General Manager,3612,460,4072
21508,Haskell,Kersley,hkersley29@ocn.ne.jp,Business Systems Development Analyst,6820,395,7215
21097,Ernie,Swan,eswan2a@icq.com,Associate Professor,4858,1070,5928
21986,Terri-jo,Pyrton,tpyrton2b@last.fm,Paralegal,2085,436,2521
21844,Nollie,Cornelis,ncornelis2c@opera.com,Marketing Manager,7963,389,8352
21096,Rodolphe,Waycott,rwaycott2d@etsy.com,Dental Hygienist,6269,717,6986
21329,Kyrstin,Kingescot,kkingescot2e@tiny.cc,Graphic Designer,8266,1739,10005
21547,Seymour,Wollrauch,swollrauch2f@nsw.gov.au,Developer I,9506,403,9909
21411,Adolf,Annwyl,aannwyl2g@cloudflare.com,Librarian,7676,1179,8855
21403,Windy,Ghio,wghio2h@xing.com,Senior Developer,7203,1275,8478
21137,Verine,Larose,vlarose2i@newyorker.com,Environmental Specialist,3100,1437,4537
21710,Shay,Moule,smoule2j@vk.com,Assistant Manager,5389,1997,7386
21362,Ahmed,Tharme,atharme2k@wikia.com,Clinical Specialist,2223,1484,3707
21804,Erich,Chidlow,echidlow2l@indiatimes.com,VP Marketing,7717,1662,9379
21339,Vonnie,Mueller,vmueller2m@epa.gov,Pharmacist,4041,438,4479
21524,Carmella,Gossage,cgossage2n@hud.gov,Sales Representative,5326,570,5896
21112,Brennen,O'Hickee,bohickee2o@phpbb.com,Assistant Media Planner,1859,616,2475
21218,Adolf,Strete,astrete2p@e-recht24.de,Recruiter,4533,1332,5865
21396,Julio,Postan,jpostan2q@bbb.org,Dental Hygienist,6938,1377,8315
21588,Wenonah,Broom,wbroom2r@sfgate.com,Financial Advisor,1217,607,1824
21080,Denis,Duck,dduck2s@ucsd.edu,Chief Design Engineer,3449,884,4333
21862,Harv,Tivnan,htivnan2t@hp.com,Social Worker,8458,397,8855
21455,Ailyn,Geroldi,ageroldi2u@marketwatch.com,Safety Technician IV,9918,480,10398
21095,Eddie,Mounsie,emounsie2v@cdbaby.com,Desktop Support Technician,7548,368,7916
21135,Vinson,Lidster,vlidster2w@google.ru,Biostatistician III,1346,1038,2384
21649,Matteo,Plume,mplume2x@businesswire.com,Speech Pathologist,6087,846,6933
21698,Katrinka,Fitzharris,kfitzharris2y@issuu.com,VP Product Management,4724,1749,6473
21782,Leann,Smaling,lsmaling2z@reuters.com,Research Nurse,6748,1206,7954
21611,Callie,Speight,cspeight30@alexa.com,Mechanical Systems Engineer,6562,617,7179
21066,Launce,Geraldo,lgeraldo31@tuttocitta.it,Financial Advisor,4555,1207,5762
21905,Les,Lambot,llambot32@wordpress.org,Civil Engineer,5276,355,5631
21801,Inessa,Olerenshaw,iolerenshaw33@zdnet.com,Database Administrator III,6973,1248,8221
21881,Alyda,Skirvane,askirvane34@google.com,Social Worker,6690,1555,8245
21214,Wendell,Peckitt,wpeckitt35@wix.com,Operator,4352,555,4907
21180,Alfredo,O'Bradane,aobradane36@istockphoto.com,Graphic Designer,4248,1126,5374
21039,Rori,Navein,rnavein37@gnu.org,Research Assistant I,6475,243,6718
21188,Kale,Devey,kdevey38@army.mil,Librarian,3338,395,3733
21839,Sky,Vallentine,svallentine39@jiathis.com,Help Desk Operator,8592,1660,10252
21280,Henrietta,Bevens,hbevens3a@ezinearticles.com,Food Chemist,2068,1252,3320
21389,Nicole,Ladel,nladel3b@acquirethisname.com,Sales Representative,7787,919,8706
21127,Ossie,Aldus,oaldus3c@house.gov,Senior Editor,1606,1080,2686
21587,Galina,Coomber,gcoomber3d@slate.com,Senior Cost Accountant,8453,847,9300
21380,Briney,Szachniewicz,bszachniewicz3e@addtoany.com,Account Executive,6404,761,7165
21004,Ginni,Sayton,gsayton3f@ft.com,Sales Representative,9474,1173,10647
21338,Yehudit,Genn,ygenn3g@mashable.com,Legal Assistant,7770,1641,9411
21553,Kimbell,Olyunin,kolyunin3h@smh.com.au,VP Marketing,7738,913,8651
21733,Roxy,Peterson,rpeterson3i@yellowpages.com,Senior Sales Associate,6420,1847,8267
21702,Lisetta,Digle,ldigle3j@msu.edu,Research Nurse,2437,380,2817
21880,Oby,Lantiffe,olantiffe3k@nymag.com,Research Assistant I,7460,558,8018
21516,Noby,Rottenbury,nrottenbury3l@irs.gov,Marketing Manager,4839,1113,5952
21999,Roxy,Ruckert,rruckert3m@samsung.com,Account Executive,6277,1177,7454
21183,Merell,Ponten,mponten3n@deliciousdays.com,VP Product Management,8474,1620,10094
21995,Mose,Masterman,mmasterman3o@4shared.com,Director of Sales,4410,1186,5596
21201,Gabe,Eagleton,geagleton3p@cnbc.com,Recruiting Manager,1173,356,1529
21169,Doralin,Shercliff,dshercliff3q@java.com,Senior Sales Associate,3515,1125,4640
21610,Lilian,Skerman,lskerman3r@free.fr,Administrative Officer,9305,1495,10800
21711,Mahmoud,Sauniere,msauniere3s@europa.eu,Senior Editor,4228,1127,5355
21304,Gussie,Hyrons,ghyrons3t@tinyurl.com,Staff Scientist,3315,1585,4900
21415,Rene,Nequest,rnequest3u@gmpg.org,Statistician IV,4794,302,5096
21884,Tabbi,Espine,tespine3v@mlb.com,VP Quality Control,4250,830,5080
21798,Randal,Spread,rspread3w@senate.gov,Administrative Officer,7942,1810,9752
21385,Bev,Caulket,bcaulket3x@huffingtonpost.com,Accounting Assistant I,6391,1760,8151
21187,Merissa,Whatman,mwhatman3y@hc360.com,Actuary,8914,377,9291
21717,Belia,Hitzke,bhitzke3z@paypal.com,Developer IV,6734,1947,8681
21879,Kalvin,Hellyer,khellyer40@desdev.cn,Information Systems Manager,5103,1958,7061
21484,Olly,Molian,omolian41@seattletimes.com,Engineer IV,9102,948,10050
21083,Felicio,Charlwood,fcharlwood43@blogtalkradio.com,Environmental Tech,6456,728,7184
21265,Anica,Risebarer,arisebarer44@constantcontact.com,Recruiting Manager,8002,1237,9239
21086,Linette,Kairns,lkairns45@dmoz.org,Web Developer IV,2340,1719,4059
21526,Gusta,Emlyn,gemlyn46@seattletimes.com,Paralegal,6103,1822,7925
21869,Agnella,Speak,aspeak47@elegantthemes.com,Engineer IV,4333,530,4863
21003,Davy,Ferrari,dferrari48@sun.com,Engineer III,8515,871,9386
21453,Rhetta,Donaldson,rdonaldson49@berkeley.edu,Pharmacist,9938,1306,11244
21913,Nani,Gorrissen,ngorrissen4a@omniture.com,Operator,5299,1960,7259
21769,Sabra,Dannohl,sdannohl4b@amazon.co.jp,Operator,9801,1809,11610
21786,Tiffanie,Hurleston,thurleston4c@wiley.com,GIS Technical Architect,6261,663,6924
21117,Kizzee,Reeders,kreeders4d@archive.org,Chief Design Engineer,6479,732,7211
21826,Vonnie,Gynne,vgynne4e@woothemes.com,Account Representative III,8726,1383,10109
21226,Reidar,Seale,rseale4g@guardian.co.uk,Statistician II,6605,600,7205
21357,Rozanne,Kimmince,rkimmince4j@lulu.com,Geologist I,3402,315,3717
21589,Salli,Drayson,sdrayson4m@microsoft.com,Safety Technician I,3396,372,3768
21690,Aeriell,Hayward,ahayward4n@edublogs.org,Help Desk Technician,1757,752,2509
21441,Desiree,Scolding,dscolding4o@storify.com,Structural Analysis Engineer,1933,1162,3095
21038,Sharona,Brumbie,sbrumbie4p@wikia.com,Automation Specialist II,4219,313,4532
21286,Corbie,Overpool,coverpool4q@sciencedirect.com,Programmer Analyst I,7461,613,8074
21410,Verine,Stovold,vstovold4r@paginegialle.it,Software Test Engineer III,4214,562,4776
21794,Mimi,Brownill,mbrownill4s@youtu.be,Human Resources Manager,8365,1248,9613
21132,Cullen,McTerrelly,cmcterrelly4t@youtube.com,Technical Writer,3193,1288,4481
21809,Kathleen,Janicek,kjanicek4u@timesonline.co.uk,Senior Financial Analyst,4862,1638,6500
21079,Joshuah,Rugg,jrugg4w@unc.edu,Biostatistician IV,7445,840,8285
21120,Malvin,Conrad,mconrad4x@ca.gov,Cost Accountant,4959,562,5521
21624,Chaddie,Banbrook,cbanbrook4y@sun.com,Civil Engineer,2994,206,3200
21321,Abie,McClinton,amcclinton4z@spotify.com,Operator,7368,1945,9313
21228,Nannie,Cuerdall,ncuerdall51@sitemeter.com,Help Desk Technician,7177,1662,8839
21489,Melba,Asaaf,masaaf53@newsvine.com,Staff Scientist,4707,459,5166
21626,Bernadina,Forst,bforst54@irs.gov,Account Representative III,2680,440,3120
21574,Sallyann,Karet,skaret55@ucoz.ru,Office Assistant III,5937,618,6555
21285,Lannie,Youd,lyoud56@wordpress.com,Project Manager,2390,1081,3471
21646,Fawnia,Lampbrecht,flampbrecht57@issuu.com,Cost Accountant,9714,523,10237
21534,Jade,Fominov,jfominov58@pagesperso-orange.fr,Help Desk Technician,8571,1874,10445
21077,Hortense,Stanlike,hstanlike59@weibo.com,Senior Quality Engineer,4434,1405,5839
21636,Paulie,Le feuvre,plefeuvre5b@census.gov,Financial Analyst,8246,1783,10029
21823,Anya,Jeaycock,ajeaycock5c@engadget.com,Legal Assistant,7877,793,8670
21372,Demeter,Dimitrijevic,ddimitrijevic5d@omniture.com,Staff Scientist,8107,698,8805
21556,Alikee,Toby,atoby5e@etsy.com,Operator,1099,1258,2357
21922,Rafferty,Date,rdate5f@msu.edu,Research Associate,3933,1172,5105
21407,Cleve,Grimwood,cgrimwood5g@facebook.com,Business Systems Development Analyst,4926,308,5234
21515,Theobald,Hamelyn,thamelyn5h@csmonitor.com,Help Desk Technician,3831,1048,4879
21737,Guilbert,Slayny,gslayny5i@harvard.edu,Desktop Support Technician,2900,1849,4749
21696,Halie,Stoeckle,hstoeckle5j@unicef.org,Pharmacist,6618,1063,7681
21651,Wilt,Claughton,wclaughton5k@vinaora.com,Actuary,8456,295,8751
21202,Griswold,Spaunton,gspaunton5l@nature.com,Occupational Therapist,1863,508,2371
21001,Robenia,Ikin,rikin5m@hubpages.com,Nurse Practicioner,5204,777,5981
21535,Cordi,Dobrovolski,cdobrovolski5n@arstechnica.com,Nuclear Power Engineer,6148,1728,7876
21979,Robinette,Kleinhandler,rkleinhandler5o@etsy.com,Database Administrator IV,6875,859,7734
21603,Tom,Wibberley,twibberley5p@people.com.cn,Office Assistant IV,1043,769,1812
21876,Sukey,Iddens,siddens5q@blog.com,Software Consultant,1960,1685,3645
21322,Lucho,Moncey,lmoncey5r@tmall.com,Internal Auditor,4981,992,5973
21157,Galven,Mirfield,gmirfield5t@sina.com.cn,Business Systems Development Analyst,3119,1940,5059
21616,Sig,Loosely,sloosely5y@netscape.com,Graphic Designer,4607,1123,5730
21198,Elsi,Kollach,ekollach5z@freewebs.com,Compensation Analyst,2191,1778,3969
21028,Der,Walkinshaw,dwalkinshaw60@mac.com,Occupational Therapist,9421,537,9958
21726,Aaron,Rosi,arosi61@webeden.co.uk,Operator,4798,1632,6430
21400,Mikaela,Fitzroy,mfitzroy62@adobe.com,VP Marketing,6130,554,6684
21852,Delmer,Cowx,dcowx63@wikispaces.com,Design Engineer,5673,244,5917
21990,Harriot,Keson,hkeson64@boston.com,Assistant Manager,4358,619,4977
21859,Sara,Guidelli,sguidelli66@slate.com,Graphic Designer,1334,821,2155
21763,Corrine,Blundel,cblundel67@dell.com,Executive Secretary,7090,1638,8728
21334,Gayle,Furlong,gfurlong69@biblegateway.com,Actuary,8232,1950,10182
21404,Patrizia,Piccard,ppiccard6a@newsvine.com,Desktop Support Technician,9315,1029,10344
21483,Merilyn,Connew,mconnew6b@twitter.com,Mechanical Systems Engineer,9649,1362,11011
21368,Lilas,Bright,lbright6c@dmoz.org,Librarian,6039,1661,7700
21614,Merline,Wippermann,mwippermann6d@odnoklassniki.ru,Sales Representative,7575,915,8490
21344,Brigg,Litherland,blitherland6e@oakley.com,Paralegal,1838,1408,3246
21842,Al,Madders,amadders6f@unblog.fr,Computer Systems Analyst IV,9686,1698,11384
21931,Sean,Timoney,stimoney6h@businessinsider.com,Internal Auditor,9412,815,10227
21569,Jermaine,Hasney,jhasney6i@meetup.com,Media Manager I,5214,1074,6288
21772,Vinson,Maypole,vmaypole6j@unblog.fr,Account Coordinator,1788,1171,2959
21241,Rip,Saxby,rsaxby6m@toplist.cz,Staff Accountant II,7773,684,8457
21975,Tandie,Leatherland,tleatherland6n@usda.gov,Structural Engineer,2771,972,3743
21854,Arline,Wilkerson,awilkerson6o@rambler.ru,Professor,9635,940,10575
21828,Fayre,Bergeon,fbergeon6p@opera.com,Clinical Specialist,6969,970,7939
21336,Price,Bodemeaid,pbodemeaid6q@smh.com.au,Accountant II,7877,466,8343
21043,Quintus,Mackieson,qmackieson6r@wordpress.org,Senior Editor,1252,1965,3217
21712,Caressa,Cannop,ccannop6s@google.pl,Environmental Specialist,7388,506,7894
21303,Tersina,Werndley,twerndley6t@purevolume.com,Staff Scientist,3225,1134,4359
21571,Ulberto,Jumonet,ujumonet6u@meetup.com,Senior Developer,3458,603,4061
21942,Maegan,Martinetto,mmartinetto6v@columbia.edu,Structural Analysis Engineer,5362,871,6233
21597,Gracie,Irnys,girnys6w@dion.ne.jp,Media Manager IV,1417,1410,2827
21478,Daniele,Crocetto,dcrocetto6x@w3.org,Operator,2672,1707,4379
21011,Cooper,Paty,cpaty6y@nih.gov,Help Desk Operator,5996,1640,7636
21276,Griffie,Beldan,gbeldan6z@google.co.jp,Environmental Tech,2561,1807,4368
21548,Rosalia,Maryan,rmaryan70@mysql.com,VP Product Management,3328,699,4027
21673,Jamil,Ohanessian,johanessian72@de.vu,Programmer III,6625,1893,8518
21807,Iver,Gartell,igartell73@google.com.hk,Actuary,6460,842,7302
21680,Dwight,Feathersby,dfeathersby74@java.com,Registered Nurse,2808,1848,4656
21245,Millard,Reddie,mreddie76@sohu.com,Community Outreach Specialist,3513,1498,5011
21186,Sonnnie,Neale,sneale77@uiuc.edu,Office Assistant II,2579,1238,3817
21215,Aaren,Jeffers,ajeffers78@ebay.com,Information Systems Manager,3506,1922,5428
21326,Arnie,Whinray,awhinray7a@stumbleupon.com,Geological Engineer,4765,527,5292
21724,Wakefield,Bullman,wbullman7b@ihg.com,Legal Assistant,6285,997,7282
21205,Eolande,Corryer,ecorryer7c@1688.com,Analyst Programmer,7286,509,7795
21961,Luke,Keiley,lkeiley7e@gravatar.com,Chief Design Engineer,2386,670,3056
21209,Hartley,Hadleigh,hhadleigh7f@nasa.gov,Help Desk Technician,1047,1552,2599
21900,Brander,Gaynor,bgaynor7h@friendfeed.com,Project Manager,9168,511,9679
21155,Charmane,Dresse,cdresse7i@msu.edu,Senior Financial Analyst,6407,1095,7502
21230,Kelci,Kikke,kkikke7k@infoseek.co.jp,Product Engineer,1907,844,2751
21418,Robinett,Balasin,rbalasin7l@bbb.org,Social Worker,4915,981,5896
21275,Ynes,Georghiou,ygeorghiou7m@ezinearticles.com,Analyst Programmer,4622,757,5379
21460,Giraldo,Pashley,gpashley7o@ed.gov,Civil Engineer,4993,766,5759
21787,Luther,Dummigan,ldummigan7p@goodreads.com,Financial Analyst,2054,966,3020
21672,Kalina,Fricke,kfricke7q@opensource.org,Assistant Media Planner,5021,612,5633
21167,Zebedee,Poleykett,zpoleykett7r@hexun.com,Chemical Engineer,5969,985,6954
21369,Yves,Harvie,yharvie7s@nyu.edu,Recruiter,7736,728,8464
21632,Hyacinthe,Baseggio,hbaseggio7t@altervista.org,Assistant Professor,9625,211,9836
21831,Frazer,Stores,fstores7v@nsw.gov.au,Cost Accountant,9857,1242,11099
21099,Griff,Geraldi,ggeraldi7x@pcworld.com,Sales Associate,4225,1762,5987
21675,Aldon,Daugherty,adaugherty7y@yahoo.com,Senior Editor,5426,773,6199
21566,Averell,Gravey,agravey7z@cargocollective.com,Quality Control Specialist,5713,1956,7669
21302,Cloe,Greir,cgreir80@arizona.edu,Assistant Media Planner,2181,1818,3999
21426,Fax,Naisbitt,fnaisbitt83@opera.com,Budget/Accounting Analyst III,4719,734,5453
21103,Adara,Bolgar,abolgar84@slashdot.org,Paralegal,7068,361,7429
21855,Katy,Nathan,knathan85@purevolume.com,Administrative Assistant II,8427,1935,10362
21997,Randal,Thomassin,rthomassin88@acquirethisname.com,Research Nurse,8135,1248,9383
21139,Marcelle,Bernhardi,mbernhardi89@epa.gov,Clinical Specialist,6759,1036,7795
21064,Yank,Ciccotto,yciccotto8a@acquirethisname.com,Information Systems Manager,9698,1261,10959
21903,Michele,Denecamp,mdenecamp8c@phoca.cz,Help Desk Technician,9579,1468,11047
21316,Julita,Collman,jcollman8d@com.com,Structural Engineer,7725,692,8417
21953,Boy,Ambrosch,bambrosch8e@mlb.com,Help Desk Operator,5525,489,6014
21744,Dmitri,Castillou,dcastillou8h@163.com,Web Developer I,3545,604,4149
21544,Jinny,Moncrefe,jmoncrefe8j@joomla.org,Paralegal,5611,1374,6985
21383,Viki,Marie,vmarie8k@va.gov,Financial Advisor,1561,729,2290
21962,Nisse,Brambell,nbrambell8n@lycos.com,Payment Adjustment Coordinator,9929,920,10849
21840,Marmaduke,Daybell,mdaybell8o@posterous.com,Geological Engineer,6280,473,6753
21012,Esteban,Bryant,ebryant8p@disqus.com,Environmental Specialist,9820,1285,11105
21706,Lorettalorna,Denial,ldenial8q@mlb.com,Actuary,9157,1043,10200
21977,Ashien,Slade,aslade8s@ted.com,Information Systems Manager,1014,1450,2464
21244,Arlen,Rawles,arawles8t@360.cn,Staff Accountant IV,4350,1023,5373
21914,Vinni,O'Looney,volooney8u@dailymail.co.uk,Marketing Assistant,5505,1608,7113
21664,Gregoor,Paulou,gpaulou8w@altervista.org,VP Marketing,2283,1430,3713
21100,Fionna,Crutchley,fcrutchley8x@dropbox.com,Physical Therapy Assistant,1759,1606,3365
21580,Maude,Aaron,maaron8y@angelfire.com,Senior Cost Accountant,2898,2000,4898
21635,Grace,Crenage,gcrenage8z@upenn.edu,Data Coordiator,7599,1722,9321
21284,Bamby,Bunch,bbunch90@shop-pro.jp,Administrative Assistant II,8671,247,8918
21989,Flinn,Pugh,fpugh92@cornell.edu,VP Sales,6688,1127,7815
21973,Lynnet,Daughtrey,ldaughtrey93@bigcartel.com,Programmer III,9380,603,9983
21035,Aubree,Kmieciak,akmieciak94@auda.org.au,Senior Sales Associate,8761,1325,10086
21707,Phineas,Cordall,pcordall95@cocolog-nifty.com,Desktop Support Technician,2067,1754,3821
21212,Myrilla,Ivins,mivins96@jimdo.com,Help Desk Technician,3525,1533,5058
21592,Inglebert,Kaine,ikaine98@moonfruit.com,Research Nurse,7353,1087,8440
21027,Thelma,Whyke,twhyke9a@army.mil,Help Desk Technician,1785,1152,2937
21920,Petra,Olley,polley9b@g.co,Health Coach II,6803,1123,7926
21363,Sutton,Tuffs,stuffs9c@ning.com,Account Representative IV,7013,223,7236
21412,Orlan,Tanman,otanman9e@marketwatch.com,Nurse Practicioner,7498,1829,9327
21480,Karole,Ciccottini,kciccottini9f@privacy.gov.au,Civil Engineer,8838,949,9787
21554,Eryn,Beechcraft,ebeechcraft9i@forbes.com,Financial Advisor,1207,1295,2502
21050,Cairistiona,De la Harpe,cdelaharpe9j@businesswire.com,Community Outreach Specialist,3059,377,3436
21138,Phylis,Friedenbach,pfriedenbach9k@addtoany.com,Design Engineer,1310,1976,3286
21615,Shanie,Ransfield,sransfield9l@engadget.com,Software Test Engineer IV,5565,1295,6860
21133,Gay,Haley,ghaley9m@washington.edu,Engineer II,9076,1303,10379
21539,Webster,Hedin,whedin9n@amazon.com,Librarian,6450,611,7061
21760,Wilfred,Donaldson,wdonaldson9p@cdbaby.com,Nuclear Power Engineer,5679,1253,6932
21521,Dougy,Tickel,dtickel9q@businessinsider.com,Quality Control Specialist,2135,1170,3305
21745,Saundra,Wraggs,swraggs9s@g.co,Research Nurse,1889,1515,3404
21525,Briggs,Slemming,bslemming9t@apple.com,Recruiter,8248,1813,10061
21332,Ab,Sisneros,asisneros9u@friendfeed.com,Environmental Specialist,4073,1423,5496
21177,Ulrika,Yanshin,uyanshin9x@google.ca,GIS Technical Architect,1355,518,1873
21951,Lorin,Dallon,ldallon9y@free.fr,Dental Hygienist,6556,433,6989
21464,Noelyn,McLean,nmcleana2@people.com.cn,Database Administrator III,5352,1890,7242
21985,Ellissa,Tofanini,etofaninia3@geocities.com,Geological Engineer,8470,1462,9932
21981,Lyndel,Hariot,lhariota4@blogger.com,Recruiter,9003,387,9390
21885,Kelcey,Goudard,kgoudarda5@feedburner.com,Clinical Specialist,8397,306,8703
21436,Ronnie,Epton,reptona6@weebly.com,Financial Analyst,3961,330,4291
21666,Celestyn,Noller,cnollera7@netlog.com,Safety Technician IV,5448,1640,7088
21716,Gretta,Shildrick,gshildricka9@youtu.be,Operator,8910,313,9223
21247,Michelina,Cosby,mcosbyab@stumbleupon.com,VP Product Management,4586,1089,5675
21446,Kai,Smalman,ksmalmanad@imgur.com,Teacher,5526,613,6139
21650,Corbin,Schade,cschadeaf@nhs.uk,Senior Cost Accountant,2393,1965,4358
21846,Kori,Clunie,kclunieag@linkedin.com,Analyst Programmer,7280,633,7913
21773,Dora,Lie,dlieah@whitehouse.gov,Social Worker,5928,663,6591
21926,Adelheid,Fine,afineai@nature.com,Account Coordinator,2578,1225,3803
21373,Gerald,Olczyk,golczykaj@about.com,Editor,8738,1880,10618
21774,Catherin,Garnsworth,cgarnsworthal@com.com,Analyst Programmer,9633,694,10327
21388,Austina,Peniman,apenimanam@ehow.com,Technical Writer,4378,1539,5917
21386,Crissie,Eliez,celiezao@house.gov,Assistant Professor,7685,1947,9632
21564,Jocelyn,Potticary,jpotticaryap@bandcamp.com,Analog Circuit Design manager,3627,1818,5445
21481,Analise,Rasor,arasoraq@bluehost.com,Technical Writer,6601,1591,8192
21994,Berny,Cowthard,bcowthardat@npr.org,Analyst Programmer,8342,1925,10267
21967,Shelagh,Cullingford,scullingfordau@indiegogo.com,Account Executive,7100,298,7398
21921,Tobias,Wyleman,twylemanax@cdbaby.com,Data Coordiator,1905,1406,3311
21916,Kristen,Gostridge,kgostridgeay@godaddy.com,Financial Analyst,8356,373,8729
21837,Rosa,Guare,rguareaz@smh.com.au,Recruiting Manager,8753,1359,10112
21037,Pansie,Carlyon,pcarlyonb0@theatlantic.com,Health Coach IV,9326,1807,11133
21405,Marcela,Merill,mmerillb1@nytimes.com,Structural Engineer,4787,1313,6100
21311,Avrit,Shirtcliffe,ashirtcliffeb2@tinypic.com,Recruiting Manager,5853,1999,7852
21216,Joannes,Callister,jcallisterb3@jalbum.net,Software Consultant,6612,1506,8118
21518,Kiel,Beals,kbealsb5@printfriendly.com,Librarian,6948,1747,8695
21293,Brittni,Ferreiro,bferreirob6@discuz.net,Biostatistician IV,2164,1192,3356
21655,Early,Colliver,ecolliverb8@github.io,VP Sales,8015,1830,9845
21049,Heddi,Gidden,hgiddenbb@irs.gov,Teacher,2312,1831,4143
21429,Nil,Brader,nbraderbd@baidu.com,Business Systems Development Analyst,9129,587,9716
21970,Leanna,Padwick,lpadwickbe@baidu.com,Senior Editor,5072,1421,6493
21016,Luis,Skirlin,lskirlinbg@mlb.com,Senior Financial Analyst,2909,1805,4714
21360,Korella,Deener,kdeenerbh@chicagotribune.com,Web Designer III,9949,580,10529
21433,Nelle,Nassey,nnasseybj@bizjournals.com,Engineer I,9848,1889,11737
21974,Gerard,Leven,glevenbm@gravatar.com,Quality Engineer,8550,213,8763
21250,Denney,Twyning,dtwyningbn@about.com,VP Sales,4547,1968,6515
21347,Sterling,Ferraraccio,sferraracciobo@baidu.com,Software Consultant,5942,1459,7401
21576,Parsifal,O'Fogerty,pofogertybp@dedecms.com,Senior Quality Engineer,1786,642,2428
21609,Bordy,Pardie,bpardiebq@elpais.com,Sales Associate,9845,1512,11357
21667,Minda,Gronaller,mgronallerbr@state.gov,Software Test Engineer IV,7548,1809,9357
21313,Ingemar,Harburtson,iharburtsonbs@chronoengine.com,Biostatistician IV,8569,1397,9966
21656,Andy,Pietrowicz,apietrowiczbu@linkedin.com,Accountant IV,8943,591,9534
21365,Tybie,MacGoun,tmacgounbx@nymag.com,Software Test Engineer IV,2958,1019,3977
21932,Henri,Jecock,hjecockby@cornell.edu,Professor,9455,859,10314
21175,Lydia,Suermeier,lsuermeierc0@walmart.com,VP Marketing,1801,1991,3792
21262,Yvon,Keyse,ykeysec1@dailymail.co.uk,Analog Circuit Design manager,7571,354,7925
21536,Gilberta,Cousins,gcousinsc2@prnewswire.com,Graphic Designer,9174,1936,11110
21585,Burke,Leathem,bleathemc3@tinyurl.com,Engineer II,8576,710,9286
21472,Kevina,Wisker,kwiskerc5@4shared.com,Teacher,2798,1668,4466
21042,Town,Creavan,tcreavanc7@ameblo.jp,Programmer I,7871,638,8509
21073,Hilda,Oakenfull,hoakenfullc8@google.com.au,Nurse Practicioner,6435,345,6780
21486,Booth,Gabriel,bgabrielcb@jugem.jp,Clinical Specialist,1598,641,2239
21858,Jock,Gurton,jgurtoncc@netscape.com,Recruiting Manager,7166,598,7764
21755,Grover,Mannock,gmannockce@netvibes.com,Assistant Professor,4808,1051,5859
21793,Teddie,Darcey,tdarceycg@themeforest.net,Programmer II,3660,779,4439
21190,Pandora,Scrivinor,pscrivinorcj@ft.com,Media Manager IV,7872,905,8777
21709,Shandeigh,Kearton,skeartoncl@prweb.com,Account Representative II,5170,1790,6960
21584,Carlie,Van der Hoven,cvanderhovencn@geocities.jp,Assistant Manager,7078,561,7639
21875,Jeth,Skace,jskaceco@google.ru,Editor,5823,1744,7567
21288,Hedwiga,Soanes,hsoanescp@tuttocitta.it,Software Engineer IV,8734,1680,10414
21695,Edwina,Daybell,edaybellcr@usgs.gov,Senior Developer,2321,1480,3801
21637,Vic,Basek,vbasekcw@themeforest.net,VP Quality Control,4065,767,4832
21479,Asa,Wudeland,awudelandcx@artisteer.com,Nuclear Power Engineer,4773,1096,5869
21031,Tracy,Tabard,ttabardcy@statcounter.com,Senior Cost Accountant,5599,531,6130
21919,Paolo,MacArd,pmacardcz@wired.com,Internal Auditor,6284,1815,8099
21451,Carmela,Ongin,congind0@independent.co.uk,Programmer I,7877,713,8590
21327,Fae,Langridge,flangridged2@pinterest.com,Nurse Practicioner,3975,1042,5017
21408,Thorny,Meharry,tmeharryd4@google.com.au,Speech Pathologist,6385,1704,8089
21754,Ryon,Bosher,rbosherd7@parallels.com,Database Administrator IV,2427,1372,3799
21349,Dixie,Varnam,dvarnamd8@tinyurl.com,Budget/Accounting Analyst III,7845,1362,9207
21427,Leonidas,Calendar,lcalendard9@networksolutions.com,Senior Cost Accountant,4151,1482,5633
21703,Winona,Lear,wlearda@nymag.com,Account Representative II,6355,289,6644
21686,Stafford,Brugden,sbrugdendd@nydailynews.com,Financial Advisor,1586,675,2261
21870,Jemie,Loxdale,jloxdalede@plala.or.jp,Structural Analysis Engineer,8730,717,9447
21165,Angelika,Conry,aconrydf@issuu.com,Dental Hygienist,7437,403,7840
21751,Garrick,Bunyard,gbunyarddi@dell.com,Research Associate,1807,1693,3500
21625,Alvin,Wapple,awappledj@scribd.com,Human Resources Assistant I,5939,840,6779
21314,Dorena,Shrieves,dshrievesdn@dailymotion.com,Business Systems Development Analyst,3802,810,4612
21420,Nat,Garrique,ngarriquedo@cocolog-nifty.com,Account Executive,7850,1803,9653
21684,Constantin,Gierck,cgierckdp@behance.net,Accountant I,3737,1494,5231
21301,Osborne,Goodlad,ogoodladdq@wisc.edu,Structural Analysis Engineer,2248,1362,3610
21145,Burke,Elderbrant,belderbrantds@apple.com,Legal Assistant,9495,536,10031
21002,Gifford,Demko,gdemkodt@1und1.de,Associate Professor,7444,845,8289
21506,Aida,Lyons,alyonsdv@lulu.com,Senior Cost Accountant,8418,1713,10131
21935,Joya,Gyde,jgydedw@hubpages.com,Payment Adjustment Coordinator,1151,859,2010
21606,Bella,Harrington,bharringtondx@goo.ne.jp,Editor,8263,1487,9750
21520,Lincoln,Thebe,lthebedy@disqus.com,Product Engineer,9883,1063,10946
21555,Dody,Mapstone,dmapstonedz@com.com,Software Engineer IV,2899,552,3451
21054,Agata,Pillington,apillingtone0@blog.com,Account Executive,1329,1017,2346
21996,Alfons,Killiner,akillinere1@eepurl.com,Accounting Assistant II,2864,1217,4081
21901,Annabella,Barnard,abarnarde4@independent.co.uk,GIS Technical Architect,2775,1825,4600
21888,Jacynth,Kedwell,jkedwelle6@nymag.com,Assistant Manager,3510,1066,4576
21907,Horacio,Heam,hheame7@sourceforge.net,Help Desk Operator,7166,727,7893
21067,Sashenka,Skitterel,sskitterele8@privacy.gov.au,Programmer Analyst IV,6751,1099,7850
21563,Yurik,Yockley,yyockleye9@addthis.com,Physical Therapy Assistant,9544,1577,11121
21722,Dorotea,Donovin,ddonovinea@huffingtonpost.com,Food Chemist,3349,1744,5093
21582,Carny,MacConchie,cmacconchieeb@cloudflare.com,VP Marketing,4506,739,5245
21908,Bobbe,Lesek,blesekec@wsj.com,Research Associate,2549,1902,4451
21416,Carmita,Thoday,cthodayed@cloudflare.com,Account Representative II,3871,438,4309
21161,Alic,Jukes,ajukesef@twitter.com,VP Marketing,1776,862,2638
21998,Lolly,Shank,lshankeg@dedecms.com,Statistician II,7909,1301,9210
21018,Jessica,Johansson,jjohanssoneh@mozilla.com,Staff Scientist,9035,1173,10208
21968,Zelma,Ridgeway,zridgewayei@histats.com,Staff Accountant III,1765,705,2470
21033,Allyn,Pestricke,apestrickeek@theglobeandmail.com,Programmer Analyst II,3133,1682,4815
21697,Merola,Clohessy,mclohessyem@opera.com,Software Test Engineer II,1957,218,2175
21622,Barbara,Astridge,bastridgeep@usda.gov,Structural Analysis Engineer,4045,259,4304
21089,Jaime,Ballentime,jballentimeer@1und1.de,Environmental Tech,1165,1294,2459
21887,Quill,McMechan,qmcmechanet@symantec.com,Accounting Assistant I,5811,792,6603
21048,Shirleen,Pursey,spurseyev@gravatar.com,Help Desk Technician,6572,515,7087
21447,Reeta,Stoak,rstoakez@surveymonkey.com,Marketing Manager,7829,923,8752
21665,Ingeberg,Paridge,iparidgef0@samsung.com,Project Manager,2630,1405,4035
21459,Lira,Faulds,lfauldsf1@home.pl,Executive Secretary,8583,1134,9717
21435,Gram,Carrane,gcarranef5@vistaprint.com,Assistant Professor,9867,1524,11391
21631,Kelby,Varty,kvartyf7@accuweather.com,Librarian,4288,401,4689
21346,Elayne,Terbeek,eterbeekf8@toplist.cz,Sales Representative,1161,1334,2495
21725,Wynnie,Seedman,wseedmanfa@jigsy.com,Administrative Assistant II,6126,1172,7298
21988,Simonne,Deare,sdearefb@rambler.ru,Staff Scientist,3313,683,3996
21510,Carlynn,Brosnan,cbrosnanfc@netvibes.com,Community Outreach Specialist,7454,401,7855
21387,Adolphus,Arboin,aarboinfe@admin.ch,Registered Nurse,3264,1017,4281
21210,Corly,Laurence,claurenceff@sfgate.com,Accounting Assistant I,2264,610,2874
21795,Orazio,Backshaw,obackshawfg@cam.ac.uk,Human Resources Assistant I,4571,1494,6065
21207,Karlee,Milham,kmilhamfj@drupal.org,Marketing Assistant,2037,559,2596
21783,Delainey,Beadham,dbeadhamfn@oaic.gov.au,Assistant Manager,2017,446,2463
21084,Madalena,Fairholme,mfairholmefo@chronoengine.com,Financial Analyst,8415,1157,9572
21062,Temple,Anten,tantenfp@skyrock.com,Operator,3550,1210,4760
21817,Gradeigh,Dennidge,gdennidgefr@linkedin.com,Civil Engineer,9131,516,9647
21023,Eleanora,Markwelley,emarkwelleyfs@reverbnation.com,Media Manager III,7058,1806,8864
21392,Reeba,Ellick,rellickfu@symantec.com,Occupational Therapist,3345,1806,5151
21006,Dorine,Byng,dbyngfx@wisc.edu,Data Coordiator,4406,1225,5631
21700,Tabor,Dyer,tdyerfy@epa.gov,Senior Quality Engineer,2529,1268,3797
21849,Evangeline,Ughi,eughig0@freewebs.com,Software Engineer III,4211,1034,5245
21315,Isador,Gorring,igorringg3@baidu.com,Chief Design Engineer,2562,1937,4499
21128,Bianka,Baptista,bbaptistag4@google.com.hk,Editor,4506,590,5096
21538,Bianca,Bratley,bbratleyg7@businessweek.com,Legal Assistant,9590,1075,10665
21234,Valentine,Herche,vhercheg9@netlog.com,Administrative Officer,3494,1393,4887
21877,Amara,Puttergill,aputtergillgb@arizona.edu,Automation Specialist IV,1481,1412,2893
21723,Jacquenetta,Dunne,jdunnegc@bloomberg.com,Editor,5393,957,6350
21679,Ingar,Bridgestock,ibridgestockgd@tripadvisor.com,Software Engineer IV,3697,1034,4731
21379,Letizia,Brailsford,lbrailsfordgg@washington.edu,Geological Engineer,3351,1463,4814
21573,Maurice,Maguire,mmaguiregi@barnesandnoble.com,Sales Representative,6023,957,6980
21220,Pauly,Deeks,pdeeksgj@mysql.com,Accountant IV,3164,483,3647
21873,Arch,Coning,aconinggm@netscape.com,Automation Specialist III,8900,972,9872
21258,Padget,Balsellie,pbalselliegn@deliciousdays.com,Web Designer II,9639,354,9993
21785,Tedda,Fragino,tfraginogo@csmonitor.com,Registered Nurse,7794,483,8277
21669,Marabel,Crane,mcranegr@mediafire.com,Biostatistician III,6143,1194,7337
21593,Blondie,Dunks,bdunksgt@reuters.com,Account Representative II,8826,883,9709
21468,Sayre,Cawsy,scawsygu@nsw.gov.au,Account Executive,7361,1901,9262
21543,Sioux,Mountain,smountaingw@cisco.com,Chief Design Engineer,4179,1513,5692
21279,Olimpia,Antonazzi,oantonazzigx@yellowpages.com,Research Associate,2326,384,2710
21324,Karil,Baldam,kbaldamgy@bing.com,Account Executive,1038,1146,2184
21963,Ulrikaumeko,Vanacci,uvanaccih3@admin.ch,Quality Engineer,9234,699,9933
21824,Bonnie,Gallihaulk,bgallihaulkh5@prlog.org,Registered Nurse,4103,1430,5533
21109,Ursula,Langworthy,ulangworthyh6@jimdo.com,Geological Engineer,1286,1145,2431
21511,Nissie,Mattioli,nmattiolih8@microsoft.com,Human Resources Assistant IV,6809,1052,7861
21883,Sheryl,Grutchfield,sgrutchfieldha@state.gov,Account Representative IV,1849,502,2351
21814,Haskell,English,henglishhd@naver.com,Dental Hygienist,4696,625,5321
21895,Rahal,Simonds,rsimondshf@spiegel.de,Data Coordiator,4899,1815,6714
21950,Fidelio,Giannazzi,fgiannazzihh@acquirethisname.com,Assistant Professor,6905,1273,8178
21562,Willy,Bartoszek,wbartoszekhi@eepurl.com,Assistant Professor,5364,1289,6653
21872,Irena,Lyptratt,ilyptratthj@webs.com,Financial Advisor,5681,1242,6923
21565,Alisun,Batrop,abatrophl@cmu.edu,Financial Advisor,5586,1633,7219
21164,Paola,Rhys,prhyshm@wikispaces.com,Actuary,9197,1544,10741
21082,Imojean,Walsh,iwalshhn@geocities.jp,Programmer Analyst IV,2890,737,3627
21046,Sharla,Mahady,smahadyho@archive.org,Staff Accountant III,4810,1117,5927
21728,Melvyn,Lambrechts,mlambrechtshp@wikimedia.org,Mechanical Systems Engineer,5710,1615,7325
21348,Beau,Breddy,bbreddyhq@gov.uk,Pharmacist,5562,662,6224
21668,Sunny,Tarrier,starrierhr@desdev.cn,Statistician II,8992,1470,10462
21092,Allison,Iohananof,aiohananofhw@printfriendly.com,Senior Developer,8830,1573,10403
21507,Jamison,Pike,jpikehx@rakuten.co.jp,Office Assistant III,9465,1219,10684
21802,Prentice,Havock,phavockhz@sogou.com,Electrical Engineer,9264,642,9906
21108,Callida,Pasticznyk,cpasticznyki1@answers.com,Nurse Practicioner,9816,1031,10847
21461,Harri,Conechie,hconechiei3@abc.net.au,Systems Administrator IV,7994,1800,9794
21172,Rice,Hillyatt,rhillyatti4@google.es,Software Test Engineer IV,6286,1800,8086
21142,Christyna,Scinelli,cscinelliic@skyrock.com,Graphic Designer,6664,1969,8633
21333,Greg,Yuryatin,gyuryatinif@google.de,Cost Accountant,2479,1167,3646
21260,Brett,Tunnicliffe,btunnicliffeig@cpanel.net,General Manager,9498,676,10174
21599,Lefty,Reinhart,lreinhartii@ifeng.com,Data Coordiator,3292,299,3591
21423,Trescha,Mathers,tmathersik@deviantart.com,Developer IV,6886,1905,8791
21431,Gwendolyn,Lammerich,glammerichil@godaddy.com,Pharmacist,6751,460,7211
21514,Katrine,Benne,kbenneio@about.me,Electrical Engineer,6703,1128,7831
21273,Trace,Obispo,tobispoip@ask.com,Geological Engineer,5265,1363,6628
21391,Jaquelin,Uphill,juphilliq@nhs.uk,Information Systems Manager,4475,1058,5533
21835,Stevena,Easby,seasbyir@geocities.jp,Software Test Engineer I,5524,1779,7303
21721,Corabelle,Galler,cgallerit@jigsy.com,Internal Auditor,6401,280,6681
21402,Sol,Godden,sgoddeniv@wufoo.com,Quality Control Specialist,1376,1209,2585
21503,Elden,Alderwick,ealderwickiw@java.com,Software Engineer II,7401,1607,9008
21806,Harlan,Gulston,hgulstonix@ted.com,Research Associate,3747,1574,5321
21714,Clareta,Nisbet,cnisbetiy@vimeo.com,VP Quality Control,5175,285,5460
21559,Suellen,Kinze,skinzeiz@digg.com,Speech Pathologist,1732,1480,3212
21661,Berty,Geldart,bgeldartj1@squarespace.com,Actuary,6844,1458,8302
21271,Marv,Cuseick,mcuseickj3@diigo.com,Information Systems Manager,7006,1609,8615
21283,Neil,Hentzer,nhentzerj6@bravesites.com,Dental Hygienist,1030,352,1382
21401,Dan,Joye,djoyej8@t-online.de,Tax Accountant,9890,407,10297
21457,Dillon,Grimmolby,dgrimmolbyj9@biglobe.ne.jp,Research Nurse,7769,489,8258
21058,Lefty,Kaley,lkaleyjc@wordpress.com,Safety Technician I,1183,1761,2944
21591,Beth,Hanshaw,bhanshawjd@archive.org,VP Sales,6087,251,6338
21676,Clarance,Faltin,cfaltinjg@nifty.com,Paralegal,6500,841,7341
21528,Mariana,Petroulis,mpetroulisjj@google.co.jp,Paralegal,8373,1212,9585
21106,Aldin,Gisbey,agisbeyjk@umich.edu,Professor,7390,1867,9257
21456,Avrom,Kacheller,akachellerjl@bravesites.com,Senior Sales Associate,4696,1158,5854
21319,Blanche,Deer,bdeerjm@wordpress.com,Statistician I,2897,1691,4588
21094,Marieann,Gabb,mgabbjn@howstuffworks.com,Analog Circuit Design manager,6169,1377,7546
21847,Tiertza,Tour,ttourjs@businessinsider.com,Mechanical Systems Engineer,3196,986,4182
21501,Edgar,Farloe,efarloeju@spotify.com,Financial Advisor,9168,429,9597
21439,Broddy,Matteoni,bmatteonijw@slate.com,Structural Engineer,6187,1990,8177
21612,Rhonda,McGeouch,rmcgeouchjz@taobao.com,Account Executive,9995,1561,11556
21917,Bronnie,Buxton,bbuxtonk0@delicious.com,Research Assistant I,8543,1189,9732
21934,Raoul,Haddon,rhaddonk2@de.vu,Quality Engineer,7764,1425,9189
21874,Karalee,Tweedell,ktweedellk3@state.gov,Director of Sales,9570,1079,10649
21029,Jany,Ikringill,jikringillk7@hugedomains.com,Environmental Tech,6136,1860,7996
21627,Juan,Parris,jparrisk8@desdev.cn,Assistant Manager,1008,1031,2039
21118,Myrwyn,Holywell,mholywellkc@devhub.com,Speech Pathologist,9635,1388,11023
21440,Marten,Havers,mhaverske@bluehost.com,Desktop Support Technician,2501,617,3118
21701,Ives,Jaumet,ijaumetkf@china.com.cn,Human Resources Assistant I,8937,1884,10821
21178,Cecilia,Hacon,chaconki@goodreads.com,Social Worker,9466,1879,11345
21340,Luce,Ordidge,lordidgekl@answers.com,VP Quality Control,5111,886,5997
21343,Nessy,Meade,nmeadekm@lycos.com,Operator,8803,489,9292
21195,Dov,Dabner,ddabnerkn@cnbc.com,Senior Cost Accountant,1993,655,2648
21085,Olia,Tassel,otasselkp@techcrunch.com,Electrical Engineer,4616,379,4995
21204,Lillian,Moxstead,lmoxsteadkq@cisco.com,Staff Accountant I,3413,1979,5392
21886,Jules,Tripe,jtripekr@pinterest.com,Analog Circuit Design manager,1433,1704,3137
21941,Stephana,Buckerfield,sbuckerfieldks@about.com,Community Outreach Specialist,9866,1105,10971
21497,Chancey,Spare,cspareku@washingtonpost.com,Recruiting Manager,9815,1425,11240
21040,Kayne,Offen,koffenkv@dailymail.co.uk,Administrative Officer,6122,824,6946
21766,Corena,Scutchin,cscutchinkz@livejournal.com,Research Assistant III,1700,221,1921
21475,Krystle,Whitmarsh,kwhitmarshl2@ox.ac.uk,Financial Analyst,3136,920,4056
21224,Guntar,Wainman,gwainmanl3@prnewswire.com,Statistician II,3801,629,4430
21191,Robbin,Juorio,rjuoriol5@barnesandnoble.com,Chemical Engineer,6958,496,7454
21009,Tallia,Schops,tschopsl7@google.com.hk,Safety Technician I,2370,357,2727
21815,Raimondo,Kervin,rkervinl9@constantcontact.com,Professor,1647,434,2081
21254,Dode,Frossell,dfrossellla@bloomberg.com,Senior Developer,6156,683,6839
21240,Pasquale,Huws,phuwslb@smugmug.com,Office Assistant III,2407,541,2948
21337,Mic,Spraggs,mspraggslc@noaa.gov,Quality Engineer,7360,800,8160
21490,Nikos,Aucourte,naucourteld@thetimes.co.uk,Analyst Programmer,3506,1012,4518
21945,Donall,Trowill,dtrowillle@indiegogo.com,Quality Engineer,5574,912,6486
21861,Merrilee,Durdle,mdurdlelh@ycombinator.com,Research Assistant I,8442,1276,9718
21850,Jobie,Blagburn,jblagburnlk@netvibes.com,Payment Adjustment Coordinator,6435,808,7243
21093,Lillis,Feldmann,lfeldmannlo@npr.org,Registered Nurse,2744,332,3076
21482,Natasha,Conisbee,nconisbeelp@irs.gov,Human Resources Manager,7054,1952,9006
21149,Ronni,Kovnot,rkovnotlq@wordpress.org,Pharmacist,2622,985,3607
21061,Collin,Ferreo,cferreolv@narod.ru,Clinical Specialist,8603,1375,9978
21581,Amanda,Pickover,apickoverlw@soundcloud.com,GIS Technical Architect,2816,1646,4462
21731,Raychel,Clough,rcloughlx@de.vu,Design Engineer,5663,1206,6869
21777,Agnes,McVane,amcvanem0@indiatimes.com,Mechanical Systems Engineer,6488,838,7326
21126,Robyn,Poizer,rpoizerm3@mail.ru,Database Administrator III,7075,1655,8730
21020,Ermina,Vaughton,evaughtonm4@addtoany.com,Account Executive,8445,332,8777
21469,Blake,Noirel,bnoirelm6@unesco.org,Automation Specialist III,8008,744,8752
21107,Jenifer,Burtonshaw,jburtonshawm7@sfgate.com,Developer I,5046,1049,6095
21160,Dexter,Hessay,dhessaym8@ebay.co.uk,Budget/Accounting Analyst II,5305,1935,7240
21007,Lucine,Hakeworth,lhakeworthmc@ebay.com,Registered Nurse,5755,678,6433
21810,Jamison,Eustice,jeusticeme@meetup.com,Tax Accountant,1314,734,2048
21242,Ludovika,Drinkel,ldrinkelmg@php.net,Senior Developer,7054,858,7912
21532,Deloria,Rodrigues,drodriguesmi@naver.com,Paralegal,7945,1958,9903
21325,Iona,Skae,iskaeml@chronoengine.com,Software Test Engineer I,6970,346,7316
21450,Milicent,Oldrey,moldreymm@dyndns.org,Help Desk Operator,5137,508,5645
21601,Vance,Phidgin,vphidginmn@paypal.com,Programmer Analyst II,7841,640,8481
21305,Nady,Pollicott,npollicottmo@blogspot.com,Database Administrator IV,4321,522,4843
21370,Filide,Manon,fmanonmp@github.io,VP Quality Control,9767,1440,11207
21767,Tomaso,Woollhead,twoollheadmq@google.cn,Teacher,1457,1483,2940
21933,Julina,Pesak,jpesakms@senate.gov,Speech Pathologist,6057,1056,7113
21146,Kaylyn,Forsythe,kforsythemt@t.co,Senior Quality Engineer,8564,1927,10491
21252,Zarla,Loggie,zloggiemu@cisco.com,Computer Systems Analyst IV,3181,828,4009
21838,Harwilll,Bendle,hbendlen2@bbc.co.uk,Tax Accountant,1973,1276,3249
21952,Jessa,Castrillo,jcastrillon3@webeden.co.uk,Account Executive,8757,1124,9881
21957,Bard,Domney,bdomneyn4@smh.com.au,Chief Design Engineer,2092,481,2573
21623,Latisha,Loveredge,lloveredgen7@businessweek.com,Community Outreach Specialist,9293,1662,10955
21857,Wallis,Harget,whargetn8@bloglines.com,Desktop Support Technician,2688,908,3596
21891,Karlie,Lerway,klerwayng@51.la,Executive Secretary,7113,554,7667
21542,Arie,De La Hay,adelahayni@ocn.ne.jp,Junior Executive,4297,1574,5871
22000,Law,Gotecliffe,lgotecliffenl@dailymail.co.uk,VP Sales,2825,283,3108
21833,Estell,Wilkowski,ewilkowskinm@amazon.co.uk,Developer III,8347,997,9344
21910,Clywd,Simmonett,csimmonettnq@blinklist.com,Financial Analyst,5739,853,6592
21976,Gertrudis,Swansborough,gswansboroughns@multiply.com,Payment Adjustment Coordinator,5817,1819,7636
21008,Brice,Likly,bliklynz@printfriendly.com,Accounting Assistant IV,1057,1395,2452
21775,Lila,Priestnall,lpriestnallo0@reverbnation.com,Geological Engineer,7381,1777,9158
21308,Karon,Serchwell,kserchwello6@china.com.cn,Senior Quality Engineer,7817,1403,9220
21152,Engelbert,Ostrich,eostricho8@usgs.gov,Office Assistant II,6984,361,7345
21956,Kiersten,Paike,kpaikeo9@nps.gov,Staff Scientist,8294,294,8588
21425,Jeramie,Debney,jdebneyoc@mlb.com,Human Resources Assistant III,2005,1346,3351
21796,Arthur,Cheavin,acheavinod@sbwire.com,Senior Financial Analyst,5287,336,5623
21170,Ashien,Candey,acandeyog@gravatar.com,Research Assistant II,3646,1467,5113
21328,Derby,Greenshiels,dgreenshielsoi@tinypic.com,GIS Technical Architect,3952,206,4158
21969,Kahaleel,Stoite,kstoiteok@whitehouse.gov,Desktop Support Technician,3636,1108,4744
21473,Ivan,Winspar,iwinsparoo@miitbeian.gov.cn,Food Chemist,9637,1213,10850
21608,Talyah,Rouge,trougeoq@4shared.com,Tax Accountant,6051,1265,7316
21678,Piper,Coules,pcoulesor@eventbrite.com,Web Developer II,8891,845,9736
21658,Milicent,Errichi,merrichiov@mysql.com,Marketing Manager,6528,1291,7819
21682,Laurice,Geffen,lgeffenp2@dailymotion.com,Financial Analyst,2652,1717,4369
21971,Julienne,Cortin,jcortinp9@house.gov,Junior Executive,2818,1435,4253
21500,Ginger,Cudworth,gcudworthpb@furl.net,Environmental Tech,4567,458,5025
21746,Shirl,Zupa,szupapd@google.cn,Human Resources Assistant I,4750,1810,6560
21868,Berti,Grunnill,bgrunnillpg@princeton.edu,GIS Technical Architect,5497,1985,7482
21393,Johnathan,Biernat,jbiernatph@mozilla.com,Paralegal,1058,1335,2393
21264,Lanni,Dionsetto,ldionsettopm@cmu.edu,Human Resources Assistant I,5822,1185,7007
21784,Correna,Bleackley,cbleackleypn@google.es,Systems Administrator II,6856,1623,8479
21607,Joby,Sheerman,jsheermanpo@rambler.ru,Nurse,2864,633,3497
21918,Essie,Bampford,ebampfordpp@last.fm,Help Desk Technician,3119,459,3578
21342,Steffi,Szepe,sszepepq@bigcartel.com,Account Executive,9366,251,9617
21943,Wren,Dartan,wdartanpz@chicagotribune.com,VP Product Management,7841,669,8510
21946,Lorrin,Collinwood,lcollinwoodq1@stumbleupon.com,Budget/Accounting Analyst IV,5159,568,5727
21295,Briant,Fortie,bfortieq2@yelp.com,Associate Professor,9023,236,9259
21924,Clem,Shoorbrooke,cshoorbrookeq4@bizjournals.com,Quality Engineer,3142,1129,4271
21068,Chandler,Westlake,cwestlakeq9@adobe.com,Account Executive,9406,427,9833
21546,North,Piechnik,npiechnikqc@icio.us,Internal Auditor,8763,559,9322
21110,Prissie,Tadman,ptadmanqd@intel.com,Web Developer I,3663,1441,5104
21294,Didi,Christaeas,dchristaeasqf@blogspot.com,Registered Nurse,1311,1453,2764
21618,Randa,Cardenoso,rcardenosoqh@sina.com.cn,Structural Engineer,10000,1932,11932
21983,Roscoe,Greystoke,rgreystokeqi@themeforest.net,Health Coach II,1730,537,2267
21306,Thayne,Feirn,tfeirnqj@bbc.co.uk,Design Engineer,8582,381,8963
21509,Ced,Oman,comanqm@chron.com,Data Coordiator,1500,231,1731
21742,Marianne,Blaber,mblaberqo@theguardian.com,Physical Therapy Assistant,5799,1068,6867
21912,Grantham,Haylor,ghaylorqt@histats.com,Database Administrator I,5606,486,6092
21629,Bibby,Paris,bparisqz@trellian.com,Senior Quality Engineer,8833,610,9443
21909,Tann,Wanley,twanleyr0@psu.edu,Engineer IV,6431,983,7414
21527,Logan,Oxenham,loxenhamr1@ezinearticles.com,Research Associate,1838,1930,3768
21732,Boote,Greg,bgregr3@paginegialle.it,Clinical Specialist,4991,1477,6468
21199,Maria,Gee,mgeer7@dot.gov,Research Nurse,1231,1099,2330
21034,Abagael,Balling,aballingr9@exblog.jp,Nurse,7181,1751,8932
21834,Keene,Roddell,kroddellre@twitpic.com,Sales Representative,1135,1726,2861
21298,Julia,Huckabe,jhuckaberf@dell.com,Civil Engineer,3212,1885,5097
21594,Clark,Davidman,cdavidmanrh@upenn.edu,Automation Specialist III,7998,1201,9199
21144,Adel,Baistow,abaistowrl@smh.com.au,Software Test Engineer II,4291,922,5213
21115,Eloisa,Ancliff,eancliffrm@zimbio.com,Staff Accountant I,5320,1340,6660
21239,Towney,Papaminas,tpapaminasrn@devhub.com,Analyst Programmer,2819,1261,4080
21358,Ardella,Mattheissen,amattheissenro@skyrock.com,Software Engineer IV,4820,1207,6027
21409,Chariot,Van den Velde,cvandenvelderq@cornell.edu,Graphic Designer,4467,1986,6453
3281,Nikoletta,Barniss,nbarniss0@aboutads.info,Cost Accountant,9776,1108,10884
3070,Maxie,Kennealy,mkennealy1@google.nl,Account Representative I,1205,472,1677
3676,Ingrim,Alcorn,ialcorn2@newsvine.com,Graphic Designer,4861,461,5322
3165,Peterus,Stiddard,pstiddard3@discovery.com,Safety Technician I,1557,389,1946
3556,Agnese,Laviste,alaviste4@forbes.com,Teacher,8747,1453,10200
3340,Sayers,Simkovich,ssimkovich5@nytimes.com,Sales Associate,7223,1500,8723
3188,Selie,Proud,sproud6@prweb.com,Desktop Support Technician,4483,1610,6093
3275,Beverly,Dight,bdight7@state.gov,Developer I,6474,1058,7532
3929,Arleyne,Malter,amalter8@netvibes.com,Mechanical Systems Engineer,6935,1267,8202
3732,Hana,Tillett,htillett9@tripadvisor.com,Structural Engineer,9805,1569,11374
3144,Rickard,Slemmonds,rslemmondsa@cnbc.com,Desktop Support Technician,5071,773,5844
3274,Merlina,Leyband,mleybandb@cpanel.net,Senior Quality Engineer,8778,892,9670
3114,Winifield,Oakeby,woakebyc@gnu.org,Physical Therapy Assistant,4568,704,5272
3506,Pate,Hendriks,phendriksd@blogtalkradio.com,Speech Pathologist,8624,413,9037
3839,Ardene,Pickton,apicktone@networksolutions.com,Environmental Tech,4368,1895,6263
3766,Tatum,Goddert.sf,tgoddertsff@newsvine.com,Web Developer IV,1926,1189,3115
3710,Flory,Bramwich,fbramwichg@hubpages.com,Operator,8063,374,8437
3424,Joline,Ranklin,jranklinh@taobao.com,VP Product Management,3395,1633,5028
3822,Kim,Nye,knyei@eventbrite.com,Chemical Engineer,7461,946,8407
3189,Sisely,Satterlee,ssatterleej@seattletimes.com,Paralegal,5515,844,6359
3233,Chad,Screase,cscreasek@weibo.com,Administrative Assistant IV,5671,1491,7162
3399,Sigrid,Gresty,sgrestyl@boston.com,Staff Accountant IV,3354,645,3999
3009,Cookie,Hamby,chambym@taobao.com,Internal Auditor,5572,292,5864
3788,Anselma,Spradbrow,aspradbrown@businessweek.com,Systems Administrator IV,6615,486,7101
3619,Tommi,Rought,troughto@printfriendly.com,Information Systems Manager,7539,261,7800
3129,Merci,Brunger,mbrungerp@goodreads.com,Senior Developer,7150,900,8050
3820,Rosaline,Walesby,rwalesbyq@taobao.com,Nurse Practicioner,1006,932,1938
3795,Filippo,Casino,fcasinor@nytimes.com,Director of Sales,1383,1013,2396
3176,Kyrstin,Arnaudot,karnaudots@theguardian.com,Human Resources Assistant IV,8534,534,9068
3284,Maison,Cultcheth,mcultchetht@gnu.org,Analog Circuit Design manager,9443,415,9858
3044,Cobby,Scriviner,cscrivineru@hibu.com,Associate Professor,6680,1730,8410
3895,Felicia,Vieyra,fvieyrav@netvibes.com,Automation Specialist I,2718,693,3411
3005,Susi,Feander,sfeanderw@diigo.com,Mechanical Systems Engineer,9053,800,9853
3664,Izabel,Froom,ifroomx@adobe.com,Geologist IV,7307,525,7832
3080,Felicle,Mucklow,fmucklowy@bravesites.com,Financial Advisor,3739,644,4383
3609,Paco,Lung,plungz@tinypic.com,Teacher,3414,1987,5401
3723,Ewan,Ridett,eridett10@wikispaces.com,Engineer I,2716,1288,4004
3951,Ethe,Wadsworth,ewadsworth11@live.com,Senior Cost Accountant,9147,334,9481
3872,Leanor,Gut,lgut12@boston.com,Geologist III,4271,1987,6258
3476,Lissi,Rentenbeck,lrentenbeck13@sina.com.cn,Information Systems Manager,7049,1342,8391
3385,Shaina,Halloway,shalloway14@washingtonpost.com,Office Assistant II,6574,425,6999
3065,Thorvald,Ramas,tramas15@mtv.com,VP Sales,2426,1601,4027
3714,Darryl,Osgodby,dosgodby16@rambler.ru,Registered Nurse,2451,344,2795
3840,Husein,Bott,hbott17@ox.ac.uk,Compensation Analyst,6348,1735,8083
3670,Karalynn,Barkshire,kbarkshire18@reverbnation.com,Food Chemist,9445,297,9742
3973,Dedie,Feehery,dfeehery19@cargocollective.com,Nuclear Power Engineer,2217,1090,3307
3185,Thomas,Schoffler,tschoffler1a@delicious.com,Safety Technician III,5708,708,6416
3280,Dulcine,Bruntjen,dbruntjen1b@homestead.com,Electrical Engineer,9396,909,10305
3955,Donavon,Feaster,dfeaster1c@youtube.com,Programmer Analyst II,2750,1252,4002
3893,Kala,Leveridge,kleveridge1d@mapquest.com,Office Assistant III,3627,1111,4738
3493,Meade,Domanek,mdomanek1e@si.edu,Web Developer IV,7244,1565,8809
3626,Leopold,Galpin,lgalpin1f@etsy.com,Nurse Practicioner,1517,1539,3056
3423,Ivie,Francesco,ifrancesco1g@ted.com,Automation Specialist IV,1137,1236,2373
3686,Alberta,Rushbrook,arushbrook1h@icio.us,Librarian,6196,1315,7511
3633,Mimi,Amps,mamps1i@wp.com,Clinical Specialist,1775,1572,3347
3649,Devy,Dowsett,ddowsett1j@godaddy.com,Safety Technician II,5359,885,6244
3349,Randolf,Okenfold,rokenfold1k@spiegel.de,Software Engineer I,8714,1249,9963
3240,Crosby,Edlestone,cedlestone1l@shinystat.com,Database Administrator II,2850,967,3817
3592,Fidel,Mateescu,fmateescu1m@amazon.de,Geological Engineer,5553,1618,7171
3007,Britte,Guislin,bguislin1n@hp.com,Programmer Analyst IV,7059,649,7708
3256,Gerrilee,Matteris,gmatteris1o@huffingtonpost.com,VP Sales,6364,1303,7667
3630,Rozalie,Chretien,rchretien1p@tripadvisor.com,Physical Therapy Assistant,2790,1531,4321
3867,Barbra,Checchi,bchecchi1q@tuttocitta.it,Nuclear Power Engineer,6914,1070,7984
3982,Dorette,Giroldo,dgiroldo1r@slate.com,Geological Engineer,8142,1686,9828
3190,Otha,Shuard,oshuard1s@blinklist.com,Senior Developer,2783,1852,4635
3087,Dasi,Doddrell,ddoddrell1t@sohu.com,Software Consultant,4403,615,5018
3644,Melli,Kencott,mkencott1u@unicef.org,Administrative Officer,9230,1591,10821
3161,Lee,Fischer,lfischer1v@goo.ne.jp,Environmental Specialist,7016,1291,8307
3913,Hendrika,Spellissy,hspellissy1w@intel.com,Director of Sales,4311,1651,5962
3016,Kim,Pacher,kpacher1x@meetup.com,Financial Advisor,7174,1413,8587
3371,Roxi,Semens,rsemens1y@twitpic.com,Database Administrator IV,5744,371,6115
3145,Emelen,Kleinberer,ekleinberer1z@imgur.com,VP Sales,9145,838,9983
3170,Sheelagh,Tidball,stidball20@hibu.com,Chemical Engineer,2063,884,2947
3861,Irene,Blitzer,iblitzer21@flickr.com,Technical Writer,6287,857,7144
3020,Batsheva,Lamke,blamke22@sourceforge.net,Data Coordiator,9013,377,9390
3272,Karie,Candlin,kcandlin23@bandcamp.com,Physical Therapy Assistant,6784,392,7176
3864,Jasun,Hotson,jhotson26@unicef.org,Paralegal,7693,657,8350
3897,Amitie,Alyoshin,aalyoshin27@networkadvertising.org,Analyst Programmer,2591,1952,4543
3111,Opalina,Stanton,ostanton28@hatena.ne.jp,Occupational Therapist,9491,1481,10972
3881,Dorena,Oleksinski,doleksinski2a@google.co.jp,Graphic Designer,3986,1397,5383
3901,Aretha,Piken,apiken2b@shinystat.com,Geological Engineer,6829,494,7323
3474,Daryl,Esseby,desseby2c@pbs.org,VP Accounting,4797,1538,6335
3741,Arty,O'Dowling,aodowling2d@tripod.com,Automation Specialist I,7705,543,8248
3108,Cecilla,Frie,cfrie2e@addthis.com,Product Engineer,2055,910,2965
3063,Jeannine,Kidwell,jkidwell2f@google.it,Analog Circuit Design manager,5239,339,5578
3043,Art,Rapa,arapa2g@instagram.com,Database Administrator IV,4425,1074,5499
3683,Nina,Sebley,nsebley2h@sphinn.com,Operator,7857,277,8134
3375,Issi,Le Breton,ilebreton2i@youku.com,Clinical Specialist,4167,569,4736
3084,Spense,Eddowis,seddowis2j@uiuc.edu,Health Coach I,1341,456,1797
3286,Thorpe,Whinney,twhinney2k@bravesites.com,GIS Technical Architect,8193,779,8972
3488,Jocko,Kamena,jkamena2l@slate.com,Marketing Manager,2512,644,3156
3887,Gae,Perle,gperle2n@ucla.edu,Marketing Manager,6608,682,7290
3217,Glory,Allsup,gallsup2p@jugem.jp,Dental Hygienist,5766,1859,7625
3914,Dallis,Chellingworth,dchellingworth2q@rakuten.co.jp,Marketing Manager,6192,1986,8178
3331,Katrine,Bremond,kbremond2r@gov.uk,Electrical Engineer,5715,1437,7152
3396,Philippe,Pietasch,ppietasch2s@ning.com,Director of Sales,9806,1414,11220
3446,Cleavland,Wildin,cwildin2t@mlb.com,Recruiter,3208,1739,4947
3268,Jolie,Bezarra,jbezarra2u@google.co.jp,General Manager,1508,1543,3051
3855,Norris,Umbert,numbert2v@huffingtonpost.com,Associate Professor,3817,509,4326
3420,Jillayne,Voysey,jvoysey2w@desdev.cn,Biostatistician II,6047,712,6759
3866,Marline,Forst,mforst2x@usgs.gov,Research Nurse,9748,1863,11611
3479,Mano,Fallawe,mfallawe2y@lycos.com,Programmer II,4414,615,5029
3562,Bari,MacMenamin,bmacmenamin2z@i2i.jp,Internal Auditor,3204,1807,5011
3847,Pennie,Chesterton,pchesterton30@tiny.cc,Graphic Designer,4276,1862,6138
3717,Courtney,Gaishson,cgaishson31@paypal.com,Paralegal,3670,1515,5185
3865,Brien,Wallicker,bwallicker32@w3.org,Social Worker,1470,1486,2956
3812,Maximilianus,Barkworth,mbarkworth33@wordpress.org,Speech Pathologist,9272,1730,11002
3747,Zora,Shelford,zshelford34@google.com.br,Paralegal,9598,642,10240
3832,Hedy,Viggers,hviggers35@vimeo.com,Human Resources Assistant I,1642,503,2145
3345,Arlie,Tapper,atapper36@naver.com,Product Engineer,2304,1328,3632
3450,Jayson,De Ferrari,jdeferrari37@github.com,Web Designer I,8395,539,8934
3139,Lanette,Sukbhans,lsukbhans38@youtu.be,Product Engineer,5162,1485,6647
3605,Chen,Copland,ccopland39@printfriendly.com,Sales Associate,2041,660,2701
3074,Rena,Sherville,rsherville3a@domainmarket.com,Research Associate,9123,1236,10359
3224,Doy,Kochlin,dkochlin3b@gnu.org,Desktop Support Technician,2510,399,2909
3153,Leann,Cosbee,lcosbee3c@fastcompany.com,Mechanical Systems Engineer,9363,352,9715
3425,Othilie,Impey,oimpey3d@friendfeed.com,General Manager,4978,1351,6329
3319,Dorey,Wethered,dwethered3e@techcrunch.com,Health Coach IV,4057,206,4263
3763,Roddie,McKeowon,rmckeowon3f@geocities.jp,Staff Accountant II,7360,1724,9084
3033,Ellette,Attrey,eattrey3h@mtv.com,Paralegal,3575,665,4240
3964,Hazel,Jollie,hjollie3i@vimeo.com,Structural Engineer,9074,1993,11067
3946,Delmer,Kensett,dkensett3j@ask.com,GIS Technical Architect,1172,1337,2509
3197,Rorke,Iacovucci,riacovucci3k@noaa.gov,Web Developer I,6634,1465,8099
3989,Torey,Sherebrooke,tsherebrooke3l@skype.com,Sales Associate,6695,872,7567
3691,Joseito,Metham,jmetham3m@unesco.org,Nurse,8414,1492,9906
3543,Iolande,Belvin,ibelvin3o@arstechnica.com,Human Resources Manager,1236,955,2191
3813,Dorian,Spatoni,dspatoni3p@bbb.org,Tax Accountant,5727,354,6081
3576,Rhys,Gilford,rgilford3q@gov.uk,Librarian,5368,1823,7191
3090,Dicky,Bangle,dbangle3r@hc360.com,General Manager,1292,911,2203
3758,Arlie,Nurdin,anurdin3s@baidu.com,VP Product Management,7295,357,7652
3179,Rhody,Faughny,rfaughny3t@ucoz.com,Programmer I,7856,988,8844
3282,Ethelind,Beck,ebeck3u@tinypic.com,Junior Executive,3251,1668,4919
3659,Zonda,Dykins,zdykins3v@toplist.cz,Physical Therapy Assistant,6139,254,6393
3796,Fidole,Weekland,fweekland3w@jiathis.com,Social Worker,5109,805,5914
3241,Brianne,Joreau,bjoreau3y@craigslist.org,Analyst Programmer,5965,636,6601
3952,Germaine,Stout,gstout3z@eventbrite.com,Accountant I,4059,778,4837
3905,Dannie,Aimeric,daimeric40@comcast.net,Physical Therapy Assistant,1050,451,1501
3300,Tadeas,Bestman,tbestman41@nsw.gov.au,VP Accounting,8714,868,9582
3135,Jarrod,Piser,jpiser42@mysql.com,Administrative Assistant IV,1958,291,2249
3601,Hedi,Causton,hcauston43@4shared.com,Junior Executive,5965,1954,7919
3201,Ursulina,Caney,ucaney44@fda.gov,Chemical Engineer,3684,412,4096
3555,Daryl,Goldbourn,dgoldbourn45@harvard.edu,Web Developer IV,6547,373,6920
3412,Garrott,Rosenstengel,grosenstengel46@nih.gov,Compensation Analyst,6993,557,7550
3343,Birk,Pickover,bpickover47@webmd.com,Programmer Analyst IV,1445,1219,2664
3156,Olga,Poff,opoff48@ask.com,Editor,9071,1641,10712
3050,Stu,Goullee,sgoullee49@instagram.com,Account Coordinator,9157,1885,11042
3283,Pepillo,Klaas,pklaas4a@cmu.edu,Data Coordiator,7296,1392,8688
3096,Sholom,Prosek,sprosek4d@topsy.com,Design Engineer,3886,815,4701
3779,Chevy,Longhorn,clonghorn4e@oakley.com,Recruiting Manager,5367,907,6274
3267,Sigfried,Golthorpp,sgolthorpp4h@aol.com,Editor,8313,424,8737
3193,Leticia,Errey,lerrey4i@imageshack.us,Financial Analyst,5687,1085,6772
3010,Stanford,Beeching,sbeeching4k@independent.co.uk,Media Manager III,7288,1058,8346
3621,Vivyan,Humerstone,vhumerstone4l@prnewswire.com,Assistant Manager,7039,1273,8312
3341,Arny,Grose,agrose4m@bloglines.com,Help Desk Technician,8397,666,9063
3419,Dinny,Ehrat,dehrat4n@vimeo.com,Database Administrator IV,9340,300,9640
3882,Rooney,Smart,rsmart4o@seesaa.net,Computer Systems Analyst IV,8569,1565,10134
3775,Marion,Buttner,mbuttner4p@marketwatch.com,Pharmacist,9430,1575,11005
3103,Julieta,Strainge,jstrainge4q@macromedia.com,Dental Hygienist,5041,523,5564
3076,Sonny,Birmingham,sbirmingham4r@aboutads.info,Financial Advisor,3255,742,3997
3615,Parker,Wickman,pwickman4s@telegraph.co.uk,Physical Therapy Assistant,5691,907,6598
3484,Willi,Belloch,wbelloch4t@rakuten.co.jp,Database Administrator IV,7915,340,8255
3606,Domenico,Lidierth,dlidierth4v@wikimedia.org,GIS Technical Architect,1985,717,2702
3971,Doralin,Ivanin,divanin4w@webeden.co.uk,Analog Circuit Design manager,6810,610,7420
3414,Ulberto,Brewse,ubrewse4x@biblegateway.com,Staff Scientist,3434,1432,4866
3504,Lucretia,McCaffrey,lmccaffrey4y@arizona.edu,Pharmacist,6822,1449,8271
3227,Francesco,Donlon,fdonlon50@1688.com,Web Designer IV,1863,661,2524
3402,Arch,Vedeneev,avedeneev51@blinklist.com,Office Assistant III,5802,1813,7615
3344,Fitz,Tureville,ftureville52@networkadvertising.org,Senior Sales Associate,5720,1414,7134
3134,Fleming,Paolo,fpaolo53@cnn.com,GIS Technical Architect,3087,1104,4191
3749,Justis,Dolder,jdolder54@deliciousdays.com,Administrative Officer,3972,1906,5878
3515,Lonna,Roblett,lroblett55@epa.gov,Software Consultant,4050,1953,6003
3754,Taber,Ber,tber57@over-blog.com,Recruiting Manager,3006,370,3376
3827,Kaela,Baynard,kbaynard59@canalblog.com,Mechanical Systems Engineer,6010,998,7008
3580,Masha,Lille,mlille5c@oaic.gov.au,Senior Developer,3532,1232,4764
3112,Xena,Bubear,xbubear5e@cam.ac.uk,Physical Therapy Assistant,1534,766,2300
3177,Elliott,Fairhurst,efairhurst5f@constantcontact.com,Sales Representative,4005,1607,5612
3663,Silvanus,Minette,sminette5g@blog.com,Operator,6490,1769,8259
3383,Barnaby,Lathom,blathom5h@thetimes.co.uk,Computer Systems Analyst III,5543,1018,6561
3508,Fransisco,Mulvihill,fmulvihill5i@google.com.hk,Senior Quality Engineer,4851,1432,6283
3398,Liva,Slimm,lslimm5j@irs.gov,Information Systems Manager,6957,684,7641
3668,Lorene,Bland,lbland5k@a8.net,Senior Sales Associate,3839,336,4175
3554,Gianina,Pinder,gpinder5l@mozilla.org,Programmer III,1406,1579,2985
3814,Crista,MacCurtain,cmaccurtain5m@comsenz.com,Structural Engineer,6595,694,7289
3308,Chris,Siebart,csiebart5o@themeforest.net,Safety Technician IV,3927,1741,5668
3127,Francisco,D'Elias,fdelias5p@eepurl.com,Staff Accountant II,6097,1389,7486
3485,Evelyn,Northern,enorthern5t@youtu.be,Health Coach III,5130,286,5416
3886,Ashley,Litster,alitster5u@chicagotribune.com,Nurse,1754,1230,2984
3326,Lexine,Cornilleau,lcornilleau5v@typepad.com,Software Consultant,6216,840,7056
3920,Bernarr,Azemar,bazemar5w@delicious.com,VP Quality Control,7648,1988,9636
3180,Yuri,Peatheyjohns,ypeatheyjohns5x@moonfruit.com,Accountant III,8623,1962,10585
3950,Jacqueline,Rickhuss,jrickhuss5y@discovery.com,Cost Accountant,8737,271,9008
3389,Marci,Feavyour,mfeavyour5z@redcross.org,Systems Administrator I,3185,564,3749
3024,Gustavo,Baldazzi,gbaldazzi60@delicious.com,Programmer IV,2517,1702,4219
3354,Sue,Saffill,ssaffill61@scientificamerican.com,Financial Advisor,9478,589,10067
3126,Ivette,Yemm,iyemm62@slate.com,Programmer Analyst I,6453,1013,7466
3833,Arda,Parfitt,aparfitt63@microsoft.com,Recruiting Manager,6820,301,7121
3559,Anne,Ruggieri,aruggieri65@unblog.fr,Food Chemist,9558,1743,11301
3091,Fabien,Frake,ffrake66@sitemeter.com,Technical Writer,1895,276,2171
3505,Torin,Fuster,tfuster67@wsj.com,Programmer Analyst IV,3020,1962,4982
3688,Trever,Boothe,tboothe68@discuz.net,Librarian,9892,376,10268
3376,Berty,Koppen,bkoppen6a@hostgator.com,Compensation Analyst,5928,1268,7196
3151,Hestia,Yacob,hyacob6b@usnews.com,Accountant IV,1641,513,2154
3582,Harlin,Craine,hcraine6c@linkedin.com,Software Engineer I,7310,750,8060
3969,Dorene,Leak,dleak6d@nationalgeographic.com,Dental Hygienist,3617,686,4303
3625,Rikki,Mollon,rmollon6e@yellowbook.com,Account Executive,5715,1475,7190
3672,Trixy,Pareman,tpareman6f@dion.ne.jp,Account Coordinator,3980,1116,5096
3441,Abdel,Wolfer,awolfer6g@ning.com,Cost Accountant,9666,1352,11018
3036,Mireille,Slocombe,mslocombe6h@lulu.com,Teacher,3816,875,4691
3524,Bail,Ainsbury,bainsbury6i@ovh.net,Automation Specialist IV,4542,880,5422
3148,Eveleen,Edmott,eedmott6j@ca.gov,Geologist II,5010,902,5912
3409,Leonora,Pethick,lpethick6k@usatoday.com,Accountant I,6070,879,6949
3026,Dennet,Van't Hoff,dvanthoff6l@businessweek.com,Marketing Assistant,7575,1920,9495
3206,Nikaniki,Bye,nbye6m@mashable.com,Social Worker,7436,299,7735
3940,Frederigo,Bugg,fbugg6n@lulu.com,Editor,2678,714,3392
3742,Shandy,Murkitt,smurkitt6o@jigsy.com,Senior Financial Analyst,3834,252,4086
3154,Bailie,Crisford,bcrisford6p@technorati.com,Design Engineer,5319,956,6275
3722,Jacinta,Faulder,jfaulder6q@prlog.org,Systems Administrator I,6178,1553,7731
3842,Deerdre,Cumberbatch,dcumberbatch6r@squidoo.com,VP Sales,5193,525,5718
3931,Fidole,Eustace,feustace6s@artisteer.com,Assistant Media Planner,7542,927,8469
4000,Renaud,Elletson,relletson6t@symantec.com,General Manager,6927,1032,7959
3095,Bonni,Maskell,bmaskell6u@ustream.tv,Registered Nurse,3355,235,3590
3572,Tom,Roger,troger6w@stanford.edu,Design Engineer,3702,764,4466
3301,Abbey,Twelvetree,atwelvetree6x@a8.net,Analog Circuit Design manager,3066,1297,4363
3442,Lenora,Emblem,lemblem6y@dedecms.com,Safety Technician I,9723,1322,11045
3956,Winslow,Knill,wknill6z@paginegialle.it,Speech Pathologist,3823,869,4692
3521,Brucie,Fellman,bfellman70@ameblo.jp,Business Systems Development Analyst,4545,1717,6262
3777,Rodd,Brewse,rbrewse71@marriott.com,Occupational Therapist,3634,1829,5463
3073,Graham,Sloan,gsloan72@tamu.edu,Senior Financial Analyst,6344,1359,7703
3648,Henrik,O'Doogan,hodoogan73@eepurl.com,Computer Systems Analyst I,1989,919,2908
3471,Lee,Frounks,lfrounks74@hostgator.com,Internal Auditor,8973,1378,10351
3781,Pryce,Copes,pcopes75@weibo.com,Structural Engineer,9870,858,10728
3835,Carmine,Doddridge,cdoddridge76@cbsnews.com,GIS Technical Architect,7554,1827,9381
3598,Shanon,Redgrave,sredgrave78@angelfire.com,Software Consultant,9248,1100,10348
3207,Roda,Baert,rbaert79@telegraph.co.uk,Computer Systems Analyst III,3642,1456,5098
3704,Jehanna,Janowski,jjanowski7a@washingtonpost.com,Financial Advisor,3260,790,4050
3889,Sarge,Serrell,sserrell7b@mlb.com,Nuclear Power Engineer,8520,724,9244
3182,Dorri,Vidgen,dvidgen7c@over-blog.com,Statistician II,1155,624,1779
3519,Cari,Stodart,cstodart7e@plala.or.jp,Statistician IV,5042,1987,7029
3486,Latisha,Moscrop,lmoscrop7f@github.com,Senior Cost Accountant,8627,1048,9675
3590,Trace,Matterdace,tmatterdace7g@pbs.org,Research Nurse,3039,725,3764
3798,Ruthanne,Swendell,rswendell7h@mozilla.com,Executive Secretary,8232,1231,9463
3712,Berty,Standen,bstanden7i@livejournal.com,Marketing Manager,9138,338,9476
3631,Bambi,Rominov,brominov7j@simplemachines.org,Geological Engineer,8296,991,9287
3047,Meris,Van der Hoven,mvanderhoven7k@yahoo.co.jp,Recruiter,7183,449,7632
3876,Kellen,Sterley,ksterley7l@slideshare.net,Accountant III,5638,279,5917
3057,Horace,Dunster,hdunster7m@edublogs.org,Dental Hygienist,7564,574,8138
3805,Hurley,Berge,hberge7n@zimbio.com,Systems Administrator III,6889,1265,8154
3783,Kennith,Elvey,kelvey7o@psu.edu,Safety Technician I,6524,535,7059
3665,Cammy,Heasley,cheasley7t@mapquest.com,Occupational Therapist,4266,1673,5939
3927,Katinka,Blazhevich,kblazhevich7u@w3.org,Software Engineer IV,4795,1280,6075
3100,Morty,Forkan,mforkan7w@google.nl,Quality Control Specialist,1955,1702,3657
3599,Taddeusz,Duiguid,tduiguid7x@altervista.org,Senior Quality Engineer,2623,625,3248
3299,Adriano,Schankel,aschankel7y@earthlink.net,Nuclear Power Engineer,9245,1857,11102
3285,Caryl,Drinkall,cdrinkall7z@state.tx.us,GIS Technical Architect,9392,1318,10710
3038,Barnett,Mitcham,bmitcham80@washington.edu,Software Test Engineer III,6404,1961,8365
3351,Corbet,Winks,cwinks81@oaic.gov.au,Senior Cost Accountant,3008,1648,4656
3132,Clarence,Burrows,cburrows82@histats.com,Senior Cost Accountant,1984,969,2953
3961,Berenice,Fedorchenko,bfedorchenko84@gnu.org,Registered Nurse,4183,1201,5384
3232,Claudelle,Readshaw,creadshaw86@timesonline.co.uk,Assistant Professor,5988,1518,7506
3907,Dorothy,Rossbrooke,drossbrooke88@usda.gov,Recruiting Manager,2307,517,2824
3453,Beth,Haggie,bhaggie8a@skype.com,Assistant Manager,1006,1997,3003
3117,Bamby,Jepps,bjepps8b@plala.or.jp,Nurse Practicioner,8610,452,9062
3115,Noemi,Schottli,nschottli8c@xing.com,Project Manager,5121,282,5403
3136,Cristabel,Condell,ccondell8e@tmall.com,Senior Quality Engineer,7425,1964,9389
3137,Nils,Moynham,nmoynham8h@comcast.net,Geologist II,7119,1507,8626
3731,Thaxter,Marzello,tmarzello8i@tinyurl.com,Research Nurse,5712,1222,6934
3694,Sandra,Lighterness,slighterness8j@altervista.org,VP Quality Control,7110,1912,9022
3219,Ashlie,Simpkins,asimpkins8l@g.co,Tax Accountant,2574,1856,4430
3953,Jonell,Hansom,jhansom8m@xinhuanet.com,Software Engineer I,2204,363,2567
3158,Fawne,Pretti,fpretti8p@cargocollective.com,Research Nurse,9842,890,10732
3845,Shea,Borges,sborges8q@plala.or.jp,Physical Therapy Assistant,2538,954,3492
3815,Rafael,Abramof,rabramof8s@vistaprint.com,Physical Therapy Assistant,7855,1621,9476
3937,Merrili,Couronne,mcouronne8t@networkadvertising.org,VP Accounting,2830,1098,3928
3511,Leontyne,Fidoe,lfidoe8u@miibeian.gov.cn,Nurse,7932,1107,9039
3191,Fredric,Woofendell,fwoofendell8v@google.com.br,Programmer Analyst III,2823,750,3573
3851,Kimbra,Bedow,kbedow8w@slate.com,Speech Pathologist,9832,1982,11814
3818,Morty,Jowitt,mjowitt8y@thetimes.co.uk,Assistant Media Planner,7523,654,8177
3296,Aloise,Smeeth,asmeeth8z@usatoday.com,Financial Analyst,5161,1083,6244
3857,Hamil,Noseworthy,hnoseworthy90@dot.gov,Speech Pathologist,7362,1998,9360
3681,Rozelle,O'Carroll,rocarroll91@google.com.au,Recruiter,3814,1164,4978
3728,Brose,Kleinsinger,bkleinsinger92@ca.gov,Analog Circuit Design manager,6935,1880,8815
3784,Hillie,Maykin,hmaykin93@oaic.gov.au,Safety Technician IV,7234,1168,8402
3992,Land,Jekel,ljekel94@gizmodo.com,Senior Sales Associate,2749,885,3634
3651,Alexis,Gelly,agelly95@howstuffworks.com,Quality Control Specialist,2964,1484,4448
3013,Lisette,Mattersey,lmattersey96@sourceforge.net,Staff Accountant II,9643,502,10145
3557,Madelene,Wharmby,mwharmby98@washington.edu,Assistant Manager,8424,1454,9878
3899,Georgine,Jurges,gjurges9a@abc.net.au,Account Coordinator,8922,1456,10378
3288,Hamlen,Haet,hhaet9b@over-blog.com,Assistant Professor,8923,876,9799
3405,Vania,McAtamney,vmcatamney9c@yelp.com,Technical Writer,4075,757,4832
3540,Cam,Cromly,ccromly9d@cocolog-nifty.com,Business Systems Development Analyst,8359,1375,9734
3751,Ker,Avo,kavo9e@uiuc.edu,VP Accounting,8514,542,9056
3496,Ileana,Leate,ileate9f@who.int,Geological Engineer,9106,1155,10261
3315,Kaila,Oattes,koattes9h@t.co,General Manager,5856,1876,7732
3933,Alexandra,Banghe,abanghe9n@loc.gov,Account Executive,6465,449,6914
3673,Oliy,Ogden,oogden9o@spiegel.de,Statistician III,1034,926,1960
3918,Ferdinand,Wetherill,fwetherill9p@scribd.com,Account Executive,1104,235,1339
3539,Baxter,Pettiward,bpettiward9s@sogou.com,Account Representative II,5769,1778,7547
3647,Claresta,Beavington,cbeavington9t@jugem.jp,Software Consultant,6326,1275,7601
3298,Rowney,Natte,rnatte9u@discovery.com,Research Assistant II,3145,482,3627
3452,Malvina,Stoner,mstoner9x@ca.gov,Analog Circuit Design manager,4149,284,4433
3094,Phyllida,Akett,pakett9y@opera.com,Legal Assistant,4447,901,5348
3361,Amber,Spaldin,aspaldin9z@microsoft.com,Information Systems Manager,4563,1888,6451
3216,Hailee,Poulden,hpouldena0@usatoday.com,Pharmacist,5477,746,6223
3226,Boy,MacGovern,bmacgoverna2@lulu.com,Sales Associate,9519,692,10211
3460,Sim,Bretherick,sbrethericka4@rakuten.co.jp,Web Designer I,1683,373,2056
3856,Spence,Martland,smartlanda5@123-reg.co.uk,Software Test Engineer IV,6632,960,7592
3870,Vin,Elders,veldersa7@istockphoto.com,Statistician IV,1272,288,1560
3451,Estelle,Howerd,ehowerda9@about.me,Analyst Programmer,5479,1709,7188
3634,Nerte,McTurley,nmcturleyaa@google.nl,Software Engineer I,6104,821,6925
3716,Hazel,Megarry,hmegarryac@google.de,Office Assistant IV,2738,1968,4706
3492,Dot,Czyz,dczyzae@seesaa.net,Structural Engineer,9199,425,9624
3583,Evaleen,Rowbury,erowburyaf@sakura.ne.jp,VP Quality Control,5152,1262,6414
3215,Noam,Kitteringham,nkitteringhamag@ow.ly,Senior Cost Accountant,1763,881,2644
3849,Heddie,Drabble,hdrabbleah@unesco.org,Research Associate,5683,333,6016
3221,Althea,Djekic,adjekicai@time.com,Research Nurse,2649,1684,4333
3574,Darcie,Lydiatt,dlydiattal@phoca.cz,Web Designer IV,3520,730,4250
3850,Taber,Murname,tmurnameam@dot.gov,Social Worker,6620,270,6890
3854,Evvie,Trenfield,etrenfieldan@netlog.com,Geologist IV,1670,1517,3187
3963,Goldy,Haskayne,ghaskayneao@lulu.com,Recruiter,8794,603,9397
3212,Rene,Danser,rdanserap@wikispaces.com,Graphic Designer,9624,522,10146
3454,Keriann,Glanders,kglandersaq@desdev.cn,Web Developer III,9857,1269,11126
3578,Bryce,Milburn,bmilburnar@goo.ne.jp,Recruiting Manager,8668,490,9158
3266,Arluene,Angear,aangearas@ucsd.edu,Chemical Engineer,8446,1326,9772
3684,Correy,Setterington,csetteringtonat@drupal.org,Business Systems Development Analyst,6128,1274,7402
3782,Blair,Pimer,bpimerau@biglobe.ne.jp,Cost Accountant,3058,362,3420
3942,Marci,Broadbear,mbroadbearav@nationalgeographic.com,Operator,7227,1158,8385
3823,Dorisa,Colling,dcollingaw@wikispaces.com,Chemical Engineer,7711,567,8278
3944,Axe,Pidwell,apidwellay@uol.com.br,Media Manager I,4552,1350,5902
3908,Amandie,Kleanthous,akleanthousaz@reuters.com,VP Marketing,3678,344,4022
3687,Norton,Donaldson,ndonaldsonb0@typepad.com,Speech Pathologist,2218,1585,3803
3018,Austina,McGregor,amcgregorb6@webnode.com,VP Product Management,4375,1537,5912
3993,Aube,McNish,amcnishb8@pen.io,Product Engineer,4906,1359,6265
3536,Juline,Neggrini,jneggrinib9@zimbio.com,Account Representative I,9720,1313,11033
3792,Sherill,Tills,stillsbb@addthis.com,Administrative Assistant IV,1502,928,2430
3011,Eileen,Bedenham,ebedenhambd@edublogs.org,Director of Sales,6002,1453,7455
3410,Fabio,Attewill,fattewillbf@dot.gov,Graphic Designer,1247,1817,3064
3459,Karrah,Davey,kdaveybg@oaic.gov.au,Web Developer I,5565,1344,6909
3935,Etty,Gawler,egawlerbh@archive.org,Administrative Officer,7463,1623,9086
3906,Jorrie,Dallimare,jdallimarebi@examiner.com,Information Systems Manager,3092,777,3869
3334,Perren,Eggers,peggersbk@phoca.cz,Administrative Officer,8891,1588,10479
3397,Tildie,Braunroth,tbraunrothbl@businessweek.com,Research Associate,2994,1530,4524
3653,Ammamaria,Romanelli,aromanellibo@nydailynews.com,Media Manager IV,7622,655,8277
3858,Austine,Greenway,agreenwaybp@1und1.de,Associate Professor,5446,1073,6519
3088,Filberto,Moncreiffe,fmoncreiffebq@shinystat.com,Tax Accountant,8598,1368,9966
3757,Jarred,Benjefield,jbenjefieldbr@networksolutions.com,Data Coordiator,9408,1198,10606
3260,Wallie,Mollnar,wmollnarbs@whitehouse.gov,Staff Scientist,6927,1270,8197
3824,Gail,Macklam,gmacklambt@slashdot.org,Human Resources Assistant II,1002,1652,2654
3990,Cesar,Crang,ccrangbw@free.fr,Staff Accountant II,3752,1048,4800
3563,Cyb,Mulholland,cmulhollandbx@pbs.org,Computer Systems Analyst III,1181,1662,2843
3133,Salvador,Barmadier,sbarmadierby@china.com.cn,Design Engineer,7148,573,7721
3629,Benedetto,Dudley,bdudleybz@upenn.edu,Operator,3867,1954,5821
3302,Wiley,Canepe,wcanepec0@seesaa.net,Compensation Analyst,7258,264,7522
3594,Sean,Draisey,sdraiseyc1@hubpages.com,Environmental Tech,4472,1745,6217
3863,Darda,Atwill,datwillc3@gravatar.com,Financial Analyst,4439,1461,5900
3166,Germain,Spottiswoode,gspottiswoodec4@amazon.com,Occupational Therapist,2217,1774,3991
3528,Diane,Iannuzzi,diannuzzic6@livejournal.com,Accountant I,9921,1562,11483
3719,Georgiana,Stodart,gstodartc7@home.pl,GIS Technical Architect,1101,1940,3041
3432,Kerrin,Roundtree,kroundtreec9@squarespace.com,VP Sales,7804,1069,8873
3604,Darline,Eberz,deberzcc@acquirethisname.com,Editor,6731,880,7611
3495,Dorella,Ludovici,dludovicicd@xrea.com,Information Systems Manager,8557,1387,9944
3740,Ninette,Kenneford,nkennefordcf@altervista.org,Structural Engineer,1489,1501,2990
3388,Eugine,Holbury,eholburych@chron.com,Research Nurse,1902,1468,3370
3703,Ethyl,Heppner,eheppnerck@nps.gov,Project Manager,7316,1459,8775
3082,Salli,Tofpik,stofpikcl@artisteer.com,Nuclear Power Engineer,1735,1855,3590
3642,Guglielmo,Ripsher,gripshercn@paypal.com,Sales Associate,6851,1772,8623
3869,Hinda,Maidens,hmaidensco@wp.com,Account Executive,5552,574,6126
3919,Levon,Timothy,ltimothycp@cnbc.com,Engineer IV,4745,1271,6016
3640,Tabb,Bryant,tbryantcs@freewebs.com,Quality Engineer,6202,444,6646
3507,Mindy,Siemianowicz,msiemianowiczct@marketwatch.com,Staff Scientist,6317,807,7124
3392,Mikael,Towsey,mtowseycw@theglobeandmail.com,Geologist IV,1439,1374,2813
3142,Ely,D'Ambrosio,edambrosiod3@tuttocitta.it,Safety Technician III,8657,560,9217
3178,Drucie,Braunes,dbraunesd5@tuttocitta.it,Research Assistant I,5735,1716,7451
3363,Greer,Ackerley,gackerleyd6@dailymail.co.uk,Geologist IV,9703,383,10086
3467,Ado,De Bell,adebelld7@redcross.org,Teacher,9801,931,10732
3724,Ned,Petracci,npetraccid9@jalbum.net,Nuclear Power Engineer,2656,636,3292
3972,Jermain,Snar,jsnardb@cbc.ca,Help Desk Operator,7965,945,8910
3890,Jodi,Abramovitch,jabramovitchdc@mapy.cz,Systems Administrator II,6557,934,7491
3466,Stafford,Gayle,sgaylede@storify.com,Recruiting Manager,2083,640,2723
3585,Margret,Georgescu,mgeorgescudh@cyberchimps.com,Assistant Professor,4725,1459,6184
3998,Samara,Rhymes,srhymesdi@flavors.me,Systems Administrator I,2948,831,3779
3293,Velvet,Ashelford,vashelforddj@ucsd.edu,Quality Engineer,5615,750,6365
3828,Aubrey,Scopes,ascopesdk@npr.org,Community Outreach Specialist,6437,1720,8157
3244,Marshall,Posner,mposnerdo@hibu.com,Civil Engineer,1860,837,2697
3715,Annis,Wingate,awingatedp@opera.com,Chief Design Engineer,2254,1462,3716
3575,Durante,Tamblingson,dtamblingsondq@com.com,General Manager,8327,1610,9937
3705,Flossie,Kisar,fkisardr@ifeng.com,Software Test Engineer III,3577,1085,4662
3447,Channa,Kinane,ckinaneds@slate.com,Recruiting Manager,2772,1946,4718
3261,Solomon,Gresly,sgreslydu@pagesperso-orange.fr,Executive Secretary,5826,1660,7486
3577,Krysta,Drewet,kdrewetdv@wunderground.com,Internal Auditor,9488,383,9871
3431,Conney,Allaway,callawaydx@bluehost.com,Tax Accountant,9350,1779,11129
3785,Xymenes,Edgin,xedgindy@dmoz.org,Compensation Analyst,7178,656,7834
3265,Karrah,Gifkins,kgifkinsdz@bing.com,Web Developer IV,4576,846,5422
3976,Cyb,Dearn,cdearne1@ucla.edu,Community Outreach Specialist,2284,869,3153
3945,Nat,Shelper,nshelpere3@time.com,Financial Advisor,1596,1486,3082
3330,Jarid,Devote,jdevotee4@miitbeian.gov.cn,Chief Design Engineer,2960,362,3322
3925,Cthrine,Flewett,cflewette6@1und1.de,Research Assistant III,8472,747,9219
3456,Filberto,Kraft,fkrafte9@youtu.be,Structural Analysis Engineer,9988,1318,11306
3231,Orsola,Dimitru,odimitruea@themeforest.net,Electrical Engineer,4337,1907,6244
3678,Elsinore,Rousby,erousbyeb@51.la,Executive Secretary,2708,623,3331
3066,Leta,Rosenblath,lrosenblathec@pcworld.com,Desktop Support Technician,8920,1958,10878
3312,Clemence,Murkin,cmurkinef@globo.com,Director of Sales,7602,1587,9189
3997,Meredithe,Rushsorth,mrushsortheg@jigsy.com,Account Representative III,8424,1914,10338
3120,Hyacinthe,Summerson,hsummersoneh@simplemachines.org,Teacher,2056,1617,3673
3534,Miguelita,Torry,mtorryei@mlb.com,Junior Executive,6087,1981,8068
3155,Gelya,Aslam,gaslamel@lulu.com,GIS Technical Architect,5525,706,6231
3098,Ulrick,Slateford,uslateforden@geocities.jp,Help Desk Technician,3079,1503,4582
3983,Kordula,Fitter,kfittereo@un.org,Recruiter,1913,1069,2982
3237,Glen,Aulsford,gaulsfordeq@joomla.org,Compensation Analyst,6776,256,7032
3879,Rafaelita,Tregona,rtregonaer@microsoft.com,Accounting Assistant III,4153,1094,5247
3258,Roberta,Dupoy,rdupoyet@usnews.com,Nurse Practicioner,4326,761,5087
3497,Crista,Stokell,cstokelleu@unesco.org,Nurse,9405,1387,10792
3759,Adelle,Coal,acoalev@cafepress.com,Senior Developer,5731,339,6070
3960,Benjamen,Gutridge,bgutridgeew@last.fm,Tax Accountant,5673,1603,7276
3768,Gonzales,Martland,gmartlandf0@odnoklassniki.ru,Geological Engineer,4493,662,5155
3567,Gris,Truluck,gtruluckf1@wp.com,Librarian,9268,614,9882
3892,Giavani,Fulmen,gfulmenf2@mac.com,VP Accounting,9705,1148,10853
3566,Barb,Haskett,bhaskettf3@blogtalkradio.com,Staff Scientist,2122,1281,3403
3558,Christi,Oxborough,coxboroughf7@seesaa.net,Statistician IV,4933,232,5165
3225,Penni,Lyosik,plyosikf8@wunderground.com,Social Worker,8022,1421,9443
3553,Bryn,Seldner,bseldnerfb@independent.co.uk,Systems Administrator II,4100,1707,5807
3498,Bernie,McPhilip,bmcphilipfc@gravatar.com,VP Quality Control,2667,1986,4653
3902,Gay,Abramzon,gabramzonfe@yahoo.co.jp,Marketing Manager,2785,837,3622
3448,Ebonee,Sivess,esivessff@trellian.com,Senior Quality Engineer,7158,1063,8221
3532,Anatole,Muttock,amuttockfg@opensource.org,Electrical Engineer,7534,1436,8970
3487,Derril,Jenken,djenkenfi@eventbrite.com,Programmer Analyst IV,9758,870,10628
3195,Chrysler,McPolin,cmcpolinfk@abc.net.au,Programmer Analyst I,4995,224,5219
3022,Nelie,Cadlock,ncadlockfp@mozilla.com,Research Nurse,2071,1737,3808
3761,Sammie,Kirwan,skirwanfw@mlb.com,Civil Engineer,6561,959,7520
3698,Bridgette,Dalloway,bdallowayfx@dot.gov,Systems Administrator IV,4970,981,5951
3490,Maurita,Gorling,mgorlingg1@tiny.cc,Automation Specialist II,9350,1542,10892
3077,Christan,Catcheside,ccatchesideg3@columbia.edu,Paralegal,2095,213,2308
3480,Jeanine,Trewett,jtrewettg4@archive.org,Human Resources Assistant III,5667,748,6415
3711,Briana,Juniper,bjuniperg7@jugem.jp,Safety Technician III,3681,1395,5076
3638,Andeee,Redford,aredfordg8@weebly.com,Software Test Engineer II,5150,277,5427
3411,Montague,Kisby,mkisbygb@biglobe.ne.jp,Actuary,3240,666,3906
3752,Hillel,Alenikov,halenikovgd@goodreads.com,Help Desk Technician,5093,282,5375
3733,Marieann,Cosins,mcosinsgf@discovery.com,Tax Accountant,1236,1785,3021
3753,Vivienne,Jordeson,vjordesongg@wiley.com,Actuary,8110,1746,9856
3878,Dulcine,Rikard,drikardgi@woothemes.com,GIS Technical Architect,6565,1102,7667
3799,Rosette,Chat,rchatgk@instagram.com,Registered Nurse,4659,793,5452
3656,Fifi,Kibbee,fkibbeegm@indiatimes.com,Quality Control Specialist,3623,370,3993
3780,Renard,Francie,rfranciegp@skype.com,Graphic Designer,9193,1929,11122
3370,Kim,Coghill,kcoghillgr@webnode.com,Desktop Support Technician,7623,241,7864
3251,Gael,McPolin,gmcpolings@w3.org,Mechanical Systems Engineer,8632,894,9526
3510,Aigneis,Bromhead,abromheadgv@thetimes.co.uk,Systems Administrator IV,2318,1540,3858
3939,Vicki,Dyball,vdyballgw@elpais.com,Data Coordiator,8374,585,8959
3198,Thadeus,Mathews,tmathewsgy@twitter.com,Administrative Officer,6881,1197,8078
3192,Carlita,Teenan,cteenangz@va.gov,Business Systems Development Analyst,5163,1685,6848
3483,Christine,Spilsted,cspilstedh0@unicef.org,Librarian,3554,1876,5430
3027,Nathanael,Matys,nmatysh1@bloomberg.com,VP Marketing,1283,1777,3060
3204,Shannon,Monte,smonteh7@wired.com,Actuary,6335,961,7296
3482,Kerrie,Burgise,kburgisehe@nytimes.com,VP Sales,7257,1917,9174
3518,Archibold,Nevill,anevillhf@vk.com,Product Engineer,8481,1172,9653
3440,Idaline,Aldam,ialdamhh@amazon.co.jp,Geological Engineer,6640,467,7107
3358,Rahel,Churchill,rchurchillhi@cafepress.com,Senior Cost Accountant,9338,1419,10757
3379,Salomi,McCumesky,smccumeskyhj@shutterfly.com,VP Quality Control,8355,648,9003
3680,Menard,Quincey,mquinceyhr@state.tx.us,Quality Control Specialist,7218,499,7717
3250,Thain,Peschke,tpeschkeht@free.fr,Senior Editor,2300,1566,3866
3750,Francyne,Carlon,fcarlonhx@people.com.cn,Sales Associate,8977,774,9751
3547,Modestine,Ielden,mieldenhy@ft.com,Assistant Professor,3454,758,4212
3417,Celka,Drinkall,cdrinkallhz@angelfire.com,Chief Design Engineer,3341,1308,4649
3337,Beilul,Culpen,bculpeni1@naver.com,Environmental Specialist,6615,636,7251
3636,Corabel,Purver,cpurveri4@surveymonkey.com,Quality Engineer,7801,897,8698
3152,Shirlene,Assinder,sassinderi8@nih.gov,Web Designer II,5811,642,6453
3324,Elberta,Mutter,emutterib@lycos.com,Dental Hygienist,9939,650,10589
3611,Nathanil,Boxhall,nboxhallic@yandex.ru,Web Designer IV,2131,692,2823
3730,Crissy,Ivashnyov,civashnyovid@amazon.de,Geological Engineer,1603,543,2146
3239,Leshia,Iveson,livesonie@accuweather.com,Operator,4533,1974,6507
3660,Yvon,Twine,ytwineif@unicef.org,Software Test Engineer I,8456,1889,10345
3175,Ruperta,Atcock,ratcockih@archive.org,Recruiter,3893,1828,5721
3807,Creight,Coltart,ccoltartik@last.fm,Engineer IV,1005,1924,2929
3213,Ronald,Povey,rpoveyiq@quantcast.com,Software Consultant,6175,1214,7389
3329,Lazaro,Tuddenham,ltuddenhamir@taobao.com,Senior Sales Associate,1894,1547,3441
3613,Ania,Blackstock,ablackstockis@mozilla.com,Developer III,6937,851,7788
3004,Maureene,Drews,mdrewsit@youtube.com,Editor,1471,1373,2844
3819,Fields,Gambles,fgamblesiv@studiopress.com,Account Executive,8588,300,8888
3184,Cheri,Silkstone,csilkstoneiy@about.com,Nuclear Power Engineer,5280,1618,6898
3169,Adrianne,Vasnetsov,avasnetsovj1@bandcamp.com,Statistician III,2789,753,3542
3325,Neils,Adlem,nadlemj3@imdb.com,Help Desk Operator,4419,559,4978
3220,Elbertine,Whitlaw,ewhitlawj5@chron.com,Help Desk Technician,1391,1986,3377
3222,Lynnett,Peinton,lpeintonj6@dion.ne.jp,Database Administrator III,7074,700,7774
3017,Killie,Gottschalk,kgottschalkja@etsy.com,Senior Sales Associate,8735,1348,10083
3550,Rosanna,Cracie,rcraciejd@about.com,Systems Administrator IV,6866,995,7861
3745,Tamqrah,Bechley,tbechleyje@icq.com,Clinical Specialist,6091,2000,8091
3335,Letisha,Billiard,lbilliardjf@simplemachines.org,Research Associate,1256,340,1596
3269,Petrina,Cardozo,pcardozojh@weibo.com,GIS Technical Architect,1313,1167,2480
3909,Corbett,Hare,charejl@youku.com,Compensation Analyst,8369,368,8737
3995,Mufi,Edwards,medwardsjm@sciencedirect.com,Technical Writer,9822,858,10680
3512,Connor,Beadle,cbeadlejn@reddit.com,Biostatistician III,4953,1201,6154
3607,Amos,Stitson,astitsonjo@army.mil,Recruiter,9144,443,9587
3666,Brana,Beeden,bbeedenjp@ovh.net,Data Coordiator,4295,204,4499
3029,Isobel,Pischoff,ipischoffjq@kickstarter.com,VP Marketing,2859,1200,4059
3692,Claudian,Forbes,cforbesju@tripod.com,Quality Control Specialist,7711,1514,9225
3443,Darya,Francino,dfrancinojw@wikispaces.com,Product Engineer,9709,849,10558
3236,Torie,Bickardike,tbickardikejx@virginia.edu,Graphic Designer,7827,1420,9247
3105,Colly,Bygreaves,cbygreavesjy@wordpress.org,Desktop Support Technician,8286,419,8705
3568,Dorrie,Londesborough,dlondesboroughk4@home.pl,Health Coach I,1341,682,2023
3439,Hussein,Rice,hricekb@nba.com,Account Representative I,1274,402,1676
3242,Darnall,Dunleavy,ddunleavykf@github.com,Software Consultant,7422,1763,9185
3888,Bettine,Soutar,bsoutarki@mit.edu,Sales Associate,6756,626,7382
3357,Arvin,Chillingworth,achillingworthkj@storify.com,Director of Sales,9733,1585,11318
3173,Ryley,Gosland,rgoslandkn@usnews.com,VP Accounting,9763,447,10210
3535,Ruthie,McHardy,rmchardyko@last.fm,Staff Scientist,6960,466,7426
3119,Jannelle,Ellison,jellisonkq@nhs.uk,Analog Circuit Design manager,4839,928,5767
3928,Tallia,Gasson,tgassonkr@angelfire.com,Design Engineer,5302,496,5798
3756,Aymer,Besnard,abesnardks@walmart.com,Teacher,6298,1381,7679
3930,Debi,Beves,dbevesku@cornell.edu,Software Consultant,6275,249,6524
3457,Sabina,Massei,smasseikv@tinyurl.com,Actuary,8969,1544,10513
3588,Duke,Marcq,dmarcqky@cnet.com,Chief Design Engineer,8467,1605,10072
3327,Carri,Spottiswoode,cspottiswoodel0@scientificamerican.com,Recruiter,7910,1430,9340
3620,Ingrim,Hanes,ihanesl1@webnode.com,Associate Professor,2169,1667,3836
3116,Marchelle,Still,mstilll2@businessweek.com,Senior Developer,4863,1237,6100
3395,Allissa,Wilbraham,awilbrahaml3@icio.us,Actuary,6952,1083,8035
3338,Elyn,Hammell,ehammelll4@google.de,Product Engineer,3378,1335,4713
3900,Merilee,Janovsky,mjanovskyl5@fc2.com,Computer Systems Analyst IV,4479,1881,6360
3332,Courtenay,Tickle,cticklela@dedecms.com,Director of Sales,6336,1507,7843
3706,Michel,Baccup,mbaccuplc@comsenz.com,Electrical Engineer,3809,844,4653
3075,Gloriane,Gaye,ggayeld@bravesites.com,Marketing Assistant,6840,1522,8362
3738,Reggis,Kinsett,rkinsettlf@msn.com,Administrative Assistant I,7744,1512,9256
3762,Payton,Blonden,pblondenli@omniture.com,Social Worker,4867,837,5704
3841,Aryn,Labb,alabbll@theatlantic.com,Senior Editor,8381,239,8620
3713,Ruy,Elph,relphln@cornell.edu,Senior Developer,8513,814,9327
3141,Cooper,Hutten,chuttenlp@wordpress.org,Tax Accountant,8573,1324,9897
3384,Fancy,Wreight,fwreightlq@bluehost.com,Programmer III,8401,1684,10085
3259,Margarethe,Plaunch,mplaunchls@tripod.com,Accountant III,5227,545,5772
3727,Pepillo,Culbard,pculbardlx@utexas.edu,Account Representative III,7489,826,8315
3035,Cheston,Halliburton,challiburtonly@sfgate.com,Associate Professor,5182,1695,6877
3436,Malissa,Tackes,mtackesm1@wikispaces.com,Database Administrator II,1610,929,2539
3917,Amil,Wimlet,awimletm2@gmpg.org,Media Manager II,6758,1864,8622
3211,Matty,Phette,mphettem3@comcast.net,Developer III,2524,578,3102
3123,Mattias,Myrkus,mmyrkusm5@skyrock.com,Developer IV,2437,391,2828
3924,Laurella,Fredson,lfredsonm6@freewebs.com,Nurse Practicioner,9406,1564,10970
3707,Othella,Ackrill,oackrillm8@latimes.com,Registered Nurse,3232,284,3516
3898,Tonie,Klyner,tklynermb@tiny.cc,Programmer Analyst II,5529,1253,6782
3445,Gibb,Milne,gmilneme@npr.org,Paralegal,5127,1202,6329
3721,Trixi,Goodyer,tgoodyermf@yahoo.co.jp,Teacher,5276,677,5953
3852,Tish,Mapp,tmappmh@weebly.com,Product Engineer,3901,1566,5467
3859,Stephie,Wye,swyemi@dot.gov,Occupational Therapist,7876,421,8297
3477,Prue,McGlew,pmcglewmk@hp.com,Desktop Support Technician,2117,524,2641
3903,Clyde,Harflete,charfletemn@time.com,Human Resources Assistant III,8627,545,9172
3826,Delores,Pyzer,dpyzermo@liveinternet.ru,Environmental Specialist,3231,1785,5016
3249,Kerwin,Marrow,kmarrowmq@cloudflare.com,Software Test Engineer II,2846,1067,3913
3875,Tammie,Tadman,ttadmanmt@patch.com,Assistant Manager,8984,1550,10534
3643,Dredi,Schneidau,dschneidaumu@fda.gov,Payment Adjustment Coordinator,8104,794,8898
3333,Brucie,Ancell,bancellmv@cargocollective.com,GIS Technical Architect,1425,1710,3135
3001,Whitney,Grizard,wgrizardmy@accuweather.com,VP Quality Control,5414,1791,7205
3720,Charley,Gerriet,cgerrietmz@nih.gov,Budget/Accounting Analyst II,1695,1290,2985
3113,Gerti,Norfolk,gnorfolkn0@networksolutions.com,Programmer Analyst I,9994,1273,11267
3791,Yorgo,Pavlov,ypavlovn1@sohu.com,Research Assistant I,2928,775,3703
3570,Maiga,De Cruze,mdecruzen5@ed.gov,Media Manager I,3856,1160,5016
3671,Adelice,Spincke,aspincken6@taobao.com,Associate Professor,8719,1250,9969
3984,Fidole,Cerie,fcerienb@hibu.com,Geologist II,8268,526,8794
3803,Dante,Danaher,ddanahernc@apache.org,Quality Engineer,3505,416,3921
3915,Syd,Fairhead,sfairheadne@google.com.hk,Engineer IV,6288,1319,7607
3131,Frederique,Kinny,fkinnynj@microsoft.com,Human Resources Manager,6475,1712,8187
3546,Stefano,Eliet,selietnl@alibaba.com,Financial Advisor,7256,745,8001
3968,Hercules,Damrell,hdamrellnn@ocn.ne.jp,Registered Nurse,5968,1914,7882
3661,Lela,Bignal,lbignalns@nifty.com,Nuclear Power Engineer,7841,1298,9139
3502,Lyndsie,Kevern,lkevernnt@ted.com,Analog Circuit Design manager,1320,346,1666
3071,Bryant,Howton,bhowtono0@wunderground.com,Legal Assistant,7946,1184,9130
3078,Bari,Lanegran,blanegrano2@nba.com,Marketing Manager,6967,908,7875
3802,Shanna,Deegan,sdeegano5@businesswire.com,Environmental Specialist,9404,1539,10943
3994,Sibbie,Lanyon,slanyono8@geocities.jp,Web Designer IV,9604,1971,11575
3734,Opaline,Digger,odiggero9@blogger.com,Geologist II,6396,438,6834
3373,Vivi,Bougen,vbougenob@shinystat.com,Technical Writer,2192,985,3177
3926,Maddy,Romme,mrommeod@springer.com,Systems Administrator III,6636,1687,8323
3635,Donielle,Fortey,dforteyof@elegantthemes.com,Speech Pathologist,1970,872,2842
3657,Lorry,Semeradova,lsemeradovaog@businessweek.com,Registered Nurse,4794,1203,5997
3381,Faye,Greenset,fgreensetoi@rambler.ru,Graphic Designer,6469,1913,8382
3744,Herby,Ca,hcaok@phoca.cz,Budget/Accounting Analyst II,2888,1725,4613
3014,Tristam,Gerrit,tgerritol@loc.gov,Senior Quality Engineer,1186,932,2118
3473,Fifine,Marre,fmarreom@printfriendly.com,Clinical Specialist,6692,701,7393
3769,Kerianne,Punter,kpunteroo@csmonitor.com,Developer II,1323,1663,2986
3157,Drake,Gallimore,dgallimoreoq@hexun.com,Analog Circuit Design manager,8052,1821,9873
3921,Dasie,Terbeek,dterbeekov@reuters.com,Professor,7046,1986,9032
3646,Norma,Stearns,nstearnsow@columbia.edu,Analyst Programmer,8614,1004,9618
3494,Selena,Penner,spenneroz@ifeng.com,Sales Associate,1147,1773,2920
3612,Elsi,Pinxton,epinxtonp0@pinterest.com,Accountant IV,9058,1935,10993
3418,Imelda,O'Donoghue,iodonoghuep1@blogspot.com,Marketing Assistant,5188,1752,6940
3118,Cliff,Couvert,ccouvertp4@boston.com,Design Engineer,9327,853,10180
3874,Reilly,Hache,rhachep7@boston.com,Administrative Officer,9542,588,10130
3923,Jessalin,Franzke,jfranzkepf@facebook.com,Research Assistant I,4277,1303,5580
3489,Maxine,McGrale,mmcgralepg@smugmug.com,Executive Secretary,4053,223,4276
3160,Beulah,Ticic,bticicpk@hostgator.com,Financial Advisor,9659,1777,11436
3048,Reggie,McCallam,rmccallampm@tmall.com,Statistician I,6204,664,6868
3367,Cos,Attyeo,cattyeopn@wunderground.com,Marketing Assistant,8953,200,9153
3455,Cherri,Schimpke,cschimpkepp@istockphoto.com,Senior Cost Accountant,7830,1312,9142
3579,Starlin,Ashingden,sashingdenps@cmu.edu,Associate Professor,7955,1837,9792
3954,Emili,Burtwell,eburtwellpt@umich.edu,Dental Hygienist,1635,1577,3212
3948,Guillemette,Vickerstaff,gvickerstaffpu@shinystat.com,Director of Sales,2441,804,3245
3700,Kikelia,Brooksbank,kbrooksbankpv@baidu.com,Account Coordinator,1793,306,2099
3322,Mortie,Clissell,mclissellpw@yandex.ru,Account Coordinator,2626,1923,4549
3632,Humphrey,Hallet,hhalletpz@dedecms.com,VP Accounting,6913,990,7903
3054,Konstance,Alderman,kaldermanq1@w3.org,Executive Secretary,7835,1591,9426
3246,Nahum,Bortoloni,nbortoloniq3@guardian.co.uk,Health Coach III,1850,1350,3200
3276,Frasier,Batte,fbatteq5@indiegogo.com,Health Coach II,8054,1105,9159
3608,Lowell,Cowton,lcowtonq6@intel.com,Paralegal,8088,1871,9959
3677,Val,McLeman,vmclemanqc@eepurl.com,Registered Nurse,9209,1697,10906
3140,Barby,Britton,bbrittonqf@npr.org,Chief Design Engineer,5012,1402,6414
3475,Ranice,Jarmain,rjarmainqh@squarespace.com,Food Chemist,8299,1807,10106
3910,Courtney,Skettles,cskettlesqi@nbcnews.com,Information Systems Manager,9501,928,10429
3581,Salomon,Russo,srussoqk@noaa.gov,VP Marketing,1478,1819,3297
3985,Ray,Sline,rslineqn@nationalgeographic.com,GIS Technical Architect,8518,787,9305
3834,Pandora,Skill,pskillqo@simplemachines.org,Software Test Engineer III,3366,1203,4569
3808,Odie,Skevington,oskevingtonqq@senate.gov,Information Systems Manager,1571,1541,3112
3321,Corrinne,Colkett,ccolkettqr@ox.ac.uk,VP Sales,7469,1581,9050
3830,Blanca,Poytress,bpoytressqv@guardian.co.uk,Statistician II,9143,1564,10707
3693,Corbie,Krienke,ckrienkeqw@hp.com,Nuclear Power Engineer,7690,1045,8735
3765,Emmanuel,Sharland,esharlandqx@de.vu,Director of Sales,7384,1743,9127
3837,Maryjo,MacElholm,mmacelholmqz@un.org,Health Coach IV,6003,526,6529
3104,Marlon,Tabor,mtaborr1@xrea.com,Office Assistant III,4758,1298,6056
3380,Harlin,Maitland,hmaitlandr2@tripod.com,Staff Accountant IV,8566,1839,10405
3652,Sidonia,Disman,sdismanr3@artisteer.com,VP Quality Control,3503,829,4332
3922,Alvera,Dullard,adullardr5@bbb.org,Food Chemist,7296,985,8281
3980,Dahlia,Malenoir,dmalenoirr7@icq.com,Media Manager III,8188,424,8612
3967,Kara-lynn,Loughney,kloughneyr8@biblegateway.com,Human Resources Assistant IV,7634,1889,9523
3760,Gabriellia,Jakubczyk,gjakubczykr9@foxnews.com,Senior Developer,7017,1977,8994
3725,Obed,Tolussi,otolussira@linkedin.com,Account Representative IV,8645,1333,9978
3316,Sheela,Whitmore,swhitmorere@shop-pro.jp,Internal Auditor,4632,1649,6281
3726,Barty,Coom,bcoomrf@nytimes.com,Legal Assistant,6437,1476,7913
3109,Jessey,Abrahamsson,jabrahamssonrk@slashdot.org,Chief Design Engineer,1141,510,1651
3049,Kienan,Murtimer,kmurtimerrl@digg.com,Speech Pathologist,8183,1132,9315
3771,Cooper,Blyth,cblythrm@intel.com,Senior Quality Engineer,1605,1677,3282
3794,Rosalind,Candlin,rcandlinrr@github.io,Teacher,4825,434,5259
22546,Cloe,Clissett,cclissett0@comcast.net,Nuclear Power Engineer,8128,738,8866
22736,Lissy,Pedican,lpedican1@stumbleupon.com,Paralegal,2651,669,3320
22282,Celine,Pernell,cpernell2@bizjournals.com,Administrative Assistant III,6770,307,7077
22978,Ralf,Barthropp,rbarthropp3@columbia.edu,Graphic Designer,2020,361,2381
22807,Maximilian,Stride,mstride4@amazon.co.uk,Nuclear Power Engineer,2998,1240,4238
22098,Janessa,Blandamere,jblandamere5@cbsnews.com,Geological Engineer,2048,983,3031
22614,Frederique,Astle,fastle6@topsy.com,Social Worker,6840,1971,8811
22518,Aaron,Weakley,aweakley7@time.com,Assistant Professor,4721,1511,6232
22642,Erny,Bidmead,ebidmead8@theguardian.com,Tax Accountant,2123,591,2714
22495,Vida,MacFarlane,vmacfarlane9@marriott.com,GIS Technical Architect,6969,1115,8084
22819,Shepard,Pinshon,spinshona@hostgator.com,Professor,2349,967,3316
22200,Meggi,Callaway,mcallawayb@bloglovin.com,Nurse,4795,1280,6075
22026,Krista,Wheelhouse,kwheelhousec@dot.gov,Community Outreach Specialist,2532,1077,3609
22124,Myrta,Yankeev,myankeevd@bing.com,Staff Scientist,6240,282,6522
22584,Darcy,Kelley,dkelleye@umich.edu,Engineer I,8573,481,9054
22637,Mitchael,Gain,mgainf@economist.com,Web Developer II,5720,340,6060
22912,Nanny,Decker,ndeckerg@disqus.com,Environmental Specialist,2015,1300,3315
22230,Donnajean,Raper,draperh@tumblr.com,Nurse,2516,234,2750
22696,Ira,Farren,ifarreni@ustream.tv,Environmental Tech,2489,1389,3878
22398,Ferdinande,Arend,farendj@dailymail.co.uk,Human Resources Assistant I,2736,439,3175
22491,Bowie,Blondell,bblondellk@technorati.com,Occupational Therapist,8463,575,9038
22264,Bartholomew,Cunniff,bcunniffl@ox.ac.uk,Assistant Media Planner,9242,1987,11229
22556,Waldo,Gerhts,wgerhtsm@bandcamp.com,Web Designer II,5840,1966,7806
22277,Jobi,Servant,jservantn@fda.gov,Nurse Practicioner,7078,889,7967
22685,Fulvia,Bernardy,fbernardyo@indiegogo.com,Programmer IV,6986,1461,8447
22680,Lionello,Brangan,lbranganp@foxnews.com,Paralegal,2583,275,2858
22289,Gennie,Baudasso,gbaudassoq@gov.uk,Engineer IV,6959,1293,8252
22204,Jay,Vakhlov,jvakhlovr@blogspot.com,VP Accounting,9838,1312,11150
22720,Sylvia,Bruin,sbruins@ovh.net,Junior Executive,2243,1253,3496
22299,Boony,Gibson,bgibsont@is.gd,Professor,5200,452,5652
22569,Ritchie,Ridesdale,rridesdaleu@phpbb.com,Database Administrator IV,3515,373,3888
22342,Zoe,Lago,zlagov@google.fr,Executive Secretary,1485,839,2324
22882,Thedric,Colston,tcolstonw@cbc.ca,Project Manager,7531,579,8110
22820,Osbert,Metschke,ometschkex@meetup.com,Computer Systems Analyst IV,8644,826,9470
22525,Adrien,Kelf,akelfy@fda.gov,VP Sales,7217,884,8101
22336,Lynna,Bryns,lbrynsz@harvard.edu,Civil Engineer,9775,335,10110
22197,Elsy,Van Zon,evanzon10@reference.com,Geological Engineer,3387,1845,5232
22671,Rossy,Gosker,rgosker12@cbsnews.com,Librarian,3739,247,3986
22936,Garek,Moden,gmoden13@theatlantic.com,Statistician I,9664,1887,11551
22157,Jamesy,Leal,jleal14@weather.com,Account Coordinator,6302,1238,7540
22418,Janifer,Brundill,jbrundill16@cdc.gov,Sales Associate,8382,984,9366
22372,Ariela,Sneaker,asneaker17@cdbaby.com,VP Quality Control,4889,1228,6117
22042,Lorie,Mapplethorpe,lmapplethorpe18@yellowpages.com,Senior Financial Analyst,3661,606,4267
22349,Ramon,Pereira,rpereira19@redcross.org,Automation Specialist III,5103,1046,6149
22251,Freddie,Puzey,fpuzey1a@ucoz.com,Speech Pathologist,8513,1305,9818
22346,Gail,Arckoll,garckoll1b@elpais.com,Quality Control Specialist,8427,1115,9542
22393,Stephen,Slayton,sslayton1c@godaddy.com,Assistant Media Planner,3573,281,3854
22172,Stormy,Goodman,sgoodman1d@comsenz.com,Design Engineer,3100,1186,4286
22387,Terrijo,Jandourek,tjandourek1e@sbwire.com,Administrative Assistant III,7371,923,8294
22657,Arlena,Marzelli,amarzelli1f@reverbnation.com,Systems Administrator II,2997,1904,4901
22683,Belinda,Klimmek,bklimmek1h@stanford.edu,Paralegal,3615,1613,5228
22822,Asher,Filoniere,afiloniere1i@usa.gov,Accounting Assistant III,4015,315,4330
22513,Woodie,Lehrian,wlehrian1j@cdbaby.com,Actuary,6518,1697,8215
22079,Lev,Hitschke,lhitschke1k@google.com.hk,Senior Sales Associate,8030,1096,9126
22567,Bobbee,Andreopolos,bandreopolos1l@eventbrite.com,Account Executive,2999,1786,4785
22806,Gisele,Szymanowski,gszymanowski1m@1und1.de,Help Desk Operator,5066,628,5694
22957,Mitzi,Swallow,mswallow1n@amazon.co.uk,Marketing Manager,7201,454,7655
22472,Steward,Heaslip,sheaslip1o@mozilla.com,Help Desk Technician,7506,297,7803
22341,Bobina,Dilliston,bdilliston1q@globo.com,Legal Assistant,3653,1700,5353
22128,Tiertza,Goodanew,tgoodanew1r@adobe.com,Database Administrator II,3700,1793,5493
22673,Chilton,Giorgini,cgiorgini1s@seattletimes.com,General Manager,1120,1778,2898
22396,Corenda,Chavrin,cchavrin1t@webnode.com,Budget/Accounting Analyst IV,4677,1115,5792
22892,Jenelle,Height,jheight1u@admin.ch,Structural Analysis Engineer,8355,1751,10106
22411,Zeke,Pack,zpack1v@oracle.com,Systems Administrator I,2381,442,2823
22488,Wilhelmina,Ick,wick1w@nydailynews.com,Payment Adjustment Coordinator,1471,563,2034
22508,Faun,Loftus,floftus1x@technorati.com,Civil Engineer,2437,1807,4244
22244,Mitchell,Zanetto,mzanetto1y@last.fm,Design Engineer,4097,602,4699
22040,Tarah,Bumphrey,tbumphrey1z@cloudflare.com,Senior Cost Accountant,3474,1778,5252
22804,Pen,Base,pbase20@webeden.co.uk,Occupational Therapist,8992,716,9708
22051,Tabatha,Duffitt,tduffitt21@nydailynews.com,Payment Adjustment Coordinator,2821,1013,3834
22306,Richy,Matus,rmatus22@typepad.com,Biostatistician III,8265,1334,9599
22593,Sherye,Myrkus,smyrkus23@wikia.com,Environmental Tech,1981,1584,3565
22689,Almeda,Abelevitz,aabelevitz24@mozilla.com,Registered Nurse,7203,1939,9142
22184,Alis,Hallex,ahallex25@bluehost.com,Help Desk Technician,1041,1153,2194
22537,Tandy,Huggins,thuggins26@stumbleupon.com,Administrative Officer,3964,671,4635
22072,Honor,Fraulo,hfraulo27@smh.com.au,Health Coach I,5779,1538,7317
22434,Sukey,Dollard,sdollard28@utexas.edu,Quality Engineer,8707,1756,10463
22376,Giacomo,Durman,gdurman29@craigslist.org,Accounting Assistant IV,7100,583,7683
22835,Hinda,Fouracres,hfouracres2a@biglobe.ne.jp,Financial Analyst,5097,234,5331
22561,Joceline,McMurrugh,jmcmurrugh2b@amazon.de,Design Engineer,9439,313,9752
22165,Clotilda,Perryman,cperryman2c@newsvine.com,Business Systems Development Analyst,8880,1584,10464
22705,Gertrudis,Huson,ghuson2d@geocities.jp,Account Representative II,7916,1675,9591
22340,Arlie,Neathway,aneathway2e@java.com,VP Accounting,5411,1925,7336
22942,Demott,Cuthbertson,dcuthbertson2g@wired.com,VP Product Management,4137,206,4343
22902,Cristine,Vatini,cvatini2h@hao123.com,Structural Engineer,3996,1694,5690
22964,Neale,Killiner,nkilliner2i@sogou.com,Graphic Designer,1370,1750,3120
22145,Justina,Scurrey,jscurrey2j@youtu.be,Web Developer II,1842,1768,3610
22206,Paxton,Wyllie,pwyllie2k@ezinearticles.com,Information Systems Manager,4219,1656,5875
22826,Richy,Hambatch,rhambatch2m@myspace.com,Marketing Manager,1390,392,1782
22634,Cleavland,Renfield,crenfield2n@pen.io,GIS Technical Architect,5296,251,5547
22855,Gerard,McInerney,gmcinerney2o@skype.com,GIS Technical Architect,4859,491,5350
22645,Albrecht,Seaward,aseaward2p@smh.com.au,Food Chemist,5927,295,6222
22420,Maryanne,Jewkes,mjewkes2q@hc360.com,Editor,8090,259,8349
22670,Paddie,Whannel,pwhannel2r@nifty.com,Health Coach II,2572,803,3375
22763,Hayley,Baccas,hbaccas2s@si.edu,Information Systems Manager,9910,382,10292
22971,Aubrie,Yurin,ayurin2t@artisteer.com,Environmental Specialist,6304,666,6970
22534,Issy,Piris,ipiris2u@booking.com,Assistant Media Planner,3443,1609,5052
22056,Stacey,Neller,sneller2w@tripod.com,Nurse,3243,1821,5064
22828,Chelsea,Yeatman,cyeatman2x@shinystat.com,Engineer III,7186,1858,9044
22852,Madlen,Redd,mredd2y@istockphoto.com,Compensation Analyst,5469,1389,6858
22311,Erl,Duffell,eduffell2z@amazon.com,Financial Advisor,2325,243,2568
22558,Nikolas,Schnieder,nschnieder31@indiatimes.com,Technical Writer,8198,1792,9990
22296,Wynn,Heindl,wheindl32@businesswire.com,Computer Systems Analyst I,3483,987,4470
22666,Robyn,Gerold,rgerold33@forbes.com,Programmer II,3975,862,4837
22958,Alicea,Smedley,asmedley34@xinhuanet.com,Research Assistant I,9286,352,9638
22090,Vally,Dennitts,vdennitts35@jimdo.com,Director of Sales,5198,386,5584
22347,Danita,Rude,drude36@quantcast.com,Legal Assistant,4244,560,4804
22922,Nonna,Scrivinor,nscrivinor37@hatena.ne.jp,Health Coach II,9485,1353,10838
22202,Ned,Dole,ndole38@cloudflare.com,Analyst Programmer,9824,1774,11598
22766,Willy,Blowing,wblowing39@narod.ru,General Manager,5320,989,6309
22096,Filia,Danilishin,fdanilishin3a@canalblog.com,Structural Analysis Engineer,4962,245,5207
22880,Thaddus,Carous,tcarous3b@twitter.com,GIS Technical Architect,1846,1035,2881
22255,Stephen,Game,sgame3c@github.io,Sales Associate,5322,1779,7101
22275,Robinetta,Antoney,rantoney3d@tripod.com,Account Coordinator,3823,279,4102
22196,Yale,Borres,yborres3e@rakuten.co.jp,Teacher,3762,528,4290
22893,Charo,Duckers,cduckers3f@europa.eu,Structural Analysis Engineer,3546,1750,5296
22897,Kevina,Hannent,khannent3g@imdb.com,Systems Administrator I,2159,359,2518
22152,Jan,Gillespey,jgillespey3h@meetup.com,Chemical Engineer,6451,1034,7485
22930,Anastasia,Liversley,aliversley3i@cnet.com,Software Engineer IV,5046,821,5867
22985,Delano,Rosenboim,drosenboim3k@yahoo.com,Assistant Manager,5024,538,5562
22678,Elisabeth,Pinniger,epinniger3l@creativecommons.org,Safety Technician III,2343,729,3072
22367,Ruggiero,Philipet,rphilipet3m@vistaprint.com,Human Resources Manager,9382,855,10237
22754,Thomasa,Sadry,tsadry3n@dot.gov,VP Marketing,2967,1534,4501
22094,Giusto,Elsy,gelsy3o@yahoo.com,Account Executive,9174,676,9850
22777,Cissy,Akam,cakam3p@eventbrite.com,Health Coach III,9954,1719,11673
22694,Cesare,MacDuffie,cmacduffie3q@sciencedirect.com,GIS Technical Architect,2270,1526,3796
22618,Bryon,Rubinfajn,brubinfajn3r@hud.gov,Programmer III,4954,422,5376
22474,Rey,Bernhardt,rbernhardt3s@house.gov,Administrative Assistant II,8151,883,9034
22260,Claus,Sugden,csugden3t@w3.org,Compensation Analyst,4443,1061,5504
22552,Kristoforo,Tomkins,ktomkins3u@dedecms.com,Human Resources Manager,6024,791,6815
22785,Patton,Wolfarth,pwolfarth3v@weebly.com,Community Outreach Specialist,4095,951,5046
22509,Trula,Hardern,thardern3w@cdc.gov,VP Sales,2067,1732,3799
22283,Grete,Edgars,gedgars3x@hp.com,Assistant Media Planner,1269,1124,2393
22748,Wilek,Belfitt,wbelfitt3y@canalblog.com,Accounting Assistant I,9301,463,9764
22358,Carter,Peaddie,cpeaddie3z@uol.com.br,Editor,3043,1330,4373
22258,Sanderson,Fayter,sfayter40@purevolume.com,Marketing Assistant,9153,1060,10213
22538,Daria,Farlham,dfarlham41@biglobe.ne.jp,Office Assistant III,3011,203,3214
22385,Cirillo,Sleeford,csleeford42@dot.gov,Tax Accountant,5690,897,6587
22259,Nathanial,Raddan,nraddan43@vistaprint.com,Financial Analyst,9951,456,10407
22510,Susana,MacConneely,smacconneely44@godaddy.com,Physical Therapy Assistant,3964,727,4691
22468,Dena,Vivers,dvivers46@cafepress.com,Community Outreach Specialist,2949,1431,4380
22608,Gage,Ashwin,gashwin47@icq.com,Speech Pathologist,5126,1718,6844
22528,Brandy,Chorley,bchorley48@bravesites.com,Recruiting Manager,3159,1087,4246
22078,Maddie,Husk,mhusk49@bbb.org,VP Sales,6885,1197,8082
22416,Terza,Spurden,tspurden4a@bbb.org,Statistician II,9106,1862,10968
22757,Kerrill,Kenyon,kkenyon4b@yale.edu,Compensation Analyst,1177,1302,2479
22873,Cody,Holdren,choldren4c@github.io,Teacher,1773,1839,3612
22950,Hasty,Abbey,habbey4d@usatoday.com,Registered Nurse,2387,1601,3988
22599,Carter,Joliffe,cjoliffe4e@chicagotribune.com,Analog Circuit Design manager,6221,1168,7389
22960,Mariejeanne,Shingler,mshingler4f@baidu.com,Community Outreach Specialist,2066,1360,3426
22116,Charil,Jeffryes,cjeffryes4h@unblog.fr,VP Product Management,1328,254,1582
22371,Francisco,Hasell,fhasell4j@slashdot.org,Director of Sales,7051,1755,8806
22361,Pietrek,Woonton,pwoonton4l@amazonaws.com,Senior Editor,7604,1267,8871
22987,Austin,Chate,achate4m@fema.gov,Automation Specialist IV,8615,286,8901
22134,Hasty,Wallentin,hwallentin4n@netlog.com,Help Desk Operator,9392,1867,11259
22241,Modestia,Tunnoch,mtunnoch4o@friendfeed.com,Systems Administrator IV,1411,1776,3187
22269,Bucky,Gumley,bgumley4p@squarespace.com,Technical Writer,1412,1179,2591
22467,Keene,Baroche,kbaroche4r@nytimes.com,Senior Editor,5114,1648,6762
22905,Rowena,Kupker,rkupker4s@jigsy.com,Registered Nurse,2396,1532,3928
22655,Alanah,Warburton,awarburton4t@cbsnews.com,Engineer IV,3807,1208,5015
22505,Emlen,Toombs,etoombs4v@typepad.com,Senior Developer,9551,1648,11199
22713,Cassey,Biasioli,cbiasioli4w@freewebs.com,Paralegal,5923,1778,7701
22047,Diane,Medina,dmedina4x@chronoengine.com,Software Consultant,8635,323,8958
22318,Kelsy,Cussons,kcussons4y@toplist.cz,Nuclear Power Engineer,5296,895,6191
22631,Abraham,Mowday,amowday50@spotify.com,Budget/Accounting Analyst IV,3265,1773,5038
22497,Fredi,Hindrich,fhindrich51@domainmarket.com,Office Assistant III,8360,1391,9751
22191,Georg,Lanphere,glanphere52@chronoengine.com,Financial Analyst,8363,317,8680
22421,Chrisy,Hearns,chearns53@mlb.com,Human Resources Assistant IV,5570,1628,7198
22730,Aldo,Cantu,acantu54@bigcartel.com,Help Desk Technician,8222,958,9180
22083,Violette,Kuban,vkuban55@merriam-webster.com,Marketing Assistant,5922,962,6884
22747,Inge,Elkin,ielkin56@shareasale.com,Registered Nurse,3582,645,4227
22690,Lou,Blacklawe,lblacklawe57@pagesperso-orange.fr,Developer IV,9561,1923,11484
22551,Walden,Sailor,wsailor58@biblegateway.com,Systems Administrator II,7125,1091,8216
22119,Zachary,Keveren,zkeveren59@cnbc.com,Safety Technician IV,4604,1019,5623
22375,Marleen,Bowers,mbowers5b@dagondesign.com,Senior Quality Engineer,5296,1036,6332
22339,Chev,Mutch,cmutch5c@wired.com,Media Manager II,2362,1236,3598
22844,Lauritz,McGuinness,lmcguinness5d@bloomberg.com,Media Manager II,2699,1069,3768
22724,Andriette,Feehely,afeehely5e@prweb.com,Actuary,7953,1222,9175
22585,Lilyan,Slym,lslym5f@creativecommons.org,Financial Advisor,6599,1627,8226
22751,Mei,Ciraldo,mciraldo5g@devhub.com,Senior Editor,8799,565,9364
22682,Terry,Ferencz,tferencz5h@rediff.com,Analog Circuit Design manager,8048,824,8872
22875,Annamaria,MacMechan,amacmechan5i@discuz.net,Engineer IV,6783,715,7498
22641,Stormy,Colloby,scolloby5j@buzzfeed.com,Structural Engineer,2559,1462,4021
22487,Pauline,Warriner,pwarriner5k@seesaa.net,Chief Design Engineer,6093,1630,7723
22350,Christophe,Hustler,chustler5m@bravesites.com,Staff Scientist,7426,1368,8794
22926,Janean,Rustadge,jrustadge5n@sun.com,Programmer Analyst III,7456,972,8428
22640,Tobin,Ostick,tostick5o@google.cn,Senior Sales Associate,5703,762,6465
22644,Mendie,Meeks,mmeeks5p@zdnet.com,Developer I,5299,1650,6949
22057,Tam,Dallosso,tdallosso5r@webnode.com,Financial Advisor,8365,1950,10315
22058,Adler,Jukubczak,ajukubczak5s@rakuten.co.jp,Administrative Officer,1906,1273,3179
22695,Alistair,Pearne,apearne5u@usgs.gov,Accountant IV,9327,1142,10469
22870,Moss,Goford,mgoford5v@cam.ac.uk,Mechanical Systems Engineer,4631,1198,5829
22800,Curry,Morshead,cmorshead5w@pinterest.com,Executive Secretary,3562,348,3910
22577,Kendricks,Yusupov,kyusupov5x@earthlink.net,Systems Administrator III,7864,473,8337
22423,Harwell,Fozard,hfozard5y@ameblo.jp,Safety Technician II,5272,1523,6795
22906,Dalila,Durnford,ddurnford5z@usa.gov,Data Coordiator,4526,725,5251
22352,Susannah,Mammatt,smammatt60@biglobe.ne.jp,Data Coordiator,6510,227,6737
22830,Bradney,Cheesley,bcheesley61@toplist.cz,Senior Sales Associate,7393,1904,9297
22308,Sayers,Burdekin,sburdekin62@craigslist.org,Structural Engineer,1016,563,1579
22636,Yetta,Kubis,ykubis64@disqus.com,Technical Writer,8430,313,8743
22446,Ignace,Reese,ireese65@who.int,VP Product Management,4704,470,5174
22328,See,Layhe,slayhe66@infoseek.co.jp,GIS Technical Architect,7130,974,8104
22740,Noelyn,Ramlot,nramlot67@163.com,Paralegal,3011,1112,4123
22601,Leonanie,Dalgliesh,ldalgliesh69@comsenz.com,Marketing Manager,3030,709,3739
22871,Ely,Aronoff,earonoff6b@wp.com,Civil Engineer,8745,1373,10118
22142,Jennilee,Bampkin,jbampkin6c@auda.org.au,Food Chemist,2249,1356,3605
22808,Nicki,Gowling,ngowling6f@php.net,Actuary,7073,1699,8772
22758,Doti,Whieldon,dwhieldon6g@ask.com,Administrative Officer,9523,1517,11040
22592,Marietta,Jarmaine,mjarmaine6h@symantec.com,Software Consultant,8792,442,9234
22319,Charlton,Aluard,caluard6i@example.com,Clinical Specialist,8445,1281,9726
22699,Rickie,Lindermann,rlindermann6j@vimeo.com,Help Desk Technician,9772,486,10258
22223,Mose,Kingzeth,mkingzeth6k@shop-pro.jp,Editor,9196,1149,10345
22457,Ashli,Pennetta,apennetta6m@reverbnation.com,Quality Engineer,1860,815,2675
22448,Morganica,Rootham,mrootham6n@dyndns.org,Marketing Assistant,4965,844,5809
22566,Markos,Sevior,msevior6o@icq.com,Office Assistant III,7281,674,7955
22849,Alexia,Pierrepoint,apierrepoint6p@storify.com,Software Engineer I,4928,643,5571
22856,Dunn,Negal,dnegal6q@nyu.edu,Clinical Specialist,1897,1887,3784
22782,Sawyere,Ackerley,sackerley6r@unicef.org,Desktop Support Technician,4216,1533,5749
22691,Bibbie,Gavahan,bgavahan6s@miitbeian.gov.cn,Senior Editor,9761,618,10379
22733,Constance,Gasker,cgasker6t@geocities.jp,Engineer I,3267,1866,5133
22635,Burlie,McKeag,bmckeag6u@edublogs.org,Graphic Designer,7424,1374,8798
22915,Jerri,Sliney,jsliney6v@prnewswire.com,Junior Executive,1374,1887,3261
22627,Daryle,Fendlen,dfendlen6w@ft.com,GIS Technical Architect,5775,1209,6984
22864,Dario,Awcoate,dawcoate6y@goodreads.com,Account Executive,4446,938,5384
22745,Morlee,Jakeway,mjakeway6z@google.cn,Director of Sales,3569,346,3915
22827,Lisa,Enevold,lenevold70@dropbox.com,Payment Adjustment Coordinator,8632,1604,10236
22711,Kaylee,Batcock,kbatcock71@google.pl,Safety Technician III,2726,1296,4022
22307,Thorstein,Pardew,tpardew72@house.gov,Structural Analysis Engineer,6601,1775,8376
22647,Grace,Bruhn,gbruhn73@comsenz.com,Human Resources Assistant III,7860,1876,9736
22228,Marj,Redhead,mredhead74@phoca.cz,Software Engineer I,6174,990,7164
22069,Patrica,Adel,padel75@ftc.gov,Automation Specialist IV,4786,265,5051
22380,Francene,Kisar,fkisar76@prlog.org,Staff Accountant IV,8982,949,9931
22222,Fredrika,Redfield,fredfield77@usa.gov,Accountant III,9231,1035,10266
22171,Gladys,Skippon,gskippon78@techcrunch.com,Quality Engineer,4033,498,4531
22910,Shaina,Rennocks,srennocks79@xing.com,Computer Systems Analyst II,2266,1583,3849
22863,Phylis,Kamiyama,pkamiyama7a@comcast.net,Cost Accountant,7149,1163,8312
22990,Joline,Darwin,jdarwin7b@europa.eu,Environmental Tech,8772,634,9406
22107,Duke,Amiable,damiable7c@skype.com,Operator,9673,1175,10848
22935,Michale,Tuminelli,mtuminelli7d@livejournal.com,Chief Design Engineer,9406,1139,10545
22059,Uta,Hambleton,uhambleton7e@123-reg.co.uk,Senior Financial Analyst,6706,1203,7909
22778,Norris,Domniney,ndomniney7f@parallels.com,Registered Nurse,5337,1671,7008
22669,Kesley,Gaskell,kgaskell7h@mlb.com,Programmer IV,7190,663,7853
22297,Dale,Loving,dloving7i@parallels.com,Chief Design Engineer,2403,1488,3891
22632,Tawnya,Colvin,tcolvin7j@thetimes.co.uk,Software Engineer IV,5053,1064,6117
22084,Hastie,Cale,hcale7k@usnews.com,Web Designer IV,7714,927,8641
22246,Simonne,Burtonshaw,sburtonshaw7l@npr.org,Assistant Manager,3857,1331,5188
22734,Webster,Hickinbottom,whickinbottom7m@lulu.com,Account Coordinator,1518,990,2508
22249,Dawna,Roset,droset7n@drupal.org,VP Quality Control,1185,1147,2332
22890,Jodee,Devanny,jdevanny7p@google.co.uk,Office Assistant I,9860,980,10840
22611,Waldemar,Clemow,wclemow7q@umich.edu,Assistant Media Planner,1399,1098,2497
22790,Rubin,Nibley,rnibley7r@angelfire.com,Research Assistant I,8261,957,9218
22193,Aguistin,O'Leary,aoleary7t@themeforest.net,Product Engineer,6165,806,6971
22218,Ted,Durrad,tdurrad7u@cdc.gov,Editor,9568,1322,10890
22991,Cam,Podd,cpodd7v@redcross.org,Programmer IV,9802,680,10482
22765,Ky,Scoines,kscoines7x@latimes.com,Research Assistant IV,9872,1130,11002
22256,Meta,Larkworthy,mlarkworthy7y@clickbank.net,Accountant III,5987,867,6854
22579,Delores,Alves,dalves80@lycos.com,Electrical Engineer,4236,739,4975
22815,Garek,Drage,gdrage81@springer.com,Nuclear Power Engineer,2579,1946,4525
22834,Gideon,Squire,gsquire82@scientificamerican.com,Registered Nurse,8164,921,9085
22811,Prue,Langshaw,plangshaw83@nifty.com,Senior Editor,3349,1737,5086
22533,Velma,Itscowicz,vitscowicz84@intel.com,Speech Pathologist,9872,801,10673
22195,Burg,Bishop,bbishop85@bluehost.com,Food Chemist,6276,761,7037
22576,Idelle,Bilovus,ibilovus86@pagesperso-orange.fr,Payment Adjustment Coordinator,1770,1301,3071
22545,Annaliese,Unworth,aunworth87@wsj.com,Cost Accountant,3989,1165,5154
22602,Liz,Whetton,lwhetton89@ustream.tv,Dental Hygienist,4383,1761,6144
22662,Jo,Jiroudek,jjiroudek8c@usnews.com,Programmer I,1754,426,2180
22407,Cleo,Chessor,cchessor8d@last.fm,Professor,3115,1234,4349
22476,Dunstan,Bog,dbog8e@hexun.com,Electrical Engineer,1232,672,1904
22598,Barbette,Folca,bfolca8h@cisco.com,Account Representative IV,6700,801,7501
22276,Angie,Cawsey,acawsey8i@loc.gov,Structural Engineer,1449,553,2002
22125,Meridel,Cocklie,mcocklie8j@mit.edu,Chemical Engineer,8038,1548,9586
22520,Rouvin,Fozard,rfozard8k@hubpages.com,Professor,2689,891,3580
22185,Rebekkah,Shropshire,rshropshire8m@whitehouse.gov,Civil Engineer,1169,1790,2959
22500,Wallis,Sercombe,wsercombe8n@newsvine.com,Product Engineer,5353,913,6266
22962,Keen,O'Loinn,koloinn8o@rambler.ru,Data Coordiator,9284,1475,10759
22866,Bobbee,Killingback,bkillingback8q@apache.org,Analog Circuit Design manager,9882,1251,11133
22095,Lorrin,Cahill,lcahill8t@free.fr,GIS Technical Architect,9312,922,10234
22648,Adelind,Bebis,abebis8u@shinystat.com,VP Sales,7338,1799,9137
22809,Emilia,Islip,eislip8v@uiuc.edu,Occupational Therapist,4518,1666,6184
22560,Phil,Blumire,pblumire8w@cbc.ca,Software Engineer IV,3072,1296,4368
22362,Lavinie,Vasyukov,lvasyukov90@pagesperso-orange.fr,Automation Specialist IV,5088,1264,6352
22478,Arlina,Leveritt,aleveritt91@imgur.com,Compensation Analyst,6374,1418,7792
22240,Ailis,Bourdis,abourdis92@cmu.edu,Social Worker,1687,1358,3045
22190,Sybila,Mogra,smogra93@nyu.edu,Staff Scientist,8327,1706,10033
22414,Laetitia,Witter,lwitter95@cornell.edu,Computer Systems Analyst IV,7434,262,7696
22374,Ursa,Dodridge,udodridge96@cbc.ca,Geologist III,3125,1254,4379
22029,Eloise,Camden,ecamden98@plala.or.jp,Nurse Practicioner,1863,1867,3730
22965,Fredia,Gleeson,fgleeson9a@ted.com,Social Worker,1113,821,1934
22527,Emlen,Duggleby,eduggleby9b@narod.ru,Nuclear Power Engineer,6948,830,7778
22886,Janey,Swinglehurst,jswinglehurst9e@mashable.com,Analog Circuit Design manager,2538,524,3062
22668,Ewen,Philippsohn,ephilippsohn9f@hp.com,Recruiting Manager,8543,1007,9550
22703,Gerrilee,Flannery,gflannery9g@ibm.com,Business Systems Development Analyst,8469,1585,10054
22102,Tate,Madner,tmadner9h@ebay.co.uk,Recruiting Manager,7788,1309,9097
22723,Malinde,Ovesen,movesen9i@usa.gov,Account Executive,7245,1797,9042
22975,Wendye,Purdy,wpurdy9j@unblog.fr,Budget/Accounting Analyst I,2475,745,3220
22956,Wallie,Favel,wfavel9l@flickr.com,Tax Accountant,8138,1911,10049
22779,Chiquia,Asplin,casplin9m@ebay.com,Community Outreach Specialist,7188,1920,9108
22872,Pauline,Bigglestone,pbigglestone9n@ameblo.jp,Compensation Analyst,9865,1619,11484
22646,Josey,Gaitskell,jgaitskell9o@paginegialle.it,Marketing Assistant,3222,1107,4329
22024,Em,Veregan,everegan9q@businessinsider.com,Technical Writer,4731,1149,5880
22967,Elsworth,Burgisi,eburgisi9s@eepurl.com,Structural Analysis Engineer,4773,1797,6570
22914,Zechariah,Annand,zannand9t@themeforest.net,Administrative Officer,4865,1192,6057
22099,Ellswerth,Beardwell,ebeardwell9v@craigslist.org,Research Assistant IV,8786,1023,9809
22981,Gregorius,Perkinson,gperkinson9w@instagram.com,Librarian,6720,950,7670
22865,Redford,Carbery,rcarbery9y@independent.co.uk,Project Manager,1394,1184,2578
22769,Beverley,Gasson,bgassona0@springer.com,Human Resources Assistant IV,2939,227,3166
22539,Viviene,Draaisma,vdraaismaa1@ucoz.ru,Civil Engineer,5479,428,5907
22216,Estella,Canario,ecanarioa2@sitemeter.com,Environmental Tech,7880,1975,9855
22591,Mathew,Boram,mborama3@netlog.com,Database Administrator III,3146,303,3449
22698,Lu,Shelsher,lshelshera4@google.de,Social Worker,6818,293,7111
22972,Meryl,Firby,mfirbya5@printfriendly.com,Research Nurse,9430,348,9778
22169,Clarie,Braniff,cbraniffa6@google.ru,Quality Control Specialist,6385,1603,7988
22338,Pepi,Ayris,payrisa8@techcrunch.com,Account Representative I,5364,1805,7169
22313,Alexine,Bonnin,abonnina9@umich.edu,Geological Engineer,3944,1762,5706
22959,Purcell,Cosans,pcosansab@odnoklassniki.ru,Environmental Specialist,9196,760,9956
22461,Clerkclaude,Fridlington,cfridlingtonac@netlog.com,Quality Engineer,9918,901,10819
22388,Reid,Authers,rauthersad@ted.com,Recruiter,2970,201,3171
22925,Ralph,Corrett,rcorrettae@zimbio.com,VP Marketing,3484,1442,4926
22721,Conrad,Beatty,cbeattyag@cmu.edu,Web Designer III,6867,1448,8315
22932,Sammie,O'Noland,sonolandai@oracle.com,Design Engineer,2565,362,2927
22921,Forester,Gammade,fgammadeaj@youku.com,Budget/Accounting Analyst IV,3877,322,4199
22470,Haze,Pinch,hpinchak@whitehouse.gov,Computer Systems Analyst IV,4848,690,5538
22455,Cullan,Seligson,cseligsonal@scribd.com,Database Administrator IV,7342,1356,8698
22661,Cassandra,Giordano,cgiordanoam@feedburner.com,Automation Specialist IV,5315,1319,6634
22215,Case,Gronow,cgronowar@tuttocitta.it,Civil Engineer,2824,558,3382
22091,Malchy,Petranek,mpetranekat@merriam-webster.com,Business Systems Development Analyst,8260,464,8724
22714,Elissa,Dei,edeiax@i2i.jp,Help Desk Operator,2219,1982,4201
22410,Foss,Cluff,fcluffay@bloglines.com,Research Associate,3688,1352,5040
22559,Alford,Cripps,acrippsaz@angelfire.com,Web Designer I,3914,1823,5737
22412,Ritchie,Livick,rlivickb0@wordpress.com,Clinical Specialist,7350,1896,9246
22127,Heall,Lepard,hlepardb1@wufoo.com,GIS Technical Architect,8628,430,9058
22431,Evelyn,Staples,estaplesb2@drupal.org,Marketing Assistant,8439,1688,10127
22149,Kaspar,Scamwell,kscamwellb3@diigo.com,Associate Professor,1990,203,2193
22617,Maje,Cregeen,mcregeenb5@linkedin.com,Compensation Analyst,3630,1304,4934
22933,Babita,Pleuman,bpleumanb6@nih.gov,Administrative Assistant II,4424,1480,5904
22903,Putnam,Haisell,phaisellb7@oakley.com,Legal Assistant,5670,1826,7496
22212,Yoshiko,Blint,yblintb8@mail.ru,Software Consultant,5257,1923,7180
22143,Dewitt,Allnutt,dallnuttbc@amazon.com,Computer Systems Analyst III,1886,202,2088
22621,Lorain,Scuse,lscusebd@theglobeandmail.com,Internal Auditor,3606,965,4571
22594,Jasmin,Springtorp,jspringtorpbe@360.cn,Sales Representative,8864,272,9136
22173,Archambault,Pardon,apardonbf@etsy.com,Internal Auditor,7245,916,8161
22327,Patty,Hakey,phakeybh@ibm.com,Social Worker,8596,1142,9738
22923,Holden,Gebb,hgebbbi@globo.com,Speech Pathologist,7041,973,8014
22067,Rosabel,Mac Giany,rmacgianybj@shareasale.com,Information Systems Manager,8407,645,9052
22797,Betteanne,Clapison,bclapisonbk@eepurl.com,Assistant Media Planner,8227,1308,9535
22334,Merry,Naismith,mnaismithbl@usnews.com,Structural Engineer,7526,1075,8601
22693,Brew,Benwell,bbenwellbn@ox.ac.uk,Registered Nurse,4182,1284,5466
22590,Ashlin,Tumilson,atumilsonbo@nydailynews.com,Recruiter,5997,1766,7763
22382,George,Dulwitch,gdulwitchbs@disqus.com,Librarian,9922,538,10460
22582,Modestia,Argent,margentbt@cam.ac.uk,Professor,2715,1353,4068
22262,Franky,Mynard,fmynardbw@360.cn,Graphic Designer,7733,297,8030
22378,Claudius,Alvarado,calvaradoc1@vinaora.com,Associate Professor,7644,808,8452
22214,Julissa,McCready,jmccreadyc3@tamu.edu,Business Systems Development Analyst,1062,1801,2863
22869,Hillard,Wildbore,hwildborec4@aol.com,Office Assistant IV,9559,882,10441
22939,Earle,Albion,ealbionc6@dropbox.com,Nuclear Power Engineer,7580,1160,8740
22187,Madlin,Qusklay,mqusklayc7@wp.com,Quality Control Specialist,2272,1943,4215
22291,Donnell,Blanket,dblanketc9@ebay.co.uk,Assistant Professor,9987,216,10203
22482,Lorant,Ruf,lrufca@123-reg.co.uk,Systems Administrator I,5111,1940,7051
22514,Lisabeth,Keme,lkemecb@boston.com,Research Associate,3613,991,4604
22194,Casey,Ivasechko,civasechkocc@diigo.com,Financial Advisor,1386,1231,2617
22365,Cecilio,Simonite,csimonitece@pagesperso-orange.fr,Cost Accountant,3591,819,4410
22774,Ingaberg,Le Maitre,ilemaitrecf@hhs.gov,Senior Editor,4461,1658,6119
22743,Leontine,Filipic,lfilipiccg@wikimedia.org,Information Systems Manager,2168,1542,3710
22726,Leanna,Bomb,lbombci@admin.ch,Assistant Manager,5702,1582,7284
22253,Hillard,Troubridge,htroubridgecj@unicef.org,Product Engineer,7600,1148,8748
22135,Junina,Smewings,jsmewingsck@dion.ne.jp,Occupational Therapist,3724,1672,5396
22295,Kahlil,Harbert,kharbertcl@about.me,Director of Sales,9391,1430,10821
22725,Budd,Coneley,bconeleycm@spotify.com,Design Engineer,6668,623,7291
22188,Karen,Dutnall,kdutnallcp@ning.com,Payment Adjustment Coordinator,1954,522,2476
22983,Case,Da Costa,cdacostacq@yale.edu,GIS Technical Architect,4740,1607,6347
22879,Maddy,Lansbury,mlansburyct@blogtalkradio.com,Health Coach II,6570,1747,8317
22968,Helsa,Pardie,hpardiecv@delicious.com,Environmental Specialist,1818,1504,3322
22756,Lombard,Bailey,lbaileycw@webnode.com,Community Outreach Specialist,2106,672,2778
22027,Veronique,Davion,vdavioncy@berkeley.edu,Safety Technician IV,4711,1208,5919
22022,Hagen,Gudyer,hgudyerd1@freewebs.com,Financial Analyst,9305,1020,10325
22544,Aurel,Bushell,abushelld5@hostgator.com,Administrative Assistant III,2873,268,3141
22494,Mina,Greensitt,mgreensittd6@upenn.edu,Director of Sales,6984,1600,8584
22435,Otto,Bampford,obampfordd7@xing.com,Pharmacist,9767,897,10664
22304,Dulcinea,Down,ddownd8@pinterest.com,Speech Pathologist,4169,1288,5457
22704,Mathian,Jills,mjillsda@icq.com,Nuclear Power Engineer,2843,1564,4407
22285,Jenelle,Trousdale,jtrousdaledc@bloomberg.com,Account Coordinator,6966,1296,8262
22945,Cirilo,Georgievski,cgeorgievskide@hatena.ne.jp,Social Worker,6043,779,6822
22841,Ania,Scarce,ascarcedh@nymag.com,Accounting Assistant IV,5119,570,5689
22012,Davina,Roke,drokedi@miitbeian.gov.cn,Statistician IV,6099,358,6457
22727,Gabriela,Westney,gwestneydk@liveinternet.ru,Structural Analysis Engineer,9404,854,10258
22477,Mariette,Harwick,mharwickdn@reddit.com,Senior Developer,1367,1916,3283
22063,Zonda,McKnockiter,zmcknockiterdo@51.la,Analog Circuit Design manager,4831,1761,6592
22274,Cindie,Cave,ccavedq@ca.gov,VP Product Management,5128,1075,6203
22010,Lin,Aliberti,lalibertidr@cbslocal.com,Assistant Manager,8839,502,9341
22429,Ebonee,Dysert,edysertds@themeforest.net,Actuary,5184,834,6018
22324,Johann,Thirlwell,jthirlwelldv@amazon.de,Budget/Accounting Analyst III,9948,520,10468
22927,Bernelle,MacCostye,bmaccostyedx@hp.com,Senior Sales Associate,9787,932,10719
22517,Kora,Durrington,kdurringtondz@mayoclinic.com,Operator,7827,1817,9644
22049,Bernie,Cubbon,bcubbone0@phpbb.com,VP Marketing,2875,1010,3885
22735,Verney,Kacheller,vkachellere3@dyndns.org,Graphic Designer,4022,1966,5988
22503,Sigfried,Simes,ssimese4@wikimedia.org,Financial Analyst,9152,696,9848
22286,Lorin,Tomsa,ltomsae5@topsy.com,Budget/Accounting Analyst III,7162,1328,8490
22920,Alix,Ivankin,aivankine6@linkedin.com,VP Marketing,7780,320,8100
22281,Rosene,Oaks,roakse7@nih.gov,Quality Control Specialist,6162,907,7069
22454,Barnebas,Flemming,bflemminge8@spiegel.de,Analyst Programmer,3333,1489,4822
22146,Merrily,Headan,mheadanea@wisc.edu,Professor,3730,207,3937
22261,Candace,Iorillo,ciorilloeb@163.com,Project Manager,6539,1639,8178
22302,Merna,Dallicott,mdallicottec@cmu.edu,Environmental Specialist,4870,650,5520
23000,Jenna,MacCarlich,jmaccarliched@chronoengine.com,Dental Hygienist,4569,661,5230
22557,Randy,Coil,rcoilee@cornell.edu,Analog Circuit Design manager,6609,1959,8568
22600,Blane,Abadam,babadameg@creativecommons.org,Editor,1656,637,2293
22231,Park,Melody,pmelodyeh@facebook.com,Analog Circuit Design manager,4677,1391,6068
22252,Murvyn,Dorber,mdorberei@businessinsider.com,Programmer II,5327,1706,7033
22516,Millie,Gligori,mgligoriek@t-online.de,Senior Developer,1315,1750,3065
22651,Violetta,Rennard,vrennarden@weibo.com,Analog Circuit Design manager,8871,1398,10269
22335,Hallsy,Feaviour,hfeavioureo@oakley.com,Help Desk Operator,1519,1683,3202
22609,Brant,Bischof,bbischofep@google.co.uk,Payment Adjustment Coordinator,6885,860,7745
22266,Glori,Lumb,glumbeq@free.fr,Systems Administrator I,1057,356,1413
22460,Natividad,Allwell,nallweller@mayoclinic.com,Dental Hygienist,3469,1925,5394
22464,Donny,Picopp,dpicoppes@usatoday.com,Budget/Accounting Analyst I,4847,1267,6114
22706,Ortensia,Smitton,osmittonet@europa.eu,Senior Financial Analyst,7366,712,8078
22015,Marrissa,Leefe,mleefeeu@zimbio.com,Financial Analyst,1129,218,1347
22005,Deonne,Pattrick,dpattrickew@exblog.jp,Computer Systems Analyst IV,7000,489,7489
22131,Fiann,Rennock,frennockey@google.co.uk,Chief Design Engineer,1242,814,2056
22033,Ive,Grimston,igrimstonez@lulu.com,Business Systems Development Analyst,9093,522,9615
22788,Hannah,Bazely,hbazelyf1@stumbleupon.com,Geological Engineer,8486,1264,9750
22512,Gwenneth,Travis,gtravisf3@arstechnica.com,Accountant III,6336,1053,7389
22802,Randy,Odeson,rodesonf4@tmall.com,Human Resources Assistant III,1250,1220,2470
22129,Lorenza,Witherspoon,lwitherspoonf9@weebly.com,Automation Specialist I,1825,1509,3334
22894,Catharine,Heis,cheisfa@tinyurl.com,Software Consultant,4055,1701,5756
22273,Caren,Sumpter,csumpterfb@whitehouse.gov,Marketing Assistant,1696,434,2130
22554,Gerhard,Pendock,gpendockfd@cam.ac.uk,Senior Financial Analyst,1394,1447,2841
22363,Karalee,Grimes,kgrimesfe@europa.eu,Electrical Engineer,9642,529,10171
22667,Carlene,Baversor,cbaversorfg@amazon.com,Occupational Therapist,9274,602,9876
22356,Domingo,Hurdidge,dhurdidgefi@yellowbook.com,Registered Nurse,9035,1877,10912
22993,Rahal,De Beauchamp,rdebeauchampfj@nih.gov,Community Outreach Specialist,8073,1814,9887
22719,Trula,Simnett,tsimnettfl@narod.ru,Social Worker,3433,440,3873
22643,Shadow,Cumberbatch,scumberbatchfq@google.fr,Data Coordiator,5527,807,6334
22575,Mirilla,Double,mdoublefr@msu.edu,VP Quality Control,1886,573,2459
22153,Hermia,Schuricht,hschurichtfs@eepurl.com,Speech Pathologist,3319,374,3693
22475,Adey,O'Deegan,aodeeganft@dmoz.org,Editor,2224,1978,4202
22041,Parry,Vallentin,pvallentinfz@phpbb.com,Data Coordiator,8052,1049,9101
22974,Averil,Liddell,aliddellg0@plala.or.jp,Occupational Therapist,8554,1378,9932
22203,Belvia,Woolager,bwoolagerg2@yahoo.co.jp,Tax Accountant,2901,1739,4640
22907,Cristobal,Alvey,calveyg3@cloudflare.com,Structural Engineer,6136,1149,7285
22677,Grethel,Hartly,ghartlyg4@yelp.com,Senior Sales Associate,4697,1092,5789
22654,Purcell,Vennart,pvennartg6@omniture.com,Speech Pathologist,7932,1227,9159
22105,Sharline,Heck,sheckg7@noaa.gov,Mechanical Systems Engineer,2611,1636,4247
22772,Genna,Darragh,gdarraghg8@typepad.com,Desktop Support Technician,6770,1849,8619
22586,Craig,Fanning,cfanningga@studiopress.com,Nuclear Power Engineer,1823,949,2772
22061,Danice,Mabbott,dmabbottgb@dmoz.org,Computer Systems Analyst III,6353,212,6565
22900,Sophia,Hugonin,shugoningh@creativecommons.org,Speech Pathologist,2299,648,2947
22888,Genovera,Crielly,gcriellygi@homestead.com,Structural Analysis Engineer,8704,1946,10650
22138,Felix,Greg,fgreggj@friendfeed.com,Product Engineer,1442,1361,2803
22208,Corbie,Asbrey,casbreygk@vistaprint.com,Human Resources Assistant IV,9911,595,10506
22237,Sydney,Venable,svenablegl@tinypic.com,Recruiter,1724,605,2329
22109,Melosa,Pasley,mpasleygm@bigcartel.com,Systems Administrator III,6587,1867,8454
22007,Lura,Demangeon,ldemangeongn@nih.gov,Software Test Engineer III,9594,687,10281
22219,Feliks,Godspede,fgodspedego@etsy.com,Paralegal,5794,582,6376
22502,Jammal,Holbarrow,jholbarrowgp@parallels.com,Administrative Officer,9998,1483,11481
22401,Cherida,Hollidge,chollidgegq@ucsd.edu,Accounting Assistant I,3945,393,4338
22954,Sherwin,Horsefield,shorsefieldgu@ca.gov,Tax Accountant,7346,1420,8766
22377,Penrod,Brickwood,pbrickwoodgv@uiuc.edu,Executive Secretary,2189,742,2931
22310,Archibold,Brownlow,abrownlowgz@earthlink.net,Financial Advisor,3278,1204,4482
22162,Anna,Element,aelementh2@nhs.uk,Graphic Designer,5803,1836,7639
22236,Selestina,Avieson,saviesonh3@oakley.com,Biostatistician III,9361,895,10256
22911,Abbot,Franchi,afranchih4@ed.gov,Structural Analysis Engineer,2910,1036,3946
22837,Waring,Skedgell,wskedgellh7@marketwatch.com,Automation Specialist II,5963,336,6299
22178,Bonnie,Mew,bmewh8@deliciousdays.com,Speech Pathologist,5293,1637,6930
22908,Aymer,Howarth,ahowarthhc@oracle.com,Web Developer II,9512,1750,11262
22427,Elka,Horlick,ehorlickhd@cocolog-nifty.com,Electrical Engineer,6528,1472,8000
22664,Red,Wildbore,rwildborehe@nyu.edu,Software Test Engineer II,4842,1443,6285
22961,Jerrilyn,Millott,jmillotthg@list-manage.com,Help Desk Operator,9168,690,9858
22946,Ly,Hellens,lhellenshh@altervista.org,Food Chemist,2526,429,2955
22966,Jorge,Lockless,jlocklesshi@ask.com,VP Product Management,7330,1361,8691
22624,Hanna,Nunn,hnunnhk@ocn.ne.jp,Staff Accountant III,4954,319,5273
22011,Waverly,Lobe,wlobehl@furl.net,Structural Engineer,1347,890,2237
22629,Dian,Roll,drollhm@gizmodo.com,Web Developer III,7245,1259,8504
22471,Samantha,Dymocke,sdymockehn@sakura.ne.jp,Senior Quality Engineer,9129,663,9792
22578,Scottie,Itzik,sitzikhp@aol.com,VP Quality Control,1521,1142,2663
22840,Udell,Cawsy,ucawsyhq@wikimedia.org,Staff Accountant II,1638,278,1916
22110,Riki,Sivill,rsivillhr@multiply.com,Graphic Designer,7783,1075,8858
22013,Gussi,Gherardini,ggherardinihs@yellowpages.com,Chief Design Engineer,7457,740,8197
22280,Alick,Havill,ahavillhw@prweb.com,Developer IV,7317,371,7688
22038,Lonnard,Winram,lwinramhx@noaa.gov,Sales Associate,9408,1829,11237
22158,Rodi,Pinar,rpinarhz@ucoz.com,Senior Developer,3451,1746,5197
22710,Rhea,Rummin,rrummini0@army.mil,Clinical Specialist,4656,1092,5748
22039,Thorvald,Tydeman,ttydemani1@twitpic.com,Analyst Programmer,7950,1611,9561
22150,Winfield,Arnald,warnaldi4@irs.gov,VP Product Management,4133,561,4694
22722,Peria,Dalling,pdallingi9@hatena.ne.jp,Food Chemist,2378,223,2601
22064,Hilton,Stolting,hstoltingia@infoseek.co.jp,Assistant Manager,1591,951,2542
22731,Eldredge,Carek,ecarekib@bizjournals.com,Web Designer III,3194,1023,4217
22916,Moses,Heeran,mheeranid@angelfire.com,Programmer III,7278,978,8256
22883,Prent,Jamme,pjammeif@reference.com,Staff Accountant I,2056,1264,3320
22030,Gianna,Aguirrezabal,gaguirrezabalih@va.gov,Financial Analyst,2715,334,3049
22659,Barbabra,Pembridge,bpembridgeii@list-manage.com,Civil Engineer,7105,1688,8793
22805,Forrest,Schowenburg,fschowenburgin@i2i.jp,Pharmacist,9677,1015,10692
22949,Kinna,Gussin,kgussinio@imgur.com,Research Associate,8397,1913,10310
22186,Kerk,Meyrick,kmeyrickis@cbsnews.com,Senior Editor,3831,1452,5283
22607,Wenonah,Ramsdale,wramsdaleiu@ebay.co.uk,Web Designer I,1366,447,1813
22603,Kelwin,Turbill,kturbilliv@github.com,Recruiting Manager,9518,205,9723
22799,Cooper,St. Louis,cstlouisix@examiner.com,Research Assistant III,9586,1343,10929
22037,Vincenz,Gamil,vgamiliy@last.fm,Senior Financial Analyst,1107,306,1413
22444,Cherin,Rowbottam,crowbottamj0@example.com,Health Coach III,1765,248,2013
22402,Claudian,Besse,cbessej2@imdb.com,Environmental Tech,2249,1394,3643
22438,Darsie,Fewkes,dfewkesj3@utexas.edu,Web Designer III,3709,746,4455
22845,Michal,Ritter,mritterj6@canalblog.com,Human Resources Manager,5055,350,5405
22320,Stacy,Di Claudio,sdiclaudioj8@51.la,Nurse,1041,734,1775
22176,Alissa,Chamberlain,achamberlainj9@mashable.com,Professor,7079,776,7855
22708,Leroy,Steckings,lsteckingsja@amazon.com,Product Engineer,5825,591,6416
22813,Florenza,Skamal,fskamaljb@barnesandnoble.com,Sales Associate,6190,812,7002
22120,Andrus,Dreher,adreherje@ft.com,Design Engineer,6544,1645,8189
22481,Sloane,Billam,sbillamjg@mediafire.com,Administrative Officer,2264,387,2651
22851,Arron,Souza,asouzajk@wisc.edu,Data Coordiator,4569,251,4820
22955,Leta,Gawne,lgawnejl@seattletimes.com,Database Administrator IV,9204,1966,11170
22977,Myrtie,MacSkeaghan,mmacskeaghanjm@arizona.edu,Software Consultant,3026,540,3566
22239,Gianna,Canton,gcantonjp@mapquest.com,Mechanical Systems Engineer,8783,707,9490
22053,Ronny,Livens,rlivensjr@rediff.com,Senior Developer,6956,1464,8420
22447,Sylas,Underhill,sunderhillju@businessweek.com,Senior Editor,3195,1364,4559
22198,Matthias,Ruffler,mrufflerjv@diigo.com,Software Engineer I,3996,972,4968
22848,Mandi,Rodger,mrodgerjw@cmu.edu,Media Manager III,7379,836,8215
22199,Francklin,Avraam,favraamk1@amazon.com,Developer I,5617,1388,7005
22984,Vasilis,Creeboe,vcreeboek5@skype.com,Product Engineer,7931,1291,9222
22025,Prinz,Fleisch,pfleischk6@drupal.org,Accounting Assistant III,1750,598,2348
22430,Ashely,Nowakowski,anowakowskik7@parallels.com,VP Marketing,5350,252,5602
22941,Bennett,Nucci,bnuccik8@deliciousdays.com,Senior Editor,6673,1463,8136
22419,Orel,Manueli,omanuelik9@example.com,Account Coordinator,6693,1351,8044
22192,Erma,Brugmann,ebrugmannkc@china.com.cn,Biostatistician II,9126,1467,10593
22217,Noach,Finnes,nfinneske@tuttocitta.it,Data Coordiator,3002,1358,4360
22413,Minta,Engelbrecht,mengelbrechtkf@ucoz.com,Automation Specialist III,8516,1141,9657
22742,Morgana,Slaughter,mslaughterkg@exblog.jp,Desktop Support Technician,1403,1971,3374
22573,Denis,Ragot,dragotkj@e-recht24.de,Information Systems Manager,5856,226,6082
22622,Norry,Wardesworth,nwardesworthkk@oracle.com,Senior Quality Engineer,3774,1291,5065
22298,Hyacinth,Vedikhov,hvedikhovkl@theglobeandmail.com,Chemical Engineer,9715,1039,10754
22325,Maddi,Daenen,mdaenenks@netvibes.com,Environmental Specialist,7760,1808,9568
22247,Willy,Lochet,wlochetkv@scientificamerican.com,Product Engineer,1787,921,2708
22686,Farris,Pidwell,fpidwellkw@wp.com,Office Assistant II,6984,912,7896
22786,Fiann,Scrauniage,fscrauniagekz@biglobe.ne.jp,Business Systems Development Analyst,2324,1573,3897
22623,Parrnell,Tomczak,ptomczakl0@boston.com,Web Designer III,8584,1032,9616
22986,Tootsie,Ritchley,tritchleyl1@chron.com,Developer I,2861,1886,4747
22653,Clevey,Spelling,cspellingl2@thetimes.co.uk,Teacher,1803,377,2180
22771,Alain,Elph,aelphl3@ft.com,Nurse,6074,1749,7823
22399,Valentino,Gilders,vgildersl5@ocn.ne.jp,Structural Engineer,8170,216,8386
22122,Mikol,Driver,mdriverl6@theatlantic.com,Executive Secretary,9097,1552,10649
22168,Karlik,Godbehere,kgodbeherel7@nymag.com,Compensation Analyst,7916,1914,9830
22511,Carly,McHan,cmchanl8@ed.gov,Assistant Media Planner,6722,1364,8086
22115,Ross,Hebborne,rhebbornel9@biglobe.ne.jp,Web Designer IV,2194,1067,3261
22066,Ole,Harnott,oharnottla@ft.com,Web Developer III,9568,428,9996
22612,Saudra,Mor,smorlb@noaa.gov,Recruiting Manager,1288,1006,2294
22762,Vonny,Cornes,vcorneslc@ft.com,Librarian,2808,217,3025
22887,Alexandros,Bentzen,abentzenle@woothemes.com,Chief Design Engineer,3082,1400,4482
22436,Jillene,Beadham,jbeadhamlf@fda.gov,VP Quality Control,3030,847,3877
22293,Christalle,Marquese,cmarqueselj@youku.com,Tax Accountant,2074,273,2347
22073,Decca,Grinston,dgrinstonll@hatena.ne.jp,Geological Engineer,6978,747,7725
22400,Winnah,Elwood,welwoodln@vinaora.com,Account Representative III,3252,579,3831
22164,Garreth,Lefeuvre,glefeuvrelo@123-reg.co.uk,Recruiting Manager,4572,1370,5942
22305,Judith,Enrique,jenriquelq@bigcartel.com,Tax Accountant,9983,388,10371
22229,Bonita,Goadbie,bgoadbielr@goo.ne.jp,Accounting Assistant III,6298,298,6596
22301,Skyler,Ouchterlony,souchterlonyls@psu.edu,Mechanical Systems Engineer,8786,1070,9856
22250,Free,Beningfield,fbeningfieldlu@who.int,Librarian,6726,696,7422
22001,L;urette,Guitonneau,lguitonneauly@geocities.com,Analog Circuit Design manager,7161,1603,8764
22148,Annadiana,Blagbrough,ablagbroughlz@prlog.org,Administrative Officer,4149,252,4401
22709,Maggi,Morby,mmorbym2@aol.com,Social Worker,5453,601,6054
22137,Beitris,Plowes,bplowesm3@surveymonkey.com,Geologist IV,5751,1160,6911
22114,Kelly,Fuzzard,kfuzzardm6@ovh.net,Social Worker,4726,1627,6353
22574,Marleah,Menguy,mmenguyma@paginegialle.it,Account Coordinator,3156,1706,4862
22113,Melinde,Driscoll,mdriscollmd@illinois.edu,Staff Scientist,8366,755,9121
22211,Nat,Allenby,nallenbymf@google.nl,Cost Accountant,1025,1669,2694
22597,Greta,Eborall,geborallmk@cargocollective.com,Social Worker,7196,984,8180
22213,Izak,Greenhalf,igreenhalfmn@bluehost.com,Environmental Specialist,7671,1676,9347
22752,Leonora,Philo,lphilomt@yale.edu,VP Quality Control,7826,1490,9316
22154,Cate,Jowers,cjowersmv@blogspot.com,Automation Specialist IV,5502,1391,6893
22938,Dulcine,Koche,dkochemw@xinhuanet.com,Senior Sales Associate,3978,1634,5612
22170,Butch,Beltzner,bbeltznermx@jalbum.net,Human Resources Assistant II,4692,706,5398
22884,Philomena,Greenhalf,pgreenhalfn0@miitbeian.gov.cn,Professor,2052,1995,4047
22652,Bogart,Cisec,bcisecn2@google.com.br,Systems Administrator II,2483,1159,3642
22004,Kean,Noah,knoahn4@123-reg.co.uk,Executive Secretary,8965,679,9644
22994,Bev,Winspurr,bwinspurrn5@tinyurl.com,Developer II,7927,1950,9877
22749,Bonita,Bandy,bbandyn6@epa.gov,VP Product Management,6359,586,6945
22303,Brion,Spurrior,bspurriorn7@kickstarter.com,Senior Financial Analyst,7017,1840,8857
22989,Estele,Gascoyen,egascoyenn8@umich.edu,Recruiting Manager,2299,564,2863
22929,Hermie,MacSharry,hmacsharrync@ucla.edu,Executive Secretary,1785,1482,3267
22395,Loy,Rushbury,lrushburynl@mac.com,Human Resources Assistant II,1395,292,1687
22245,Mar,Kunkel,mkunkelnm@sina.com.cn,Paralegal,4914,984,5898
22565,Fletcher,Farquharson,ffarquharsonno@yale.edu,Quality Control Specialist,1542,283,1825
22535,Travis,Zukerman,tzukermannq@reverbnation.com,Professor,9033,1243,10276
22620,Latrina,Shadbolt,lshadboltnr@furl.net,Recruiter,9959,694,10653
22333,Tamma,Foxton,tfoxtonns@4shared.com,Structural Engineer,4388,582,4970
22588,Bernadine,Hurndall,bhurndallnu@wordpress.com,Technical Writer,6146,1109,7255
22023,Kinsley,Aldie,kaldienw@naver.com,Analog Circuit Design manager,4388,1456,5844
22587,Domeniga,Arboin,darboinnx@wisc.edu,Graphic Designer,1713,1456,3169
22463,Lee,Mechell,lmechellny@example.com,Geologist I,5294,1914,7208
22456,Jillayne,Huster,jhustero4@nytimes.com,Tax Accountant,9508,1410,10918
22540,Derk,Yglesias,dyglesiaso9@upenn.edu,Assistant Professor,4579,1888,6467
22862,Donnajean,McKernan,dmckernanod@flavors.me,VP Sales,3362,365,3727
22824,Kermy,Rother,krotherog@weibo.com,Nurse Practicioner,7170,1806,8976
22878,Johnny,Lavrick,jlavrickoh@nasa.gov,Clinical Specialist,9399,647,10046
22715,Beaufort,Fanstone,bfanstoneoi@bbb.org,Electrical Engineer,7901,1118,9019
22934,Blakelee,MacAllester,bmacallesteroj@nymag.com,Senior Cost Accountant,4827,780,5607
22449,Nessy,Exall,nexallol@nsw.gov.au,Editor,9491,294,9785
22428,Jaimie,Meaney,jmeaneyon@home.pl,Human Resources Assistant II,2774,1074,3848
22791,Almire,Hammonds,ahammondsoo@opensource.org,Senior Financial Analyst,3288,473,3761
22982,Penelope,Pluthero,pplutherooq@blogspot.com,Dental Hygienist,4011,1763,5774
22639,Dunn,Hull,dhullor@businesswire.com,Help Desk Operator,1458,1724,3182
22147,Kellie,Plimmer,kplimmeros@dmoz.org,Administrative Assistant II,7711,1842,9553
22817,Cristian,Jewar,cjewarou@tripadvisor.com,Actuary,3984,880,4864
22504,Yves,Podmore,ypodmoreov@hugedomains.com,Biostatistician IV,5462,216,5678
22383,Tammie,Hickford,thickfordow@china.com.cn,Help Desk Technician,4443,717,5160
22604,Norah,Adolthine,nadolthineoz@altervista.org,Environmental Tech,3401,853,4254
22469,Elsy,Martland,emartlandp2@howstuffworks.com,Automation Specialist II,2926,207,3133
22130,Kippie,Hovington,khovingtonp4@sciencedaily.com,Budget/Accounting Analyst II,6758,1761,8519
22440,Gusella,Haddick,ghaddickp6@wix.com,Staff Accountant III,5565,1443,7008
22523,Rita,Hurley,rhurleyp7@php.net,Developer IV,9350,1517,10867
22889,Odelia,Tanby,otanbyp8@samsung.com,Occupational Therapist,3930,1203,5133
22531,Koenraad,Hattersley,khattersleyp9@telegraph.co.uk,Social Worker,5487,753,6240
22006,Berton,Gergolet,bgergoletpa@mapy.cz,Desktop Support Technician,4795,945,5740
22315,Cyrille,Wetherby,cwetherbypb@netlog.com,VP Accounting,7613,1946,9559
22373,Xenia,Evison,xevisonpc@hexun.com,Social Worker,3427,934,4361
22524,Stephanus,Ohrtmann,sohrtmannpd@bbb.org,Clinical Specialist,9365,876,10241
22465,Creigh,Petschel,cpetschelpe@alexa.com,VP Marketing,4213,1477,5690
22522,Pascale,Mewe,pmewepf@storify.com,Research Nurse,7211,1237,8448
22741,Reider,Fussey,rfusseypg@ucoz.ru,Social Worker,8631,1389,10020
22331,Rosalynd,Chang,rchangph@bing.com,Internal Auditor,2709,1802,4511
22397,Nichole,Plaxton,nplaxtonpi@wordpress.org,Senior Editor,5600,447,6047
22175,Simeon,Jorczyk,sjorczykpn@washington.edu,Structural Engineer,6655,801,7456
22697,Gery,Skechley,gskechleypp@berkeley.edu,Design Engineer,4735,1080,5815
22904,Andy,Cheke,achekeps@archive.org,Information Systems Manager,9296,312,9608
22589,Nap,Aslet,nasletpu@npr.org,Mechanical Systems Engineer,5986,1056,7042
22775,Dion,Flaxman,dflaxmanpy@hc360.com,Chemical Engineer,2310,1333,3643
22019,Tova,Bolderson,tboldersonq2@webeden.co.uk,Geologist IV,7775,205,7980
22838,Deborah,Richfield,drichfieldq3@deliciousdays.com,Programmer Analyst IV,8466,823,9289
22207,Lilith,Boc,lbocq9@nationalgeographic.com,Statistician III,6898,998,7896
22263,Augustine,Paszak,apaszakqb@jiathis.com,Account Representative I,1577,1165,2742
22046,Heindrick,Sulland,hsullandqe@oracle.com,Assistant Media Planner,3676,565,4241
22750,Roldan,More,rmoreqf@unblog.fr,Social Worker,4145,1697,5842
22885,Salomone,Pindred,spindredqh@vk.com,Account Representative I,3191,1689,4880
22272,Axel,Huard,ahuardqi@epa.gov,Structural Analysis Engineer,5148,1816,6964
22928,Tam,Terron,tterronqk@nsw.gov.au,Graphic Designer,2854,757,3611
22151,Alyda,Hollingshead,ahollingsheadqp@biglobe.ne.jp,Product Engineer,2429,271,2700
22649,Ewart,Worsnup,eworsnupqr@cam.ac.uk,Chemical Engineer,4537,1053,5590
22506,Alvis,Danbye,adanbyeqt@nba.com,Senior Cost Accountant,3111,1447,4558
22549,Clem,Walden,cwaldenqu@163.com,Chief Design Engineer,5262,1828,7090
22426,Tamera,Danher,tdanherqv@ocn.ne.jp,Senior Cost Accountant,3585,275,3860
22874,Phaidra,Neubigging,pneubiggingqx@prnewswire.com,Nurse,6599,1414,8013
22360,Tyrone,Markie,tmarkier0@soup.io,Dental Hygienist,5753,1845,7598
22370,Livvie,Peckitt,lpeckittr1@smugmug.com,Web Designer II,6189,534,6723
22530,Phylis,Rucklidge,prucklidger5@hud.gov,GIS Technical Architect,4306,932,5238
22473,Mace,Dobsons,mdobsonsr9@paginegialle.it,Data Coordiator,5549,786,6335
22998,Lanni,Robelow,lrobelowra@reference.com,Analyst Programmer,2444,1832,4276
22466,Davey,Ludmann,dludmannre@microsoft.com,Tax Accountant,2967,1692,4659
22970,Consalve,Benge,cbengerl@europa.eu,Community Outreach Specialist,9256,922,10178
23283,Valerye,Antusch,vantusch0@china.com.cn,Product Engineer,9845,571,10416
23239,Betsey,MacAndreis,bmacandreis1@ifeng.com,Dental Hygienist,5015,307,5322
23808,Deni,Baly,dbaly2@github.io,VP Sales,8663,1413,10076
23447,Arlana,Iacobacci,aiacobacci3@myspace.com,Librarian,1697,256,1953
23661,Nefen,Radnedge,nradnedge4@dell.com,Registered Nurse,2559,644,3203
23701,Dannel,Ciubutaro,dciubutaro5@statcounter.com,Nurse Practicioner,3139,1364,4503
23084,Ches,Pawlaczyk,cpawlaczyk6@samsung.com,Legal Assistant,6732,323,7055
23657,Lucais,Illwell,lillwell7@wunderground.com,Structural Analysis Engineer,8525,1201,9726
23511,Eal,Hempel,ehempel8@odnoklassniki.ru,Occupational Therapist,4755,1302,6057
23205,Cayla,Dunning,cdunning9@fc2.com,Actuary,7888,1005,8893
23089,Audrye,Goskar,agoskara@nationalgeographic.com,VP Accounting,2293,787,3080
23696,Thorvald,Beenham,tbeenhamb@cocolog-nifty.com,Administrative Assistant I,6856,390,7246
23651,Broddy,Koch,bkochc@netvibes.com,Junior Executive,4348,1514,5862
23232,Gerhard,Storek,gstorekd@xing.com,GIS Technical Architect,5495,1893,7388
23431,Terri,Ozintsev,tozintseve@ehow.com,Senior Sales Associate,2402,1775,4177
23505,Giulietta,Stronge,gstrongef@soup.io,Engineer I,4763,817,5580
23640,Sena,Tingle,stingleg@shutterfly.com,Product Engineer,2035,304,2339
23996,Matty,Paulin,mpaulinh@about.me,Accounting Assistant III,6524,347,6871
23003,Shane,Tibbotts,stibbottsi@tinyurl.com,Dental Hygienist,9028,1457,10485
23170,Daisy,Grevatt,dgrevattj@pbs.org,Junior Executive,9601,521,10122
23150,Merlina,Eliasson,meliassonk@unblog.fr,Payment Adjustment Coordinator,8965,675,9640
23453,Marta,Stuttard,mstuttardl@merriam-webster.com,Marketing Manager,8996,244,9240
23480,Bay,Wainman,bwainmanm@intel.com,Sales Associate,4514,1133,5647
23223,Hugibert,Fadian,hfadiann@ameblo.jp,VP Marketing,3445,1612,5057
23635,Helen-elizabeth,Band,hbando@shutterfly.com,Engineer II,1274,394,1668
23944,Kailey,Yakuntzov,kyakuntzovp@simplemachines.org,Graphic Designer,1405,1480,2885
23055,Marje,Gallop,mgallopq@etsy.com,Sales Representative,7806,262,8068
23259,Rosalynd,Westerman,rwestermans@macromedia.com,Marketing Assistant,9251,1833,11084
23208,Ezmeralda,Bemlott,ebemlottt@usa.gov,Teacher,4708,1752,6460
23782,Amaleta,Yerson,ayersonu@home.pl,Paralegal,1404,476,1880
23697,Eddy,Ivashkin,eivashkinv@microsoft.com,Teacher,6980,437,7417
23764,Kayle,Swinney,kswinneyw@redcross.org,GIS Technical Architect,3981,1245,5226
23175,Alyda,O'Deoran,aodeoranx@dailymail.co.uk,Technical Writer,6618,1296,7914
23686,Lilia,McLoney,lmcloneyy@weebly.com,GIS Technical Architect,4993,1568,6561
23327,Glen,Gossage,ggossagez@360.cn,Marketing Manager,8725,1601,10326
23286,Ted,Spanswick,tspanswick10@csmonitor.com,Staff Accountant III,2095,545,2640
23931,Polly,Gobourn,pgobourn11@cafepress.com,Computer Systems Analyst III,4969,372,5341
23244,Shawna,Dehn,sdehn12@howstuffworks.com,Design Engineer,7679,1809,9488
23420,Conni,Odcroft,codcroft13@virginia.edu,Staff Scientist,3682,617,4299
23099,Joscelin,Kadwallider,jkadwallider14@msu.edu,Accounting Assistant I,8787,1190,9977
23413,Shirline,Leavold,sleavold15@skyrock.com,Senior Cost Accountant,4506,464,4970
23167,Galen,Yate,gyate16@pen.io,Safety Technician III,6892,1698,8590
23787,Olympie,Mathieu,omathieu17@theglobeandmail.com,Information Systems Manager,7749,1015,8764
23199,Prudence,Harteley,pharteley18@wsj.com,Assistant Media Planner,1583,1829,3412
23002,Binky,Barker,bbarker19@ftc.gov,Research Associate,9577,1932,11509
23575,Tallou,Wauchope,twauchope1a@a8.net,Clinical Specialist,9468,1025,10493
23822,Rudd,Taig,rtaig1b@marketwatch.com,Software Consultant,1638,1636,3274
23235,Ginni,Benneton,gbenneton1c@deviantart.com,Product Engineer,8719,651,9370
23398,Virginia,Cowell,vcowell1d@trellian.com,Physical Therapy Assistant,4861,714,5575
23198,Malvina,Jirusek,mjirusek1e@wordpress.com,Assistant Professor,8212,1309,9521
23295,Herby,Toke,htoke1f@usda.gov,Statistician IV,4947,765,5712
23321,Heath,Alders,halders1g@vk.com,Research Assistant I,1843,1447,3290
23582,Annissa,Jeeves,ajeeves1h@virginia.edu,Senior Financial Analyst,3199,1624,4823
23300,Joey,Yegoshin,jyegoshin1i@nymag.com,Nurse,9475,1597,11072
23820,Maren,Grocock,mgrocock1j@washington.edu,Sales Representative,5010,1071,6081
23287,Blancha,Billin,bbillin1k@state.gov,Systems Administrator IV,2411,1468,3879
23527,Falkner,Pawden,fpawden1l@buzzfeed.com,Desktop Support Technician,1373,794,2167
23446,Addi,Arboin,aarboin1m@webmd.com,Social Worker,3131,1749,4880
23876,Ibbie,Doody,idoody1n@issuu.com,Accountant III,2626,698,3324
23200,Katlin,Signore,ksignore1o@usgs.gov,Physical Therapy Assistant,4303,1405,5708
23073,Royce,Klehn,rklehn1p@icq.com,Web Developer I,5991,1076,7067
23269,Bamby,Brunnen,bbrunnen1q@sitemeter.com,Engineer III,2348,647,2995
23600,Farris,Klimsch,fklimsch1r@mysql.com,Internal Auditor,9549,1020,10569
23735,Elijah,Sedgwick,esedgwick1s@google.ru,Administrative Officer,6937,516,7453
23092,Lenette,Duinkerk,lduinkerk1t@wordpress.org,Professor,8954,245,9199
23630,Romola,Ibbison,ribbison1u@comsenz.com,Web Developer I,4448,1210,5658
23774,Cello,Piddletown,cpiddletown1v@over-blog.com,Speech Pathologist,9601,1022,10623
23877,Nikolaus,Redmond,nredmond1w@purevolume.com,Accounting Assistant I,1142,854,1996
23596,Tamqrah,Lucia,tlucia1x@addthis.com,Chief Design Engineer,7579,451,8030
23557,Ambrose,Schneidar,aschneidar1y@google.com.hk,Account Coordinator,1611,735,2346
23034,Rivkah,Fellgatt,rfellgatt1z@loc.gov,Human Resources Assistant I,9518,1178,10696
23506,Dal,Wallworke,dwallworke20@tinypic.com,Electrical Engineer,5745,1955,7700
23373,Seana,Parke,sparke21@yellowbook.com,Financial Advisor,8750,1197,9947
23201,Jocelin,Tuminelli,jtuminelli22@google.pl,Mechanical Systems Engineer,1727,1946,3673
23363,Reed,Scaice,rscaice23@foxnews.com,Pharmacist,6276,1246,7522
23964,Ripley,Holyard,rholyard25@zimbio.com,Teacher,7033,780,7813
23168,Lynde,Miguet,lmiguet26@arstechnica.com,Sales Associate,2915,356,3271
23434,Dewey,Frazier,dfrazier27@odnoklassniki.ru,Senior Sales Associate,2180,1296,3476
23375,Araldo,Menichillo,amenichillo28@cdc.gov,Payment Adjustment Coordinator,3110,1470,4580
23163,Aharon,Foyston,afoyston29@shareasale.com,VP Product Management,5968,1283,7251
23835,Mitch,Yitzhakof,myitzhakof2a@admin.ch,Staff Scientist,7813,1792,9605
23470,Stacie,Pochet,spochet2b@people.com.cn,Associate Professor,1563,735,2298
23842,Khalil,Barsham,kbarsham2c@princeton.edu,Senior Developer,1577,872,2449
23293,Rafaello,Guiet,rguiet2d@yolasite.com,Professor,5918,781,6699
23371,Giustino,Gemlbett,ggemlbett2e@ucoz.ru,Accounting Assistant III,5422,715,6137
23598,Aylmer,Clapson,aclapson2g@foxnews.com,Professor,5995,247,6242
23393,Lottie,Verman,lverman2h@gravatar.com,Executive Secretary,7003,1185,8188
23397,Janeen,Begley,jbegley2i@home.pl,Nurse,1368,892,2260
23472,Madelon,Liston,mliston2j@symantec.com,Associate Professor,5190,903,6093
23997,Holden,Eagling,heagling2k@geocities.com,Compensation Analyst,3240,383,3623
23975,Arte,Simms,asimms2l@w3.org,Financial Analyst,9138,609,9747
23979,Daphene,Jacobsz,djacobsz2m@slashdot.org,Chief Design Engineer,7547,1258,8805
23559,Saxe,Forgan,sforgan2n@google.co.jp,Food Chemist,7513,309,7822
23960,Gilbert,Topliss,gtopliss2o@hubpages.com,Human Resources Assistant III,9119,1860,10979
23274,Silvie,Cherry Holme,scherryholme2p@patch.com,Database Administrator II,4618,1478,6096
23556,Dav,McCurrie,dmccurrie2q@irs.gov,Engineer IV,3414,1895,5309
23797,Duff,Renehan,drenehan2r@admin.ch,Staff Accountant III,8015,433,8448
23880,Illa,Weatherell,iweatherell2s@trellian.com,Environmental Tech,5781,268,6049
23114,Willey,Robshaw,wrobshaw2t@google.it,Assistant Professor,2932,481,3413
23510,Si,Harpur,sharpur2u@state.tx.us,Desktop Support Technician,9798,610,10408
23709,Rolph,Belt,rbelt2v@typepad.com,Research Nurse,5242,919,6161
23275,Saudra,Robertsson,srobertsson2w@over-blog.com,Geological Engineer,8397,719,9116
23387,Trenton,Marquez,tmarquez2x@cbsnews.com,Administrative Assistant IV,5366,1878,7244
23096,Freddy,Klaff,fklaff2y@theguardian.com,Professor,7194,1906,9100
23777,Wyn,Jakoubek,wjakoubek2z@ezinearticles.com,General Manager,4704,1851,6555
23831,Ofelia,Tiffney,otiffney30@discuz.net,Operator,2476,475,2951
23664,Adrianna,Whooley,awhooley31@squarespace.com,VP Marketing,1592,410,2002
23241,Melli,Noton,mnoton32@chron.com,Software Test Engineer II,9465,1399,10864
23466,Debor,Pesik,dpesik33@digg.com,Technical Writer,1990,241,2231
23502,Emelita,Libermore,elibermore34@phoca.cz,Junior Executive,6778,1675,8453
23612,Rycca,MacTrusty,rmactrusty35@netlog.com,Technical Writer,1246,1647,2893
23260,Jacki,Goddman,jgoddman36@mayoclinic.com,Programmer II,4968,728,5696
23717,Stephenie,D'Adamo,sdadamo37@wikimedia.org,Tax Accountant,3231,911,4142
23932,Valene,Antoney,vantoney38@sfgate.com,Civil Engineer,8904,493,9397
23419,Kirbee,Espada,kespada39@godaddy.com,Quality Engineer,9783,544,10327
23302,Marianna,Kristoffersen,mkristoffersen3a@wordpress.com,VP Marketing,3230,1500,4730
23048,Finley,Katzmann,fkatzmann3c@state.gov,VP Quality Control,3401,1996,5397
23719,Clarey,Soitoux,csoitoux3d@gizmodo.com,Product Engineer,7706,1484,9190
23021,Hanson,Siflet,hsiflet3e@cpanel.net,Senior Developer,4529,457,4986
23372,Viva,Pargent,vpargent3f@nifty.com,Financial Analyst,7438,812,8250
23891,Nikkie,Polendine,npolendine3g@shutterfly.com,Marketing Manager,1411,904,2315
23722,Rosmunda,Hempshall,rhempshall3h@sun.com,Quality Engineer,3808,1477,5285
23588,Elizabeth,Dondon,edondon3i@boston.com,Systems Administrator III,1974,1330,3304
23832,Gail,Webb,gwebb3j@cnn.com,Sales Representative,3712,1260,4972
23655,Henriette,Ubsdale,hubsdale3l@jalbum.net,VP Sales,6218,1211,7429
23107,Arther,O'Geneay,aogeneay3m@admin.ch,Staff Accountant IV,3957,479,4436
23024,Hanny,Shakshaft,hshakshaft3n@vkontakte.ru,Community Outreach Specialist,1664,1118,2782
23576,Elly,Redwin,eredwin3o@meetup.com,Help Desk Technician,7819,939,8758
23026,Norene,Ingold,ningold3p@xinhuanet.com,Software Test Engineer II,9801,996,10797
23332,Owen,Bannell,obannell3q@wordpress.org,Dental Hygienist,5241,679,5920
23622,Lia,Batting,lbatting3r@geocities.jp,Editor,6644,994,7638
23985,Malorie,Lifsey,mlifsey3s@woothemes.com,Biostatistician III,6541,305,6846
23105,Octavia,Rockcliff,orockcliff3t@tinyurl.com,Environmental Tech,9867,564,10431
23441,Noll,Cleall,ncleall3u@yellowbook.com,Chief Design Engineer,3644,756,4400
23068,Lyndsay,Sutherden,lsutherden3v@opensource.org,Analog Circuit Design manager,4791,404,5195
23281,Cami,Laffling,claffling3w@sitemeter.com,Electrical Engineer,3145,1605,4750
23525,Clerkclaude,Menci,cmenci3x@addthis.com,Geological Engineer,8238,1194,9432
23938,Aleda,Pren,apren3z@opensource.org,Marketing Manager,7044,1591,8635
23827,Margo,Pauer,mpauer40@1und1.de,Engineer II,5874,484,6358
23184,Griz,Gormley,ggormley41@addtoany.com,Cost Accountant,5245,406,5651
23899,Lynne,Ruffler,lruffler43@ftc.gov,Technical Writer,2751,842,3593
23355,Hetti,Heaford,hheaford44@engadget.com,Sales Associate,1157,443,1600
23272,Syd,Bartolomivis,sbartolomivis45@arstechnica.com,Administrative Assistant III,8479,1955,10434
23507,Nathanial,Beeres,nbeeres46@usgs.gov,Physical Therapy Assistant,4988,1138,6126
23849,Lauryn,Polly,lpolly47@sfgate.com,Staff Scientist,2414,619,3033
23331,Crystie,Mitton,cmitton48@about.com,Payment Adjustment Coordinator,8739,1349,10088
23158,Nona,Willsmore,nwillsmore49@home.pl,Health Coach II,3626,1339,4965
23751,Ingmar,Dando,idando4a@theatlantic.com,Analyst Programmer,3199,1164,4363
23531,Roddie,Sprott,rsprott4b@de.vu,Senior Developer,1654,930,2584
23346,Batsheva,Davidoff,bdavidoff4c@hibu.com,Accounting Assistant IV,9065,511,9576
23488,Cyrus,Nolte,cnolte4d@google.co.uk,Assistant Media Planner,8034,912,8946
23539,Baxie,Wesgate,bwesgate4e@mtv.com,Financial Analyst,6156,1092,7248
23803,Allister,Lasham,alasham4f@businessweek.com,Media Manager III,7526,281,7807
23486,Garnet,Zumbusch,gzumbusch4h@marriott.com,Internal Auditor,1725,1775,3500
23503,Ericha,Elleton,eelleton4i@census.gov,Civil Engineer,2986,585,3571
23247,Clive,Amori,camori4j@wikimedia.org,Senior Developer,9692,465,10157
23237,Ted,Jozsika,tjozsika4k@livejournal.com,Director of Sales,8695,342,9037
23766,Baird,Aspell,baspell4l@wp.com,Payment Adjustment Coordinator,5971,1079,7050
23064,Luce,Pitherick,lpitherick4m@google.com.au,Technical Writer,5187,714,5901
23400,Jennifer,Rodenborch,jrodenborch4n@spiegel.de,Help Desk Technician,8597,1800,10397
23336,Harald,Symington,hsymington4o@amazon.co.uk,Information Systems Manager,6531,1076,7607
23986,Celesta,Roberds,croberds4p@berkeley.edu,Quality Control Specialist,5183,1454,6637
23578,Yvor,Helis,yhelis4q@deviantart.com,Office Assistant II,9619,944,10563
23435,Fidela,Gottelier,fgottelier4r@blogger.com,VP Accounting,5708,212,5920
23243,Glenda,Beardall,gbeardall4s@salon.com,Compensation Analyst,6012,605,6617
23497,Jo-anne,Hilary,jhilary4u@java.com,VP Quality Control,7874,1754,9628
23461,Godart,Rothermel,grothermel4v@patch.com,Safety Technician III,9412,1447,10859
23631,Shell,D'Alessandro,sdalessandro4w@hexun.com,Biostatistician IV,8358,1044,9402
23417,Brietta,Last,blast4x@myspace.com,Electrical Engineer,5985,766,6751
23381,Frank,Creggan,fcreggan4y@princeton.edu,Marketing Assistant,6406,736,7142
23386,Jenine,Gockeler,jgockeler4z@webnode.com,Librarian,2365,461,2826
23693,Ardenia,Claydon,aclaydon50@yahoo.com,Project Manager,8787,986,9773
23015,Hymie,Crowley,hcrowley51@accuweather.com,Junior Executive,9254,1289,10543
23583,Sadye,Harkness,sharkness52@census.gov,Compensation Analyst,8422,1861,10283
23088,Maddi,Bletcher,mbletcher53@ted.com,Paralegal,8889,1864,10753
23781,Deirdre,Chastang,dchastang56@meetup.com,Nuclear Power Engineer,6926,802,7728
23479,Halsey,Seear,hseear57@liveinternet.ru,Actuary,4181,750,4931
23463,Denise,Wedderburn,dwedderburn58@t.co,Sales Representative,5805,1608,7413
23801,Ulrikaumeko,Proudman,uproudman5b@opera.com,VP Product Management,1719,606,2325
23830,Hilarius,Matterson,hmatterson5c@php.net,Physical Therapy Assistant,9743,1909,11652
23790,Bell,Grisley,bgrisley5d@flavors.me,Health Coach II,2660,375,3035
23917,Kylie,Dulen,kdulen5e@spotify.com,Computer Systems Analyst III,1788,603,2391
23403,Zea,Skerm,zskerm5f@google.pl,Food Chemist,6150,1735,7885
23845,Stormie,Pawelek,spawelek5g@phpbb.com,Senior Quality Engineer,7849,335,8184
23139,Halie,Driscoll,hdriscoll5h@alexa.com,Quality Engineer,1815,1530,3345
23044,Pippy,O'Beirne,pobeirne5i@admin.ch,Research Associate,7104,618,7722
23036,Bonnibelle,Bowdery,bbowdery5j@chron.com,Web Developer IV,9044,466,9510
23254,Bailey,Olifaunt,bolifaunt5l@home.pl,Research Associate,9110,549,9659
23428,Malena,Filipczak,mfilipczak5m@vimeo.com,Office Assistant II,1540,535,2075
23601,Caresse,Esparza,cesparza5n@sphinn.com,Developer IV,4928,1242,6170
23749,Egor,Malser,emalser5o@cnet.com,Occupational Therapist,6551,290,6841
23731,Livy,Downing,ldowning5r@google.com.br,Electrical Engineer,3586,313,3899
23174,Carl,Scheu,cscheu5s@sfgate.com,Professor,2987,397,3384
23705,Petronia,Varden,pvarden5t@statcounter.com,GIS Technical Architect,4511,1526,6037
23416,Lyn,Oughton,loughton5u@nytimes.com,Marketing Manager,1263,1422,2685
23580,Caril,Croasdale,ccroasdale5v@pinterest.com,Product Engineer,5498,1050,6548
23341,Dulsea,Rydeard,drydeard5w@dmoz.org,Internal Auditor,2239,1678,3917
23233,Cleo,Critch,ccritch5y@icq.com,Librarian,5851,473,6324
23561,Filippo,Bertie,fbertie5z@google.cn,General Manager,2308,1588,3896
23851,Hyatt,Flexman,hflexman60@example.com,Business Systems Development Analyst,9780,1116,10896
23071,Constantine,Rachuig,crachuig63@myspace.com,Information Systems Manager,3474,1044,4518
23242,Clarke,Friar,cfriar64@ox.ac.uk,Senior Sales Associate,3337,1862,5199
23270,Fancy,Bocke,fbocke65@reddit.com,Web Designer IV,5318,1960,7278
23396,Alissa,Chevis,achevis67@naver.com,Automation Specialist IV,6887,1820,8707
23708,Quintana,Avey,qavey68@constantcontact.com,Senior Cost Accountant,2147,1271,3418
23028,Giulietta,Turpey,gturpey69@elegantthemes.com,Safety Technician II,5020,670,5690
23727,Andriette,Kightly,akightly6b@yahoo.co.jp,Office Assistant II,5099,1766,6865
23915,Sid,McClunaghan,smcclunaghan6c@senate.gov,Software Engineer I,3983,1460,5443
23360,Boigie,Millimoe,bmillimoe6d@dion.ne.jp,Budget/Accounting Analyst III,1713,937,2650
23291,Lexine,Weepers,lweepers6e@shop-pro.jp,Senior Quality Engineer,4787,1776,6563
23388,Brandy,Stonier,bstonier6f@wiley.com,Teacher,8588,1361,9949
23882,Zaneta,Astin,zastin6g@angelfire.com,Marketing Manager,2262,1023,3285
23402,Morganne,Aronson,maronson6h@bloglines.com,Account Coordinator,7871,1909,9780
23675,Laurena,Raynard,lraynard6i@mozilla.org,Assistant Media Planner,6003,1120,7123
23909,Pooh,Jacqueminot,pjacqueminot6j@nytimes.com,Computer Systems Analyst II,9906,919,10825
23624,Sandra,Swatland,sswatland6l@xing.com,Registered Nurse,2800,774,3574
23215,Margette,Farres,mfarres6n@patch.com,Media Manager IV,1313,531,1844
23587,Osbourn,Smalles,osmalles6o@51.la,Help Desk Operator,5521,634,6155
23919,Stormy,Beek,sbeek6p@macromedia.com,Director of Sales,1026,237,1263
23566,Anya,McTerry,amcterry6q@fastcompany.com,Environmental Tech,8956,1724,10680
23110,Jessey,Lafay,jlafay6r@narod.ru,Dental Hygienist,1456,1337,2793
23535,Vladimir,Hincham,vhincham6s@va.gov,Clinical Specialist,7759,765,8524
23898,Taryn,Parzis,tparzis6u@dion.ne.jp,Systems Administrator IV,2577,1252,3829
23579,Orrin,MacPhee,omacphee6w@washington.edu,Analog Circuit Design manager,5513,1118,6631
23498,Kendre,Pettifer,kpettifer6y@nbcnews.com,Speech Pathologist,6659,1534,8193
23734,Delila,Moakes,dmoakes6z@xinhuanet.com,General Manager,6407,426,6833
23605,Madelyn,Penrith,mpenrith70@reference.com,Analog Circuit Design manager,5514,1712,7226
23257,Ricky,Sawdon,rsawdon71@cdbaby.com,Geologist I,3310,1556,4866
23207,Wernher,Von Hindenburg,wvonhindenburg73@who.int,Account Executive,9416,758,10174
23716,Shermie,Hinkins,shinkins74@amazon.co.jp,Software Test Engineer III,7753,516,8269
23250,Willie,Bambery,wbambery76@springer.com,Statistician I,5563,1128,6691
23039,Si,McPheat,smcpheat77@seesaa.net,Staff Accountant II,9347,1098,10445
23142,Lambert,Gerram,lgerram79@economist.com,Civil Engineer,1994,1162,3156
23155,Ros,Spada,rspada7a@loc.gov,Technical Writer,2626,791,3417
23736,Gennie,Dencs,gdencs7b@zimbio.com,Research Assistant III,5273,409,5682
23925,Melosa,Inglis,minglis7c@list-manage.com,Payment Adjustment Coordinator,8251,1676,9927
23288,Osgood,Peare,opeare7d@ibm.com,Senior Cost Accountant,2774,471,3245
23061,Ferd,Thomerson,fthomerson7f@usa.gov,Community Outreach Specialist,4240,1864,6104
23298,Vivyan,Cassey,vcassey7g@eventbrite.com,Statistician I,7591,606,8197
23623,Brendon,Dobbin,bdobbin7h@china.com.cn,Sales Associate,2105,1257,3362
23262,Oralle,Di Giacomo,odigiacomo7i@theatlantic.com,Executive Secretary,5211,726,5937
23825,Birch,Scarlin,bscarlin7j@acquirethisname.com,Assistant Professor,7814,555,8369
23659,Irving,O'Murtagh,iomurtagh7k@unicef.org,Health Coach III,6640,882,7522
23308,Lilas,Soeiro,lsoeiro7m@symantec.com,Software Consultant,9342,231,9573
23022,Royce,Ingold,ringold7o@berkeley.edu,Account Representative IV,1173,529,1702
23263,Sarina,Antunes,santunes7p@toplist.cz,Nurse,6531,1887,8418
23414,Sonny,Strode,sstrode7q@ed.gov,Design Engineer,7997,1350,9347
23895,Hillel,Martinet,hmartinet7r@examiner.com,Tax Accountant,4072,1111,5183
23322,Belita,Luckett,bluckett7s@dion.ne.jp,Internal Auditor,6866,1318,8184
23305,Eddy,Issitt,eissitt7t@jiathis.com,Graphic Designer,5367,1523,6890
23853,Pennie,Clothier,pclothier7u@freewebs.com,Editor,7498,1069,8567
23490,Correna,Blakelock,cblakelock7v@irs.gov,Information Systems Manager,6356,1989,8345
23799,Clarisse,Gantzman,cgantzman7w@ox.ac.uk,Associate Professor,6215,434,6649
23117,Giorgi,Sayles,gsayles7x@cnet.com,Environmental Tech,4360,1165,5525
23197,Ardith,Tedahl,atedahl7y@wordpress.com,Quality Control Specialist,9980,1367,11347
23075,Marleen,Treffry,mtreffry7z@cyberchimps.com,Occupational Therapist,3730,736,4466
23008,Ash,Lamshead,alamshead80@live.com,Electrical Engineer,9569,467,10036
23345,Augie,Ambrogio,aambrogio81@odnoklassniki.ru,Junior Executive,9828,962,10790
23677,Martainn,Oldford,moldford82@ucla.edu,Programmer Analyst I,2992,1238,4230
23712,Oralla,Charette,ocharette83@geocities.com,Office Assistant IV,1741,570,2311
23406,Sandro,Ivanikhin,sivanikhin84@blogs.com,Chemical Engineer,9217,561,9778
23290,Kale,O'Hara,kohara85@eepurl.com,Food Chemist,4279,1373,5652
23427,Kaiser,Dafforne,kdafforne87@quantcast.com,Sales Associate,2965,931,3896
23060,Jeannette,Murr,jmurr88@wisc.edu,Programmer Analyst IV,9263,1881,11144
23430,Nelly,Strewther,nstrewther8a@ibm.com,Senior Financial Analyst,7754,1157,8911
23282,Page,Devenny,pdevenny8b@lycos.com,Database Administrator III,4799,1982,6781
23756,Cherilynn,Jenne,cjenne8c@storify.com,Research Associate,7347,1924,9271
23730,Robin,Jolliff,rjolliff8d@symantec.com,Web Designer I,4130,656,4786
23382,Benoite,Carlisle,bcarlisle8f@hc360.com,Quality Control Specialist,9803,768,10571
23584,Valerie,Giorgeschi,vgiorgeschi8g@jalbum.net,Senior Quality Engineer,4843,1805,6648
23038,Odille,Van Hove,ovanhove8h@bloomberg.com,Marketing Assistant,2787,1388,4175
23001,Cynthia,Slader,cslader8i@zimbio.com,Account Representative IV,1099,481,1580
23362,Nico,Kelner,nkelner8j@mozilla.org,Teacher,5983,1759,7742
23191,Lesly,Townley,ltownley8k@ftc.gov,Technical Writer,3577,1471,5048
23798,Kailey,Kretschmer,kkretschmer8l@tamu.edu,Database Administrator III,7266,224,7490
23858,Barthel,Dorrins,bdorrins8n@cloudflare.com,VP Sales,7277,1456,8733
23546,Hollie,Harner,hharner8o@reuters.com,Geological Engineer,3329,1974,5303
23678,Paton,Donizeau,pdonizeau8r@taobao.com,Media Manager IV,7736,1297,9033
23762,Lorelle,Benbrick,lbenbrick8s@hibu.com,Executive Secretary,4194,1677,5871
23411,Kissee,Rosekilly,krosekilly8t@mapy.cz,Sales Representative,2062,1379,3441
23523,Curcio,Dymocke,cdymocke8u@slashdot.org,Pharmacist,6529,1934,8463
23137,Renie,Napier,rnapier8v@sogou.com,Budget/Accounting Analyst IV,4946,245,5191
23728,Andy,Valentetti,avalentetti8y@geocities.com,Accountant II,6308,986,7294
23606,Nolie,Spilsburie,nspilsburie8z@ehow.com,Senior Financial Analyst,3198,1159,4357
23072,Charisse,Castellaccio,ccastellaccio90@godaddy.com,GIS Technical Architect,3829,791,4620
23224,Felisha,Coomes,fcoomes91@illinois.edu,Professor,1634,502,2136
23229,Pam,Lidgate,plidgate92@indiegogo.com,Dental Hygienist,1603,599,2202
23838,Florance,Scanlan,fscanlan93@blogs.com,Legal Assistant,9801,385,10186
23543,Casandra,Maunders,cmaunders94@archive.org,Nuclear Power Engineer,8480,930,9410
23908,Jory,Keller,jkeller95@e-recht24.de,Programmer Analyst III,5261,688,5949
23066,Odilia,Holleworth,oholleworth97@europa.eu,Assistant Media Planner,6294,1943,8237
23809,Carry,McIlrath,cmcilrath98@t.co,Recruiting Manager,4194,680,4874
23953,Nata,Dudliston,ndudliston99@boston.com,Software Test Engineer IV,8972,893,9865
23702,Lizbeth,Lukianovich,llukianovich9a@elegantthemes.com,Internal Auditor,8252,756,9008
23861,Paton,Eastmond,peastmond9b@ustream.tv,VP Marketing,5653,1921,7574
23647,Lilly,McCromley,lmccromley9f@businessinsider.com,GIS Technical Architect,9426,1062,10488
23378,Claiborn,Dennison,cdennison9g@hugedomains.com,Web Developer IV,8075,1163,9238
23905,Lowe,Challes,lchalles9h@abc.net.au,Human Resources Manager,9647,1171,10818
23983,Glynda,Perryn,gperryn9j@washingtonpost.com,Marketing Manager,8995,656,9651
23758,Kynthia,Casebourne,kcasebourne9k@unicef.org,Budget/Accounting Analyst I,9707,1358,11065
23569,Murry,Jacmar,mjacmar9l@mysql.com,Tax Accountant,9268,1807,11075
23757,Charisse,Jugging,cjugging9m@shareasale.com,Budget/Accounting Analyst IV,3448,416,3864
23261,Anne-marie,MacCheyne,amaccheyne9n@jiathis.com,Nuclear Power Engineer,8756,1560,10316
23676,Deva,Hindrick,dhindrick9o@wired.com,Analyst Programmer,6531,1292,7823
23160,Carlie,McWhorter,cmcwhorter9q@blog.com,Computer Systems Analyst II,7838,360,8198
23246,Hettie,Drain,hdrain9r@amazon.de,Research Associate,6969,1971,8940
23458,Florrie,Marklew,fmarklew9s@mtv.com,Systems Administrator IV,9692,873,10565
23994,Lisle,Armfirld,larmfirld9t@discovery.com,Civil Engineer,9588,779,10367
23829,Adele,Franke,afranke9u@rediff.com,Programmer Analyst III,8020,545,8565
23632,Blake,Rault,brault9v@163.com,Marketing Manager,6718,1438,8156
23009,Alberta,Leaney,aleaney9w@washingtonpost.com,Environmental Specialist,7733,308,8041
23407,Dukey,Pozer,dpozer9y@geocities.jp,General Manager,1045,1467,2512
23869,Elayne,Grzegorecki,egrzegorecki9z@google.com.br,Dental Hygienist,3210,336,3546
23491,Wilona,Sappson,wsappsona0@cdc.gov,General Manager,1198,309,1507
23864,Gennie,Valintine,gvalintinea2@stanford.edu,Food Chemist,2414,299,2713
23452,Claresta,Meade,cmeadea3@salon.com,Editor,9142,417,9559
23707,Andros,Bencher,abenchera4@wp.com,Media Manager I,2267,233,2500
23687,Aubrey,Bauman,abaumana7@ameblo.jp,Systems Administrator IV,6190,488,6678
23999,Giles,Grigolli,ggrigollia9@meetup.com,Administrative Assistant III,9158,706,9864
23890,Sioux,Philpotts,sphilpottsae@goodreads.com,VP Accounting,2582,293,2875
23098,Gilda,Benoi,gbenoiaf@lycos.com,Operator,2679,1521,4200
23773,Kariotta,McDell,kmcdellak@tuttocitta.it,Recruiting Manager,4447,1604,6051
23791,Loralee,Ragot,lragotal@netscape.com,Biostatistician III,1245,570,1815
23374,Abra,Abry,aabryam@sogou.com,Assistant Manager,3217,1604,4821
23526,Maddie,Carrett,mcarrettan@pagesperso-orange.fr,Budget/Accounting Analyst I,7679,1900,9579
23811,Tadio,Kipling,tkiplingao@engadget.com,Environmental Specialist,1596,1806,3402
23593,Buddie,Longford,blongfordap@redcross.org,Automation Specialist II,2735,1999,4734
23484,Donetta,Lauritzen,dlauritzenas@nsw.gov.au,Engineer II,5667,599,6266
23042,Caresa,Conibeer,cconibeerav@shinystat.com,Office Assistant II,2983,1934,4917
23437,Timmie,Perschke,tperschkeax@hud.gov,Assistant Manager,5622,1181,6803
23688,Fowler,Austick,faustickay@google.pl,Teacher,5563,1389,6952
23307,Deeanne,Kisby,dkisbyaz@is.gd,Senior Sales Associate,6975,1710,8685
23181,Donetta,Castellanos,dcastellanosb2@examiner.com,Software Test Engineer III,2236,343,2579
23992,Yank,Simpkin,ysimpkinb3@posterous.com,Electrical Engineer,8975,266,9241
23228,Lorry,Raysdale,lraysdaleb5@wisc.edu,Programmer I,9929,523,10452
23644,Steward,Leatham,sleathamb6@thetimes.co.uk,Media Manager I,1914,560,2474
23928,Rori,Janning,rjanningb9@ibm.com,Quality Engineer,7297,255,7552
23124,Lynnet,Aston,lastonbb@examiner.com,Director of Sales,2650,729,3379
23852,Athene,Chadburn,achadburnbc@google.co.uk,Senior Financial Analyst,6231,1558,7789
23131,Thalia,Knibb,tknibbbd@printfriendly.com,Dental Hygienist,1984,309,2293
23450,Lyndsie,Milward,lmilwardbe@themeforest.net,Nurse,8924,1139,10063
23586,Sheri,MacEntee,smacenteebf@flavors.me,Web Designer II,2502,1935,4437
23933,Kathlin,Eastam,keastambh@icq.com,Media Manager III,1375,901,2276
23753,Terencio,Fleury,tfleurybj@tripod.com,Help Desk Technician,9730,265,9995
23918,Waiter,Sore,wsorebk@google.com.au,Project Manager,6160,1067,7227
23725,Alonso,Malone,amalonebn@netvibes.com,Librarian,8969,1724,10693
23111,Guss,Myatt,gmyattbo@cam.ac.uk,Account Representative II,9826,1415,11241
23033,Beltran,Bellwood,bbellwoodbp@discovery.com,Community Outreach Specialist,8975,1409,10384
23129,Julietta,Fessler,jfesslerbq@tumblr.com,Health Coach II,5793,262,6055
23893,Catlee,Medd,cmeddbr@nasa.gov,Occupational Therapist,9226,1995,11221
23296,Shirlee,MacCarrane,smaccarranebt@sakura.ne.jp,Help Desk Technician,6320,1690,8010
23981,Kristin,Quakley,kquakleybu@home.pl,Automation Specialist II,6138,1965,8103
23585,Land,Ardy,lardybv@newyorker.com,Marketing Assistant,5317,1749,7066
23495,Lorne,Hauxby,lhauxbybw@weebly.com,Legal Assistant,8219,367,8586
23265,Tomaso,Powner,tpownerbx@jimdo.com,VP Marketing,6069,867,6936
23234,Maurita,Laudham,mlaudhamc0@bizjournals.com,Health Coach IV,7711,1146,8857
23348,Emelina,Besantie,ebesantiec3@utexas.edu,Human Resources Assistant IV,7180,986,8166
23920,Bab,Wallach,bwallachc4@hhs.gov,Senior Editor,1751,356,2107
23125,Batholomew,Borrott,bborrottc6@friendfeed.com,Programmer I,2884,857,3741
23052,Benjamen,Gobel,bgobelc7@desdev.cn,Quality Control Specialist,4145,1288,5433
23976,Ulric,Celler,ucellerc8@amazon.co.jp,Software Test Engineer I,5851,1645,7496
23871,Fidole,Pomeroy,fpomeroycc@boston.com,Assistant Manager,5738,1798,7536
23399,Samuel,Devenny,sdevennyce@zdnet.com,Data Coordiator,1956,1985,3941
23185,Luis,Rigmond,lrigmondcf@cocolog-nifty.com,Product Engineer,1240,671,1911
23720,Noami,Moncarr,nmoncarrcg@reverbnation.com,Geologist II,7704,962,8666
23866,Florencia,Gilpillan,fgilpillanci@twitpic.com,Programmer IV,8584,927,9511
23780,Alfy,Klebes,aklebescj@earthlink.net,Marketing Manager,8843,1917,10760
23303,Addie,Pargeter,apargetercl@google.es,Community Outreach Specialist,4718,1864,6582
23194,Marigold,Picott,mpicottcm@wiley.com,Teacher,4795,1114,5909
23349,Kori,McQuarrie,kmcquarriecn@loc.gov,VP Quality Control,1847,1540,3387
23617,Fredelia,Habden,fhabdenco@army.mil,Database Administrator IV,8143,508,8651
23878,Jorrie,Haggar,jhaggarcp@addthis.com,Programmer Analyst IV,2384,1174,3558
23475,Allayne,Chretien,achretiencq@pcworld.com,Senior Financial Analyst,5602,1976,7578
23903,Dare,Kulic,dkuliccr@smugmug.com,Nurse,5065,1197,6262
23666,Mikol,Mourge,mmourgect@tmall.com,Programmer Analyst IV,9782,944,10726
23638,Vanessa,Assiratti,vassiratticy@rediff.com,Assistant Professor,1690,1705,3395
23663,Nanci,Ellerey,nellereycz@lycos.com,Community Outreach Specialist,8411,1441,9852
23615,Leanna,Chitty,lchittyd1@cyberchimps.com,Automation Specialist I,3782,491,4273
23723,Kinsley,Glowinski,kglowinskid4@nps.gov,Accountant IV,4251,605,4856
23739,Rory,Goosey,rgooseyd5@arizona.edu,Research Assistant IV,8018,1200,9218
23669,Jabez,Myring,jmyringd8@npr.org,Nurse Practicioner,7963,1950,9913
23914,Janeva,Raraty,jraratyd9@cornell.edu,Software Engineer IV,5048,1710,6758
23660,Collin,Lindberg,clindbergda@berkeley.edu,Developer I,8093,907,9000
23760,Justinian,Kinig,jkinigdc@google.pl,Librarian,7378,881,8259
23474,Gothart,Ivashnikov,givashnikovdd@sciencedirect.com,Environmental Tech,8469,2000,10469
23085,Sashenka,Stockport,sstockportde@diigo.com,Environmental Specialist,3410,1506,4916
23401,Johnnie,Duffield,jduffielddf@whitehouse.gov,Environmental Specialist,1474,299,1773
23867,Louella,Hinken,lhinkendn@google.com.au,Programmer III,1264,1367,2631
23922,Leopold,Shevill,lshevilldr@pcworld.com,Geological Engineer,4752,1007,5759
23955,Annmarie,Angrock,aangrockdu@wordpress.com,Food Chemist,4269,1521,5790
23879,Karil,Grumble,kgrumbledv@boston.com,Automation Specialist IV,5944,1774,7718
23653,Vlad,Hardistry,vhardistrydw@java.com,Environmental Specialist,1041,973,2014
23789,Antony,Loftus,aloftusdx@zimbio.com,Community Outreach Specialist,9404,1728,11132
23037,Witty,Tough,wtoughdy@bloglovin.com,Data Coordiator,4572,1134,5706
23318,Thaxter,McKain,tmckaindz@toplist.cz,Office Assistant I,5598,1866,7464
23988,Grazia,Peinton,gpeintone2@unblog.fr,Marketing Manager,7931,682,8613
23102,Lauri,Dealtry,ldealtrye3@devhub.com,Compensation Analyst,8195,501,8696
23901,Merilyn,MacNamee,mmacnameee4@creativecommons.org,Technical Writer,1698,807,2505
23353,Tory,Donaho,tdonahoe5@php.net,Librarian,5017,1726,6743
23227,Jolynn,de Glanville,jdeglanvillee8@ted.com,Structural Analysis Engineer,7746,1567,9313
23637,Cindelyn,Everwin,ceverwine9@biglobe.ne.jp,Compensation Analyst,3181,1359,4540
23854,Dru,Pohlak,dpohlakea@google.cn,Research Nurse,4262,1147,5409
23438,Wolf,Stow,wstowec@pen.io,Biostatistician I,2902,862,3764
23310,Bernete,Mingaye,bmingayeee@list-manage.com,Accountant I,8384,430,8814
23255,Sari,Wardley,swardleyef@flickr.com,Office Assistant II,5025,1119,6144
23591,Bobbi,Espinoy,bespinoyeg@hubpages.com,VP Accounting,4345,1228,5573
23522,Rolland,Hefferon,rhefferonej@bigcartel.com,Teacher,7278,1703,8981
23508,Robb,Opie,ropieem@cocolog-nifty.com,Clinical Specialist,1683,503,2186
23487,Joey,Phare,jphareep@a8.net,Software Engineer II,1393,1782,3175
23969,Andreas,Coggings,acoggingses@google.ru,Executive Secretary,7202,229,7431
23054,Lesley,Corzon,lcorzonet@ocn.ne.jp,Geologist I,1046,956,2002
23408,Griffie,Skillings,gskillingseu@woothemes.com,Staff Accountant IV,3491,654,4145
23171,Maryrose,Skein,mskeinew@themeforest.net,Environmental Specialist,1394,1218,2612
23788,Ceciley,Lanchberry,clanchberryex@umn.edu,Human Resources Manager,7352,1399,8751
23070,Corabel,Hirjak,chirjakey@reference.com,Desktop Support Technician,6527,1066,7593
23771,Winonah,Senecaux,wsenecauxez@bloglines.com,Speech Pathologist,7676,1045,8721
23351,Chrissy,Marty,cmartyf1@skype.com,Technical Writer,3645,1579,5224
23902,Vivyan,Domel,vdomelf3@xrea.com,Assistant Manager,9324,1298,10622
23176,Hanan,Wilflinger,hwilflingerf6@ted.com,Cost Accountant,5933,1185,7118
23889,Derek,Berkley,dberkleyf7@imageshack.us,Quality Engineer,9611,895,10506
23433,Morris,Handslip,mhandslipf9@deliciousdays.com,Systems Administrator II,2895,1979,4874
23103,Durante,Wahner,dwahnerfa@dmoz.org,Marketing Assistant,4893,741,5634
23844,Monroe,Agar,magarfb@youku.com,Speech Pathologist,3358,795,4153
23299,Merl,Galsworthy,mgalsworthyfc@dion.ne.jp,Programmer IV,2688,603,3291
23456,Geri,Pagram,gpagramfd@topsy.com,Computer Systems Analyst IV,5581,726,6307
23670,Augusta,Thorneley,athorneleyfg@cisco.com,Help Desk Technician,7980,1698,9678
23672,Cherilynn,Bunclark,cbunclarkfh@salon.com,Systems Administrator II,2780,1963,4743
23921,Lezlie,Flaonier,lflaonierfi@t.co,Marketing Manager,3912,1062,4974
23529,Charmine,Rodell,crodellfk@nytimes.com,Electrical Engineer,6886,406,7292
23515,Fanni,Gremane,fgremanefl@twitter.com,Human Resources Assistant III,9850,548,10398
23133,Luciano,Sackes,lsackesfm@comcast.net,VP Accounting,9567,744,10311
23843,Ram,Heigl,rheiglfn@jiathis.com,Teacher,7884,1095,8979
23577,Britte,Langstone,blangstonefp@umn.edu,Business Systems Development Analyst,9415,1413,10828
23863,Esteban,Whittle,ewhittlefr@google.ca,Help Desk Operator,7355,1669,9024
23937,Hamilton,Lightbourn,hlightbournft@telegraph.co.uk,Health Coach I,7167,686,7853
23819,Khalil,Hollidge,khollidgefv@uiuc.edu,Structural Engineer,4076,1600,5676
23711,Etta,Ricciardello,ericciardellofw@live.com,Director of Sales,9596,1913,11509
23537,Lotty,Manus,lmanusfx@newsvine.com,Food Chemist,1580,1244,2824
23604,Atlante,Petrolli,apetrollifz@google.nl,Automation Specialist II,1102,1924,3026
23203,Joella,Ryde,jrydeg1@dmoz.org,Teacher,6690,540,7230
23347,Emmi,Gossop,egossopg4@nih.gov,Help Desk Technician,3507,899,4406
23792,Patti,Sagg,psaggga@statcounter.com,Electrical Engineer,8007,1689,9696
23195,Terry,Rosettini,trosettinigd@livejournal.com,GIS Technical Architect,6710,821,7531
23940,Bunnie,Critcher,bcritchergg@pcworld.com,Senior Cost Accountant,5750,267,6017
23738,Patty,Lamperd,plamperdgi@harvard.edu,Automation Specialist III,3170,555,3725
23056,Paten,Happel,phappelgj@privacy.gov.au,Engineer II,1377,1634,3011
23154,Lorianna,Peche,lpechegk@themeforest.net,Junior Executive,2534,258,2792
23524,Shari,McGeagh,smcgeaghgo@dell.com,Senior Developer,5431,1587,7018
23040,Eleonore,Blakemore,eblakemoregp@google.ru,Pharmacist,7383,1047,8430
23126,Gayle,Gilffilland,ggilffillandgq@fda.gov,Operator,1200,1452,2652
23599,Tanny,Le Blond,tleblondgs@meetup.com,Staff Accountant I,9143,476,9619
23551,Beckie,Tomini,btominigu@hugedomains.com,Health Coach IV,2889,1665,4554
23629,Leighton,Rushbrooke,lrushbrookegw@ehow.com,Structural Analysis Engineer,3175,1630,4805
23775,Leonore,Berzons,lberzonsgy@lulu.com,Sales Representative,2064,815,2879
23278,James,Zellner,jzellnergz@reuters.com,Environmental Tech,9251,226,9477
23395,Sholom,Shakle,sshakleh0@php.net,Cost Accountant,3880,1305,5185
23973,Claiborn,Perks,cperksh1@ning.com,Senior Financial Analyst,5902,1087,6989
23065,Gisela,Avrahamof,gavrahamofh2@archive.org,Analyst Programmer,1799,1637,3436
23704,Erinna,Kavanagh,ekavanaghh5@soup.io,Payment Adjustment Coordinator,8775,1504,10279
23364,Nona,Barbrick,nbarbrickh6@tripod.com,Financial Advisor,4760,1870,6630
23165,Katharyn,Petrakov,kpetrakovha@youku.com,Social Worker,7060,705,7765
23221,Thacher,Lankester,tlankesterhe@intel.com,Senior Cost Accountant,7084,1829,8913
23320,Norene,Dixey,ndixeyhf@harvard.edu,Civil Engineer,8677,1889,10566
23860,Fabiano,Halvorsen,fhalvorsenhi@pen.io,Assistant Manager,9807,422,10229
23095,Joelie,Free,jfreehj@pcworld.com,Director of Sales,9189,713,9902
23855,Jessey,Kerne,jkernehk@ycombinator.com,Help Desk Technician,6307,1731,8038
23549,Tarrah,Staner,tstanerhm@reference.com,Health Coach III,5881,1206,7087
23334,Sol,Reisenstein,sreisensteinhn@digg.com,Actuary,8088,1515,9603
23544,Jacob,Wellstood,jwellstoodhp@senate.gov,GIS Technical Architect,6336,326,6662
23963,Trenna,Cullon,tcullonht@economist.com,Engineer III,6942,1118,8060
23724,Nikolos,O'Shea,nosheahx@wikia.com,Research Nurse,9877,291,10168
23564,Idaline,Trewhela,itrewhelahy@google.com.hk,Operator,7284,1355,8639
23874,Tristam,Cudiff,tcudiffi2@hostgator.com,Professor,9253,345,9598
23807,Nadean,Eckart,neckarti3@theglobeandmail.com,Help Desk Operator,2349,648,2997
23520,Noak,Dyte,ndytei5@hibu.com,Technical Writer,5133,579,5712
23737,Jammie,Vest,jvesti6@webs.com,Librarian,3218,439,3657
23995,Cate,Tunmore,ctunmoreic@seesaa.net,Research Nurse,1007,1064,2071
23268,Jeffie,Simmins,jsimminsid@weather.com,Executive Secretary,1731,1376,3107
23394,Wes,De Simoni,wdesimoniih@answers.com,Statistician IV,5332,736,6068
23151,Gusti,MacDearmid,gmacdearmidij@blogger.com,Environmental Specialist,5732,1325,7057
23267,Naomi,Lambkin,nlambkinim@friendfeed.com,Research Assistant II,1437,1446,2883
23552,Janetta,Wavish,jwavishin@shutterfly.com,VP Sales,3123,1208,4331
23138,Sarita,Bratley,sbratleyip@skype.com,Structural Engineer,3380,498,3878
23121,Sawyer,Brass,sbrassiv@symantec.com,Software Test Engineer IV,5282,487,5769
23904,Dix,Money,dmoneyiy@gravatar.com,Professor,9811,779,10590
23560,Pansie,O'Mannion,pomannionj0@angelfire.com,Research Assistant II,3983,1131,5114
23554,Arleen,Howles,ahowlesj2@g.co,Associate Professor,9740,1892,11632
23732,Cheri,Jans,cjansj4@themeforest.net,Legal Assistant,9986,409,10395
23804,Carola,Cutler,ccutlerj6@wunderground.com,Pharmacist,7203,253,7456
23616,Jemie,Empson,jempsonj9@cargocollective.com,Paralegal,1568,921,2489
23796,Hurleigh,Barnewelle,hbarnewellejb@1688.com,Registered Nurse,2077,1758,3835
23123,Frazier,Sibbs,fsibbsjd@abc.net.au,Assistant Professor,6608,1768,8376
23971,Lavinie,Brittlebank,lbrittlebankje@oakley.com,Pharmacist,2838,939,3777
23846,Ashli,Stollmeyer,astollmeyerji@usnews.com,Developer III,3136,690,3826
23329,Alisa,Goodrich,agoodrichjj@businesswire.com,Staff Scientist,1379,1618,2997
23077,Marlee,Lune,mlunejk@netvibes.com,Office Assistant III,5073,1132,6205
23390,Darby,Reaney,dreaneyjm@sogou.com,Web Developer III,4011,1792,5803
23115,Iain,Ciccotto,iciccottojn@goo.gl,Nuclear Power Engineer,2979,650,3629
23652,Ferd,Eldredge,feldredgejo@bluehost.com,Quality Engineer,2625,390,3015
23476,Anya,Loxley,aloxleyjp@wikispaces.com,Nurse,3234,1264,4498
23924,Serene,Tregenza,stregenzajq@weibo.com,Design Engineer,4713,1296,6009
23563,Gert,Featherstonhaugh,gfeatherstonhaughjr@mac.com,Compensation Analyst,5321,862,6183
23785,Pavla,Ungerer,pungererjt@instagram.com,Marketing Manager,1524,921,2445
23810,Loella,Skowcraft,lskowcraftjw@utexas.edu,Geologist IV,9161,1393,10554
23965,Kaspar,Ackenson,kackensonjx@chron.com,Community Outreach Specialist,6374,1674,8048
23618,Bobette,Courtman,bcourtmanjy@sakura.ne.jp,Registered Nurse,6223,465,6688
23448,Maribelle,Flockhart,mflockhartk0@mtv.com,Data Coordiator,3227,1174,4401
23916,Marmaduke,Busch,mbuschk1@eepurl.com,Social Worker,9298,878,10176
23649,Cory,Seeks,cseeksk2@google.de,Pharmacist,9829,1920,11749
23062,Joshia,Egginton,jeggintonk3@twitpic.com,Systems Administrator IV,3027,318,3345
23473,Baldwin,Yushkin,byushkink4@csmonitor.com,Senior Sales Associate,8510,257,8767
23741,Delmer,Bravery,dbraveryk5@studiopress.com,Nurse Practicioner,7347,674,8021
23692,Adelina,Manie,amaniek6@si.edu,Engineer III,4787,1292,6079
23304,Xever,Jindacek,xjindacekka@shinystat.com,Chief Design Engineer,8378,1447,9825
23006,Ryley,Ottewill,rottewillkb@hostgator.com,Structural Analysis Engineer,2829,1685,4514
23710,Nelly,Breissan,nbreissankd@blogspot.com,Systems Administrator III,3161,1458,4619
23897,Leo,Lamberto,llambertokg@tinyurl.com,Information Systems Manager,6905,1378,8283
23313,Griffy,Reubel,greubelkh@google.es,Budget/Accounting Analyst I,8148,421,8569
23424,Benedikta,McIlvoray,bmcilvorayki@sbwire.com,Technical Writer,3819,1338,5157
23352,Kary,Babon,kbabonkj@sohu.com,Chief Design Engineer,3939,232,4171
23668,Betteann,Demare,bdemarekk@vimeo.com,Dental Hygienist,4322,748,5070
23004,Fraze,Qusklay,fqusklaykm@jigsy.com,VP Marketing,9417,533,9950
23271,Marleah,Cogan,mcoganko@usa.gov,Food Chemist,4632,377,5009
23086,Haskel,Sirmon,hsirmonkw@lulu.com,Statistician II,3927,229,4156
23106,Foster,Havile,fhavilekx@wp.com,Occupational Therapist,9109,1482,10591
23912,Judd,Beaglehole,jbeagleholel0@amazon.co.uk,Chemical Engineer,2912,1913,4825
23648,Tamar,Forster,tforsterl1@ask.com,Executive Secretary,3604,1525,5129
23683,Englebert,Defew,edefewl3@bloomberg.com,Project Manager,3014,1777,4791
23128,Darren,Carlisi,dcarlisil5@ca.gov,Editor,5177,1138,6315
23350,Chevy,Pearce,cpearcelb@harvard.edu,Developer I,6111,399,6510
23108,Saleem,Greenhill,sgreenhillld@dropbox.com,Web Developer II,7700,1805,9505
23464,Denni,Pengilly,dpengillylf@senate.gov,Community Outreach Specialist,9619,859,10478
23189,Webb,Yanov,wyanovlh@netlog.com,Media Manager II,6567,1151,7718
23982,Cly,McSperrin,cmcsperrinli@360.cn,Design Engineer,9769,1505,11274
23496,Judy,McNamara,jmcnamaralo@fastcompany.com,Analyst Programmer,1283,351,1634
23888,Titus,Swanbourne,tswanbournelt@edublogs.org,Human Resources Manager,8935,540,9475
23972,Tailor,Brussell,tbrusselllu@google.it,Budget/Accounting Analyst IV,8538,1834,10372
23425,Hadlee,Morphey,hmorpheylw@redcross.org,Software Test Engineer I,8396,1468,9864
23806,Wittie,Thorald,wthoraldly@sina.com.cn,Accountant II,5096,1991,7087
23823,Gerome,Scothorn,gscothornm0@sfgate.com,Legal Assistant,3617,1800,5417
23826,Mike,Tustin,mtustinm1@privacy.gov.au,Mechanical Systems Engineer,7088,388,7476
23998,Beniamino,Cominotti,bcominottim2@elegantthemes.com,Pharmacist,4492,269,4761
23391,Roseanna,Greenhalf,rgreenhalfm3@theguardian.com,Account Coordinator,1536,471,2007
23836,Tobin,Bulman,tbulmanm6@npr.org,Design Engineer,1878,900,2778
23602,Jesse,Colbridge,jcolbridgema@yellowpages.com,Programmer IV,9404,245,9649
23344,Patrick,Rogge,proggeme@seesaa.net,Quality Engineer,4295,319,4614
23451,Janenna,Burdess,jburdessmg@so-net.ne.jp,Analyst Programmer,2039,1548,3587
23421,William,Comins,wcominsml@discuz.net,Nuclear Power Engineer,6937,240,7177
23540,Bernetta,Rolland,brollandmo@nationalgeographic.com,Office Assistant III,3272,1457,4729
23097,Lisha,Dohrmann,ldohrmannmq@chicagotribune.com,Nuclear Power Engineer,9122,1600,10722
23252,Valentijn,Couche,vcouchemr@bandcamp.com,Business Systems Development Analyst,1041,1422,2463
23536,Marti,Coombes,mcoombesms@xinhuanet.com,Chief Design Engineer,4018,867,4885
23750,Callida,Shapcott,cshapcottmu@hostgator.com,Web Designer II,9377,1569,10946
23859,Odelinda,Bramhall,obramhallmv@so-net.ne.jp,Analog Circuit Design manager,9591,228,9819
23892,Tabbi,Leathers,tleathersmz@cpanel.net,Nurse,7143,1291,8434
23589,Cirilo,Worsall,cworsalln0@google.co.jp,Help Desk Technician,7186,1198,8384
23949,Daphne,Castelin,dcastelinn1@tinyurl.com,Web Developer III,1637,1484,3121
23872,Tonya,Herculson,therculsonn5@yelp.com,Professor,8679,1783,10462
23977,Sybilla,Switsur,sswitsurn6@privacy.gov.au,Sales Associate,7276,1307,8583
23187,Munroe,Bellfield,mbellfieldn7@rediff.com,Teacher,5482,843,6325
23592,Giacobo,Towns,gtownsn8@over-blog.com,VP Product Management,8814,1953,10767
23361,Gwenore,Alexsandrovich,galexsandrovichng@zimbio.com,Computer Systems Analyst IV,1677,1338,3015
23202,Charin,Iwanicki,ciwanickinl@cdc.gov,Human Resources Assistant IV,9368,1702,11070
23209,Brynn,Revening,breveningnm@earthlink.net,Budget/Accounting Analyst IV,8246,1369,9615
23743,Gusty,Paroni,gparoninr@wp.com,Librarian,3582,1496,5078
23954,Gaspard,Pollack,gpollackns@google.it,Quality Control Specialist,7931,1783,9714
23312,Paddie,Armsby,parmsbynt@mozilla.com,Senior Editor,5588,1438,7026
23449,Wendall,Ingledow,wingledownu@cocolog-nifty.com,Quality Engineer,8402,991,9393
23713,Gizela,Pettengell,gpettengellnx@state.tx.us,Health Coach II,2502,719,3221
23457,Glenn,Ballam,gballamny@princeton.edu,Help Desk Technician,7579,1321,8900
23385,Nerty,Santarelli,nsantarellio6@ca.gov,Budget/Accounting Analyst IV,7383,1107,8490
23264,Charlene,Bartlomiejczyk,cbartlomiejczyko7@nhs.uk,Assistant Media Planner,2220,1664,3884
23213,Angelique,Congdon,acongdonoa@scribd.com,Office Assistant III,7101,1016,8117
23297,Clayborn,Braemer,cbraemerob@icio.us,Director of Sales,9399,1005,10404
23436,Kassi,Juste,kjusteoc@patch.com,Community Outreach Specialist,3734,647,4381
23654,Chic,enzley,cenzleyog@shop-pro.jp,Geological Engineer,1612,1057,2669
23116,Ambrosius,Gittis,agittisok@xrea.com,Speech Pathologist,5077,737,5814
23611,Berne,Wenden,bwendenol@arizona.edu,Nurse Practicioner,9841,1914,11755
23768,West,Mayworth,wmayworthom@com.com,Desktop Support Technician,6363,1888,8251
23432,Rafe,McGeraghty,rmcgeraghtyon@angelfire.com,VP Sales,4535,1288,5823
23141,Raquel,Romanet,rromanetoo@163.com,Analyst Programmer,1637,361,1998
23906,Maury,Mitchenson,mmitchensonor@usatoday.com,Technical Writer,2981,289,3270
23256,Dori,Ormonde,dormondeos@alibaba.com,Research Assistant III,9689,1509,11198
23628,Jacquie,Gianolini,jgianoliniou@devhub.com,Recruiter,2591,1889,4480
23025,Ronnie,Galpin,rgalpinov@icq.com,Geologist I,3392,1717,5109
23219,Lief,Lackinton,llackintonp0@unicef.org,Geological Engineer,1400,966,2366
23887,Cammi,Halbord,chalbordp3@java.com,Dental Hygienist,1497,1329,2826
23769,Neron,Wooddisse,nwooddissep4@studiopress.com,Dental Hygienist,6170,1103,7273
23443,Marlin,Ybarra,mybarrap6@ted.com,Account Representative III,7757,1761,9518
23870,Gerty,Creane,gcreanepg@cloudflare.com,Sales Representative,4304,917,5221
23251,Gigi,Seneschal,gseneschalpi@comsenz.com,Quality Control Specialist,5959,358,6317
23014,Janine,Azema,jazemapk@webmd.com,Software Consultant,1465,1882,3347
23415,Hercule,Iorizzi,hiorizzipm@multiply.com,Senior Editor,2318,624,2942
23951,Ronica,Ancell,rancellpn@google.co.jp,Research Associate,6676,1755,8431
23694,Kennie,Olczyk,kolczykpp@tuttocitta.it,Biostatistician IV,3338,906,4244
23130,Letti,Rittelmeyer,lrittelmeyerpq@nsw.gov.au,Help Desk Operator,6339,1811,8150
23190,Alberto,Heinz,aheinzpt@soundcloud.com,Research Assistant III,7857,1482,9339
23225,Rona,Jepps,rjeppspx@netlog.com,Statistician I,1900,938,2838
23650,Barry,Reina,breinapy@tinypic.com,General Manager,6604,1570,8174
23326,Kania,Folliss,kfollissq1@google.nl,Senior Cost Accountant,9965,1918,11883
23597,Erinna,Morrowe,emorroweq6@com.com,Legal Assistant,3161,234,3395
23726,Isadora,Roset,irosetqa@howstuffworks.com,Actuary,5669,834,6503
23614,Alverta,Jursch,ajurschqg@g.co,Human Resources Manager,3870,986,4856
23166,Eugenio,Hayter,ehayterqj@storify.com,Sales Representative,8276,223,8499
23217,Mimi,Danbrook,mdanbrookql@blogs.com,Nuclear Power Engineer,2899,255,3154
23013,Delilah,Twells,dtwellsqu@wisc.edu,Chemical Engineer,3869,1837,5706
23276,Reggie,Caldera,rcalderaqz@artisteer.com,Health Coach IV,2611,1544,4155
23057,Bryan,de Castelain,bdecastelainr2@imageshack.us,Staff Scientist,4536,1231,5767
23703,Ronna,Presnall,rpresnallr3@posterous.com,VP Sales,1531,1796,3327
23333,Tildie,Gulliver,tgulliverr5@devhub.com,Paralegal,1425,1414,2839
23211,Franz,Housbey,fhousbeyr7@purevolume.com,VP Product Management,3723,1775,5498
23821,Lindon,Misson,lmissonra@google.pl,VP Product Management,7809,1464,9273
23440,Maurizia,Kupper,mkupperrc@cornell.edu,Help Desk Technician,3274,514,3788
23718,Constanta,Shortland,cshortlandrd@ox.ac.uk,Technical Writer,4864,1461,6325
23266,Lorenzo,Lewnden,llewndenrf@mediafire.com,Senior Sales Associate,2478,1367,3845
23112,Brigham,Bricksey,bbrickseyrg@fastcompany.com,Senior Financial Analyst,4693,729,5422
23699,Katrinka,Knox,kknoxrh@microsoft.com,Chemical Engineer,2687,1738,4425
23324,Moritz,Conigsby,mconigsbyri@google.com.au,Assistant Manager,3717,1440,5157
23958,Ashla,Chippindall,achippindallrl@yellowpages.com,Account Representative I,5105,1180,6285
23945,Idelle,Jeanin,ijeaninrm@mozilla.com,Cost Accountant,8385,290,8675
23284,Yardley,O'Heffernan,yoheffernanrp@hatena.ne.jp,Software Engineer III,4073,990,5063
24200,Darcey,Causley,dcausley0@arstechnica.com,Technical Writer,1342,1454,2796
24788,Dilan,Gobolos,dgobolos1@shop-pro.jp,Cost Accountant,1938,1358,3296
24798,Nealson,Danshin,ndanshin2@domainmarket.com,GIS Technical Architect,5393,1180,6573
24348,Alistair,Knoller,aknoller3@psu.edu,Environmental Tech,9204,1684,10888
24399,Nappie,Le Provost,nleprovost4@fc2.com,Librarian,3732,665,4397
24762,Madison,Joderli,mjoderli5@china.com.cn,Technical Writer,9748,1952,11700
24188,Eilis,Down,edown6@is.gd,Human Resources Manager,7373,982,8355
24363,Reggie,Deavin,rdeavin7@privacy.gov.au,Data Coordiator,9694,316,10010
24642,Flint,Brunesco,fbrunesco8@jigsy.com,Desktop Support Technician,9061,1234,10295
24086,Lief,Tattersill,ltattersill9@usgs.gov,Research Assistant IV,8113,1741,9854
24263,Pooh,Waszczyk,pwaszczyka@netlog.com,Payment Adjustment Coordinator,9631,1196,10827
24056,Devon,Ryding,drydingb@artisteer.com,Business Systems Development Analyst,7873,1227,9100
24258,Clem,Klyn,cklync@nih.gov,Teacher,2025,1814,3839
24790,Rollin,Blowick,rblowickd@discuz.net,Developer III,4713,1994,6707
24437,Roanna,Parnby,rparnbye@oakley.com,Junior Executive,6923,1016,7939
24974,Penrod,Caras,pcarasf@house.gov,Structural Engineer,8179,1996,10175
24279,Ellis,MacKall,emackallg@xing.com,Director of Sales,2234,1415,3649
24780,Pembroke,Huddlestone,phuddlestoneh@umn.edu,Business Systems Development Analyst,7165,996,8161
24745,Ossie,Rodger,orodgeri@youtu.be,Chemical Engineer,8323,1638,9961
24500,Bebe,Bentham,bbenthamj@usda.gov,VP Sales,5783,1876,7659
24173,Sherilyn,Hovenden,shovendenk@alibaba.com,Analog Circuit Design manager,1760,537,2297
24300,Nichol,Red,nredl@biblegateway.com,Account Representative III,2584,1169,3753
24771,Georgetta,Earingey,gearingeym@constantcontact.com,Developer II,7707,465,8172
24799,Eric,Tolfrey,etolfreyn@macromedia.com,Mechanical Systems Engineer,3963,1329,5292
24010,Callida,Gilvear,cgilvearo@chicagotribune.com,Computer Systems Analyst IV,1565,1537,3102
24637,Abbie,Skayman,askaymanp@taobao.com,Programmer III,8846,1323,10169
24915,Sapphira,Youdell,syoudellq@histats.com,Graphic Designer,2903,1821,4724
24286,Pippo,O'Glassane,poglassaner@i2i.jp,Structural Analysis Engineer,8218,1304,9522
24749,Virginia,Armstrong,varmstrongs@imgur.com,Developer IV,8739,1616,10355
24757,Ines,Gather,igathert@disqus.com,Health Coach I,9363,1154,10517
24868,Roy,Poltone,rpoltoneu@facebook.com,Paralegal,4243,672,4915
24458,Emylee,Berthelet,ebertheletv@ocn.ne.jp,Financial Analyst,9044,1944,10988
24139,Bent,MacCracken,bmaccrackenw@a8.net,Junior Executive,3172,258,3430
24929,Irena,Caveau,icaveaux@godaddy.com,Mechanical Systems Engineer,6339,1012,7351
24464,Kari,Karpinski,kkarpinskiy@thetimes.co.uk,Staff Scientist,3240,1188,4428
24362,Agosto,Couroy,acouroyz@unc.edu,Software Consultant,9715,548,10263
24398,Jobi,O'Sesnane,josesnane10@google.com,Research Associate,7718,1495,9213
24379,Rivy,Heare,rheare11@is.gd,Financial Advisor,5951,1588,7539
24812,Luella,Naismith,lnaismith12@chron.com,Senior Cost Accountant,3106,699,3805
24584,Sutton,Kerman,skerman13@wp.com,Executive Secretary,8878,1771,10649
24888,Krystyna,Grellis,kgrellis14@oracle.com,Geological Engineer,8316,870,9186
24531,Edi,Chawner,echawner15@t.co,Help Desk Technician,4637,1830,6467
24980,Emmaline,Cobain,ecobain16@tripadvisor.com,Analog Circuit Design manager,6558,1208,7766
24886,Shurwood,Lethem,slethem17@amazonaws.com,Geologist IV,1506,654,2160
24639,Valentine,Evershed,vevershed18@paypal.com,Senior Financial Analyst,3256,1164,4420
24154,Reinold,Di Dello,rdidello1a@youtu.be,Recruiter,4413,659,5072
24730,Danika,Gunson,dgunson1b@bluehost.com,Developer III,1206,1138,2344
24261,Janella,Wrightham,jwrightham1c@sakura.ne.jp,Budget/Accounting Analyst IV,8458,1475,9933
24052,Silvana,Blant,sblant1d@unc.edu,Tax Accountant,7652,1135,8787
24902,Jephthah,Whittenbury,jwhittenbury1e@engadget.com,Data Coordiator,2388,1190,3578
24951,Bryanty,Iacovucci,biacovucci1f@cbsnews.com,Teacher,4940,1800,6740
24877,Simone,Shrimplin,sshrimplin1g@europa.eu,Software Consultant,1414,1574,2988
24209,Dacey,Klimentov,dklimentov1h@usgs.gov,GIS Technical Architect,9467,1825,11292
24383,Tina,Ingamells,tingamells1i@etsy.com,Cost Accountant,7892,504,8396
24870,Greta,Grason,ggrason1j@goo.gl,Financial Analyst,1203,430,1633
24775,Malvina,Siemandl,msiemandl1k@house.gov,Senior Financial Analyst,9491,1393,10884
24378,Pat,Dring,pdring1l@miibeian.gov.cn,Web Developer IV,6245,834,7079
24498,Alejandra,Cran,acran1m@yellowbook.com,Financial Analyst,9419,504,9923
24546,Brianna,McDougald,bmcdougald1n@nyu.edu,Administrative Assistant III,1791,1080,2871
24603,Tim,Tippetts,ttippetts1p@ebay.com,Project Manager,9295,292,9587
24140,Erinn,Forsythe,eforsythe1q@cisco.com,Professor,5260,1484,6744
24269,Gwendolyn,Sopp,gsopp1r@amazon.com,Programmer II,1603,822,2425
24751,Darice,Sissel,dsissel1s@hhs.gov,Safety Technician IV,5547,1411,6958
24019,Garey,Chadburn,gchadburn1t@mashable.com,Actuary,1875,1014,2889
24423,Nealy,Hebner,nhebner1u@businessinsider.com,Professor,9353,1563,10916
24121,Blane,Iannuzzi,biannuzzi1v@gov.uk,Assistant Professor,9620,805,10425
24607,Judie,Little,jlittle1w@businessinsider.com,VP Quality Control,7679,1387,9066
24692,Winnifred,Eaklee,weaklee1x@cbsnews.com,Programmer Analyst IV,5135,355,5490
24246,Ash,Vasenkov,avasenkov1y@cyberchimps.com,Administrative Officer,3515,1945,5460
24446,Ilaire,Wraggs,iwraggs1z@newsvine.com,Safety Technician I,6402,1680,8082
24085,Reginald,Armin,rarmin20@free.fr,Statistician II,1206,883,2089
24744,Freida,Merrall,fmerrall21@hp.com,Geologist II,1683,1252,2935
24585,Lizbeth,Skyppe,lskyppe22@behance.net,Social Worker,5447,445,5892
24441,Cristiano,Felstead,cfelstead23@dropbox.com,Design Engineer,4746,1513,6259
24501,Dulcinea,Hischke,dhischke24@reuters.com,Tax Accountant,7736,322,8058
24276,Tripp,Slayny,tslayny25@cornell.edu,Sales Representative,3404,1973,5377
24105,Jesselyn,Hearley,jhearley26@blogger.com,Accounting Assistant II,2030,737,2767
24133,Trace,Kubicka,tkubicka27@marketwatch.com,Assistant Professor,7494,807,8301
24266,Sanders,Walisiak,swalisiak28@xinhuanet.com,Software Test Engineer I,8268,1165,9433
24293,Reggy,Vittet,rvittet29@sfgate.com,Nuclear Power Engineer,5200,533,5733
24583,Layney,Samweyes,lsamweyes2b@pagesperso-orange.fr,Research Nurse,4671,477,5148
24826,Berkley,Attrey,battrey2d@diigo.com,Web Developer III,8496,1487,9983
24989,Rene,Cockshott,rcockshott2e@salon.com,Nurse Practicioner,7468,370,7838
24504,Thacher,Galler,tgaller2f@mashable.com,Web Designer II,4467,1698,6165
24132,Nance,Wickwar,nwickwar2g@npr.org,Database Administrator IV,1057,523,1580
24803,George,Aldington,galdington2h@cyberchimps.com,Technical Writer,2180,355,2535
24020,Cullin,O'Cannavan,cocannavan2i@bloglines.com,Business Systems Development Analyst,8919,1295,10214
24406,Gabe,Pero,gpero2j@webnode.com,Research Associate,5524,1125,6649
24621,Wood,Juschka,wjuschka2k@moonfruit.com,Compensation Analyst,7195,1717,8912
24934,Stern,Uff,suff2l@google.com.br,Financial Advisor,5407,827,6234
24454,Cissiee,Basley,cbasley2m@list-manage.com,Social Worker,2035,1851,3886
24898,Herrick,Packham,hpackham2n@pbs.org,Product Engineer,4674,516,5190
24983,Hank,Domini,hdomini2o@1und1.de,Chief Design Engineer,1651,1146,2797
24397,Tracy,Putland,tputland2p@msn.com,Systems Administrator I,8338,1379,9717
24120,Myrwyn,Grigg,mgrigg2q@google.com.br,Programmer II,4150,1875,6025
24624,Harald,Francesco,hfrancesco2r@rediff.com,Accountant III,9514,1110,10624
24820,Kyle,Iacomi,kiacomi2s@java.com,Geological Engineer,2799,765,3564
24325,Lorita,Boodle,lboodle2u@privacy.gov.au,Engineer III,4213,643,4856
24109,Aubrie,Kezourec,akezourec2v@biblegateway.com,VP Product Management,4470,776,5246
24694,Germain,Timmins,gtimmins2w@chron.com,Speech Pathologist,1482,935,2417
24156,Gerrie,Josupeit,gjosupeit2x@homestead.com,Marketing Assistant,9766,1659,11425
24919,Rollins,Finney,rfinney2y@cargocollective.com,Pharmacist,8931,571,9502
24927,Augustin,O'Logan,aologan2z@accuweather.com,GIS Technical Architect,9468,1479,10947
24465,Dael,Kalaher,dkalaher30@redcross.org,Civil Engineer,5854,566,6420
24384,Paton,Artrick,partrick31@posterous.com,Speech Pathologist,7160,506,7666
24345,Basile,Corps,bcorps32@cisco.com,Internal Auditor,2727,1609,4336
24710,Gavrielle,Rosenthaler,grosenthaler34@comcast.net,Programmer Analyst II,1488,870,2358
24163,Dur,Barkly,dbarkly35@howstuffworks.com,Legal Assistant,2940,1046,3986
24988,Billy,Kydde,bkydde37@miitbeian.gov.cn,Biostatistician II,1426,472,1898
24848,Bay,Thornbarrow,bthornbarrow38@lulu.com,Senior Financial Analyst,9415,1626,11041
24545,Lynett,Fildes,lfildes39@elpais.com,Recruiting Manager,3000,1488,4488
24006,Velma,Asquez,vasquez3a@symantec.com,Information Systems Manager,8661,1377,10038
24924,Riane,Banisch,rbanisch3b@senate.gov,Automation Specialist I,3399,204,3603
24579,Tybi,Klais,tklais3c@etsy.com,Food Chemist,1362,1176,2538
24920,Sanders,Noke,snoke3d@artisteer.com,Senior Developer,8390,1979,10369
24190,Gard,Davies,gdavies3e@bravesites.com,Occupational Therapist,4675,1118,5793
24912,Faythe,Taylot,ftaylot3f@sfgate.com,Physical Therapy Assistant,7546,816,8362
24970,Yardley,Aslie,yaslie3g@shop-pro.jp,Graphic Designer,9984,371,10355
24011,Jori,Gwalter,jgwalter3h@boston.com,Legal Assistant,4138,833,4971
24253,Jordon,Dovey,jdovey3i@goo.ne.jp,Business Systems Development Analyst,7784,1807,9591
24335,Joanna,Sheerin,jsheerin3j@netvibes.com,Civil Engineer,2434,1569,4003
24502,Putnem,O'Lenane,polenane3k@usda.gov,Chemical Engineer,1210,1462,2672
24743,Artair,Close,aclose3l@usgs.gov,Engineer III,9065,1486,10551
24100,Melodie,Curgenuer,mcurgenuer3m@army.mil,Financial Advisor,7022,1617,8639
24469,Suki,Canet,scanet3n@blogtalkradio.com,Project Manager,9466,1538,11004
24242,Harmon,Stanhope,hstanhope3o@telegraph.co.uk,Automation Specialist I,8127,1801,9928
24249,Brnaby,Ambroziak,bambroziak3r@cnbc.com,Cost Accountant,4438,1391,5829
24199,Alyssa,de Werk,adewerk3s@dion.ne.jp,Staff Accountant I,7507,1830,9337
24698,Paddie,Gaw,pgaw3u@e-recht24.de,Nurse Practicioner,3513,1129,4642
24906,Breanne,Luxford,bluxford3v@washingtonpost.com,Editor,6214,1139,7353
24630,Willie,Hawyes,whawyes3w@ftc.gov,Electrical Engineer,4170,1935,6105
24689,Hedy,Balmforth,hbalmforth3y@dailymotion.com,Biostatistician I,1930,648,2578
24480,Flori,Daburn,fdaburn3z@scribd.com,VP Quality Control,7712,651,8363
24748,Norine,Reedshaw,nreedshaw40@ovh.net,Human Resources Assistant III,6564,284,6848
24235,Sidonnie,Vasyutochkin,svasyutochkin41@timesonline.co.uk,Account Representative I,2348,1689,4037
24718,Olympia,Le Brum,olebrum42@apple.com,VP Quality Control,5595,786,6381
24859,Celisse,Shank,cshank43@dailymotion.com,Financial Analyst,3805,1889,5694
24334,Evyn,McGaughey,emcgaughey44@independent.co.uk,Account Coordinator,6501,1368,7869
24093,Missy,Le Gallo,mlegallo45@abc.net.au,Senior Developer,2892,879,3771
24224,Ivan,Janson,ijanson46@ox.ac.uk,Professor,8683,1577,10260
24493,Sharon,Rickardes,srickardes47@purevolume.com,VP Accounting,1787,862,2649
24218,Gerry,Losty,glosty48@alibaba.com,Dental Hygienist,1049,221,1270
24027,Ingram,Hinchcliffe,ihinchcliffe4a@vkontakte.ru,Recruiting Manager,5956,1368,7324
24299,Appolonia,Grane,agrane4b@fastcompany.com,Structural Analysis Engineer,7982,2000,9982
24823,Evan,Hacking,ehacking4c@nhs.uk,Professor,7486,1333,8819
24839,Alexio,Steventon,asteventon4d@yelp.com,Registered Nurse,8063,1647,9710
24197,Penny,Tupper,ptupper4e@ucla.edu,Senior Sales Associate,1466,1464,2930
24434,Erminia,Pittman,epittman4f@answers.com,Account Coordinator,9236,1779,11015
24661,Joelly,Yousef,jyousef4h@howstuffworks.com,Web Developer IV,4609,210,4819
24672,Elle,Sapwell,esapwell4i@smh.com.au,Geological Engineer,8312,1170,9482
24047,Kenyon,Anyon,kanyon4k@friendfeed.com,Business Systems Development Analyst,5607,262,5869
24238,Chrystel,Francey,cfrancey4m@opensource.org,Accounting Assistant III,2291,1134,3425
24330,Matilde,Terron,mterron4n@sphinn.com,Help Desk Technician,4711,1484,6195
24534,Allegra,Harnes,aharnes4o@answers.com,Office Assistant II,8004,1607,9611
24126,Enrica,Bootherstone,ebootherstone4p@noaa.gov,Junior Executive,1627,1201,2828
24946,Emelyne,Brisbane,ebrisbane4q@t-online.de,Research Assistant III,8677,815,9492
24573,Talbot,Kellitt,tkellitt4r@flickr.com,Budget/Accounting Analyst I,3263,1365,4628
24517,Devonne,Panas,dpanas4u@opensource.org,Associate Professor,5725,1897,7622
24433,Lynnett,Boone,lboone4x@springer.com,Systems Administrator IV,1042,1171,2213
24580,Dunc,Phlippsen,dphlippsen4y@admin.ch,Junior Executive,1003,1183,2186
24807,Samson,Soughton,ssoughton4z@blog.com,Chief Design Engineer,2029,932,2961
24737,Philipa,Baber,pbaber50@webnode.com,Environmental Tech,7789,1745,9534
24481,Dita,Bratton,dbratton51@wisc.edu,Nurse Practicioner,2989,652,3641
24566,Corly,Kerner,ckerner52@geocities.com,Junior Executive,6988,330,7318
24963,Aline,Gierardi,agierardi53@sourceforge.net,Analog Circuit Design manager,6119,335,6454
24112,Dimitry,Odlin,dodlin54@nyu.edu,Staff Accountant IV,5483,1237,6720
24765,Annice,Waeland,awaeland55@state.tx.us,Senior Quality Engineer,8350,330,8680
24662,Lane,Sudell,lsudell56@istockphoto.com,Nurse,8681,454,9135
24911,Sergio,Salvadori,ssalvadori57@so-net.ne.jp,Software Test Engineer II,5603,275,5878
24193,Lanae,Masding,lmasding58@usgs.gov,Executive Secretary,9142,864,10006
24589,Brittney,Carverhill,bcarverhill59@bravesites.com,Web Designer IV,7333,1610,8943
24701,Edyth,Connachan,econnachan5a@blogger.com,Technical Writer,5713,425,6138
24854,Ethe,Bumphrey,ebumphrey5c@freewebs.com,VP Accounting,8688,684,9372
24636,Schuyler,Guilloux,sguilloux5d@ezinearticles.com,Nurse,8814,977,9791
24999,Ethel,Grzelczyk,egrzelczyk5e@goo.ne.jp,Software Consultant,6788,1792,8580
24435,Daile,Kelledy,dkelledy5g@independent.co.uk,Programmer Analyst I,5227,539,5766
24879,Angele,Elcoat,aelcoat5i@virginia.edu,Recruiter,8389,526,8915
24900,Carlin,Simkiss,csimkiss5j@weather.com,VP Quality Control,4659,217,4876
24155,Nap,Plain,nplain5l@usgs.gov,Accounting Assistant II,2300,1880,4180
24280,Corine,Eles,celes5m@blogspot.com,Sales Representative,4200,381,4581
24118,Deloria,Ast,dast5n@qq.com,Nurse,3074,476,3550
24003,Amery,Tammadge,atammadge5o@webnode.com,Information Systems Manager,5902,756,6658
24759,Olly,Ridley,oridley5p@weebly.com,Research Associate,6788,1771,8559
24265,Duff,Sadry,dsadry5q@360.cn,Legal Assistant,5153,1306,6459
24549,Edlin,Gilluley,egilluley5r@smh.com.au,Design Engineer,1700,1712,3412
24587,Kyla,Storr,kstorr5u@twitpic.com,Account Coordinator,6025,1409,7434
24969,Xena,Willmot,xwillmot5v@indiatimes.com,Social Worker,5102,236,5338
24851,Bayard,Caile,bcaile5w@360.cn,Research Nurse,6256,1290,7546
24040,Prudi,Tremoille,ptremoille5x@ocn.ne.jp,Electrical Engineer,8263,877,9140
24405,Neal,Griston,ngriston5y@addtoany.com,Registered Nurse,3767,861,4628
24342,Booth,Croot,bcroot5z@geocities.com,Senior Sales Associate,6978,384,7362
24403,Dannel,Wallwork,dwallwork60@usda.gov,Associate Professor,7992,1634,9626
24954,Roslyn,Heddan,rheddan61@dropbox.com,Payment Adjustment Coordinator,1465,419,1884
24134,Dov,Stuckey,dstuckey62@ucoz.ru,VP Quality Control,2287,720,3007
24455,Cammi,Parncutt,cparncutt66@51.la,Senior Financial Analyst,8825,959,9784
24065,Izzy,Rathmell,irathmell67@etsy.com,Administrative Officer,9220,671,9891
24198,Nance,Garner,ngarner68@home.pl,Assistant Manager,8486,1278,9764
24380,Nels,Champneys,nchampneys69@liveinternet.ru,VP Quality Control,6061,1680,7741
24727,Catriona,Rubee,crubee6a@howstuffworks.com,Director of Sales,1049,1090,2139
24895,Van,Gentreau,vgentreau6b@google.nl,Speech Pathologist,7935,1492,9427
24716,Brnaby,Veracruysse,bveracruysse6c@seattletimes.com,Accountant II,9928,532,10460
24586,Ethyl,Beardmore,ebeardmore6f@goo.ne.jp,Nuclear Power Engineer,1196,847,2043
24993,Jordanna,Petracchi,jpetracchi6g@hibu.com,Accounting Assistant II,5487,588,6075
24450,Ram,Alven,ralven6h@fema.gov,Software Consultant,7729,1123,8852
24049,Dacey,Kettlestringes,dkettlestringes6i@who.int,Safety Technician III,8570,1949,10519
24633,Mollee,Adhams,madhams6j@vk.com,Electrical Engineer,2343,380,2723
24254,Hi,Baignard,hbaignard6k@businessinsider.com,Assistant Media Planner,6543,500,7043
24956,Sidonia,Becken,sbecken6l@cnet.com,Account Executive,2039,1997,4036
24161,Doyle,Vellender,dvellender6m@icio.us,Registered Nurse,4309,1523,5832
24568,Bidget,McOnie,bmconie6n@cmu.edu,Payment Adjustment Coordinator,4008,1743,5751
24421,Blanca,Bissell,bbissell6o@wordpress.com,Senior Financial Analyst,5327,1639,6966
24657,Paco,Bartel,pbartel6p@privacy.gov.au,Financial Analyst,2697,1896,4593
24913,Carita,Hugill,chugill6u@blog.com,Social Worker,9467,473,9940
24053,Miran,Batrop,mbatrop6w@gizmodo.com,Structural Analysis Engineer,6968,511,7479
24613,Rainer,Awton,rawton6x@ihg.com,Librarian,1937,984,2921
24572,Georgianne,Osmund,gosmund6y@microsoft.com,Marketing Manager,7891,487,8378
24819,Thedrick,Klimontovich,tklimontovich6z@mapquest.com,Statistician IV,4751,778,5529
24548,Brandi,Allsepp,ballsepp70@weibo.com,Cost Accountant,8891,510,9401
24863,Obidiah,Alentyev,oalentyev71@reuters.com,Research Assistant I,6521,1269,7790
24938,Alfy,Kringe,akringe72@technorati.com,VP Product Management,3019,1140,4159
24930,Silvanus,Jan,sjan73@jiathis.com,Help Desk Operator,9701,1745,11446
24389,Bordie,Sealand,bsealand74@umich.edu,Analog Circuit Design manager,4106,1278,5384
24206,Nolan,Quibell,nquibell75@prlog.org,Desktop Support Technician,2480,1095,3575
24350,Ursala,Stroband,ustroband77@hatena.ne.jp,Assistant Professor,8298,1410,9708
24041,Sarajane,Bendig,sbendig78@so-net.ne.jp,Staff Accountant II,8656,1617,10273
24466,Raffarty,Taleworth,rtaleworth79@google.com.au,Statistician III,1358,1646,3004
24786,Charity,Desmond,cdesmond7a@ebay.com,Tax Accountant,9236,1065,10301
24543,Gracia,Jamieson,gjamieson7b@cbc.ca,Structural Analysis Engineer,2060,1696,3756
24331,Franklyn,Trafford,ftrafford7c@mapy.cz,Marketing Manager,9683,962,10645
24102,Duffy,Palfree,dpalfree7d@ucla.edu,Editor,9336,1550,10886
24432,Shurlock,Gersam,sgersam7e@theglobeandmail.com,Systems Administrator IV,2112,1233,3345
24145,Chere,Cunney,ccunney7f@unblog.fr,Assistant Media Planner,2430,1626,4056
24978,Merrilee,Celez,mcelez7g@youku.com,Actuary,4906,792,5698
24228,Raquel,Poinsett,rpoinsett7h@aol.com,Accountant IV,1822,1435,3257
24451,Franny,Hinsche,fhinsche7i@typepad.com,Project Manager,5611,967,6578
24070,Shanon,Malacrida,smalacrida7j@sfgate.com,Human Resources Manager,2354,1045,3399
24725,Crawford,Fibbitts,cfibbitts7l@weibo.com,VP Marketing,9544,1050,10594
24251,Lucienne,Brookwood,lbrookwood7n@amazonaws.com,VP Quality Control,4268,241,4509
24723,Kingsley,Gonnel,kgonnel7o@vimeo.com,Cost Accountant,6021,1136,7157
24539,Angelo,Wadie,awadie7p@cisco.com,Office Assistant II,4967,1004,5971
24473,Vivianne,Fandrey,vfandrey7r@princeton.edu,Quality Control Specialist,4564,1778,6342
24967,Gun,Filyakov,gfilyakov7s@sciencedaily.com,Marketing Assistant,2886,876,3762
24479,Ned,Elliman,nelliman7t@nymag.com,Compensation Analyst,7856,1066,8922
24575,Federico,Goodacre,fgoodacre7u@cbc.ca,Research Assistant IV,5631,1524,7155
24401,Dulci,Ansley,dansley7v@youku.com,Pharmacist,6663,1313,7976
24211,Maureene,Janaszkiewicz,mjanaszkiewicz7w@telegraph.co.uk,Senior Cost Accountant,4217,1634,5851
24650,Kendra,Widdicombe,kwiddicombe7x@tinypic.com,Junior Executive,7228,1998,9226
24143,Lennard,Tawse,ltawse7z@chron.com,Budget/Accounting Analyst III,2670,202,2872
24685,Mel,Yannikov,myannikov80@nydailynews.com,Automation Specialist IV,6084,1180,7264
24257,Alvina,Munday,amunday81@china.com.cn,Analog Circuit Design manager,7457,1140,8597
24327,Ted,Eleshenar,teleshenar82@mac.com,Account Representative I,3640,933,4573
24849,Wilhelmine,Mayte,wmayte83@last.fm,Web Designer I,1559,799,2358
24768,Mercy,Wayte,mwayte84@wired.com,VP Product Management,1141,1743,2884
24878,Paddy,Voas,pvoas85@drupal.org,Systems Administrator II,2996,813,3809
24623,Shellie,Treen,streen87@reverbnation.com,Budget/Accounting Analyst III,2545,1106,3651
24472,Calley,Wyse,cwyse88@geocities.jp,Budget/Accounting Analyst II,3605,1753,5358
24277,Pooh,Keeling,pkeeling89@independent.co.uk,Electrical Engineer,1163,1396,2559
24294,Herold,Minchinton,hminchinton8a@blogs.com,Professor,7705,1263,8968
24894,Khalil,Gallaccio,kgallaccio8b@springer.com,Community Outreach Specialist,6778,1942,8720
24425,Elset,Powner,epowner8e@bing.com,Geologist I,3359,692,4051
24494,Raquela,Ordidge,rordidge8f@sourceforge.net,Food Chemist,7138,484,7622
24340,Violetta,Baccup,vbaccup8g@dmoz.org,Electrical Engineer,5348,478,5826
24322,Rozelle,Chevers,rchevers8i@jugem.jp,VP Product Management,5059,1739,6798
24272,Manon,Phillimore,mphillimore8l@wix.com,Research Assistant II,8605,766,9371
24514,Mayer,Fritschmann,mfritschmann8m@seattletimes.com,Sales Representative,3708,599,4307
24304,Melicent,Butson,mbutson8o@weather.com,Data Coordiator,2708,253,2961
24576,Cristina,Josephi,cjosephi8p@psu.edu,Web Developer III,4423,751,5174
24735,Kinsley,Toohey,ktoohey8r@symantec.com,Developer III,4412,996,5408
24007,Harmonia,Sycamore,hsycamore8s@europa.eu,Executive Secretary,7427,1947,9374
24663,Bili,Dorrington,bdorrington8t@latimes.com,Geological Engineer,6527,904,7431
24764,Leila,Cockshoot,lcockshoot8u@mysql.com,Assistant Manager,4487,1279,5766
24158,Nicoli,Jump,njump8v@ask.com,Paralegal,6719,1993,8712
24267,Judi,Catford,jcatford8x@reuters.com,Software Consultant,4098,1196,5294
24761,Berna,Kenvin,bkenvin8y@va.gov,Operator,7529,1349,8878
24066,Rosaline,Lesek,rlesek8z@instagram.com,Editor,9787,1765,11552
24477,Lona,Spary,lspary90@mlb.com,Web Designer IV,3513,1668,5181
24009,Symon,Ranshaw,sranshaw91@symantec.com,Software Test Engineer III,6269,1888,8157
24614,Morna,Viste,mviste92@mashable.com,Human Resources Assistant I,4942,1175,6117
24396,Abramo,Scrowston,ascrowston93@ibm.com,Software Engineer I,6533,1994,8527
24314,Cassandry,Lawlings,clawlings95@fastcompany.com,Speech Pathologist,4502,1364,5866
24262,Daniele,Drable,ddrable97@unblog.fr,Web Developer III,3760,553,4313
24229,Gae,Jemmett,gjemmett9a@whitehouse.gov,Environmental Tech,3370,342,3712
24627,Ileane,Grigoryov,igrigoryov9c@topsy.com,Account Coordinator,2700,648,3348
24742,Reinhold,Pesselt,rpesselt9d@naver.com,Senior Cost Accountant,5116,1650,6766
24933,Myrtice,Hritzko,mhritzko9f@free.fr,Mechanical Systems Engineer,4953,1059,6012
24982,D'arcy,Bambrugh,dbambrugh9g@virginia.edu,Professor,6711,1116,7827
24795,Leoine,Tooth,ltooth9h@wikipedia.org,Mechanical Systems Engineer,3928,731,4659
24413,Wadsworth,Sloey,wsloey9i@oakley.com,Software Engineer I,6619,352,6971
24167,Faulkner,Manjot,fmanjot9k@smh.com.au,Desktop Support Technician,5582,782,6364
24552,Vivianna,Loding,vloding9l@aboutads.info,Teacher,9978,1595,11573
24674,Iosep,Blaxill,iblaxill9m@goodreads.com,Research Nurse,2586,1527,4113
24677,Mauricio,Blain,mblain9o@ftc.gov,Research Assistant II,8960,614,9574
24715,August,Crocket,acrocket9p@google.cn,Project Manager,9063,1755,10818
24365,Sidoney,Flooks,sflooks9q@mtv.com,Software Engineer II,1625,1175,2800
24216,Kandace,Rewan,krewan9r@technorati.com,Marketing Assistant,3136,322,3458
24873,Denis,Swafford,dswafford9s@about.me,Account Coordinator,6230,243,6473
24440,Horst,Grealey,hgrealey9t@china.com.cn,Assistant Media Planner,2339,1607,3946
24644,Glynis,Tangye,gtangye9u@so-net.ne.jp,Librarian,6756,1164,7920
24489,Cammie,Sherborn,csherborn9w@slideshare.net,Account Representative II,3899,1050,4949
24303,Brianna,Gierck,bgiercka0@twitter.com,Human Resources Manager,2548,1916,4464
24656,Brander,Cullon,bcullona1@sciencedirect.com,Staff Scientist,1751,1808,3559
24588,Lisabeth,Ramey,lrameya2@ucla.edu,Software Engineer I,2281,714,2995
24682,Matthias,Dainter,mdaintera4@marketwatch.com,VP Product Management,3974,821,4795
24439,Donica,Gravey,dgraveya6@miitbeian.gov.cn,Paralegal,4121,271,4392
24619,Gaby,Botfield,gbotfielda7@thetimes.co.uk,Administrative Officer,1009,931,1940
24135,Margit,Rocks,mrocksa8@wix.com,Actuary,2187,1107,3294
24043,Shaylynn,Mapam,smapama9@ifeng.com,Actuary,7423,1431,8854
24871,Free,Kamall,fkamallaa@mediafire.com,Civil Engineer,5797,1574,7371
24578,Angie,Joanaud,ajoanaudab@biglobe.ne.jp,Clinical Specialist,8865,1644,10509
24567,Joli,Tidbold,jtidboldad@photobucket.com,Senior Quality Engineer,3155,907,4062
24979,Clara,Munson,cmunsonaf@ebay.co.uk,Financial Analyst,3143,689,3832
24046,Rakel,Verdy,rverdyai@cafepress.com,Technical Writer,6530,625,7155
24696,Daloris,Lightwing,dlightwingaj@samsung.com,Sales Representative,8821,1612,10433
24882,Helen,Busk,hbuskak@bbb.org,Design Engineer,9188,573,9761
24858,Riannon,Gundrey,rgundreyan@purevolume.com,Structural Engineer,4131,1629,5760
24388,Allister,Hansley,ahansleyao@unblog.fr,Research Nurse,6346,1891,8237
24463,Rahal,Bennough,rbennoughap@google.fr,Nurse,2818,1443,4261
24990,Natty,Lakes,nlakesaq@comcast.net,Human Resources Manager,2418,1680,4098
24676,Harbert,Aprahamian,haprahamianar@mac.com,Safety Technician III,7740,1351,9091
24681,Adeline,Langcaster,alangcasteras@google.co.uk,Community Outreach Specialist,3294,1493,4787
24344,Ines,Yuryaev,iyuryaevat@walmart.com,Programmer I,7949,684,8633
24778,Etheline,Rolinson,erolinsonau@angelfire.com,Actuary,1201,595,1796
24829,Matilda,Bobasch,mbobaschax@topsy.com,Structural Analysis Engineer,3879,1503,5382
24308,Appolonia,Lannin,alanninay@google.com,Payment Adjustment Coordinator,9964,1971,11935
24811,Editha,Redit,ereditaz@canalblog.com,Speech Pathologist,6289,579,6868
24903,Angelico,Conring,aconringb0@youtu.be,Actuary,9926,1445,11371
24510,Massimo,Di Gregorio,mdigregoriob3@yellowpages.com,Editor,2209,492,2701
24885,Conant,Fonzone,cfonzoneb4@usnews.com,Assistant Professor,1464,779,2243
24869,Kaylil,Cousin,kcousinb6@addthis.com,Compensation Analyst,9293,1562,10855
24077,Park,Crayke,pcraykeb8@paginegialle.it,Research Associate,5188,1294,6482
24476,Poppy,Gheraldi,pgheraldiba@twitter.com,GIS Technical Architect,9566,1503,11069
24207,Gelya,Gantzman,ggantzmanbb@google.com,Data Coordiator,8054,1083,9137
24386,Rorie,Wavell,rwavellbc@oracle.com,Analyst Programmer,9880,1009,10889
24310,Dennet,Way,dwaybe@fda.gov,Speech Pathologist,6993,975,7968
24960,Vivianne,Newns,vnewnsbg@samsung.com,Health Coach I,2546,1327,3873
24647,Jessie,Bathowe,jbathowebh@newsvine.com,Senior Editor,2785,395,3180
24767,Rheba,Maffiotti,rmaffiottibk@bandcamp.com,Executive Secretary,5098,1113,6211
24640,Mathilde,Menhci,mmenhcibm@nasa.gov,General Manager,2569,1702,4271
24343,Alric,Filler,afillerbn@gizmodo.com,Structural Analysis Engineer,2781,583,3364
24874,Harlie,MacLleese,hmaclleesebo@vinaora.com,Dental Hygienist,8151,891,9042
24805,Lawton,Rhymes,lrhymesbq@virginia.edu,Media Manager II,2618,1335,3953
24157,Godwin,Mawdsley,gmawdsleybr@samsung.com,Assistant Manager,8771,1342,10113
24782,Lissy,McJury,lmcjurybt@godaddy.com,Paralegal,9496,1660,11156
24084,Collie,Fidilis,cfidilisbu@npr.org,Social Worker,8661,368,9029
24541,Neilla,Castletine,ncastletinebv@ucla.edu,Human Resources Assistant III,6328,1635,7963
24615,Odey,Hairyes,ohairyesbw@samsung.com,Account Executive,2854,1451,4305
24057,Yule,Jorger,yjorgerbx@google.de,Senior Quality Engineer,3013,327,3340
24045,Grant,Epton,geptonby@deviantart.com,Occupational Therapist,3440,1056,4496
24738,Tybi,Foxley,tfoxleybz@indiatimes.com,Senior Developer,4773,261,5034
24958,Felicio,Siehard,fsiehardc0@irs.gov,Structural Engineer,9007,1462,10469
24372,Alfred,Greenman,agreenmanc1@last.fm,Office Assistant I,7129,811,7940
24298,Tabby,Feander,tfeanderc3@cornell.edu,Mechanical Systems Engineer,9015,483,9498
24488,Benito,Pomfrey,bpomfreyc4@smh.com.au,Software Engineer II,7373,601,7974
24910,Priscella,Towey,ptoweyc9@auda.org.au,Design Engineer,8645,837,9482
24312,Jacquelin,Jeffreys,jjeffreysca@desdev.cn,Administrative Assistant I,5329,457,5786
24645,Marlie,Dewerson,mdewersoncb@umn.edu,Accounting Assistant IV,2031,531,2562
24078,Alvinia,Chambers,achamberscc@utexas.edu,Developer I,6372,1032,7404
24581,Ilsa,Youens,iyouensce@github.io,Assistant Professor,2816,1824,4640
24148,Morrie,Rangle,mranglecg@prnewswire.com,Assistant Professor,2861,894,3755
24923,Delphinia,Watman,dwatmanch@amazon.co.uk,Office Assistant I,6005,1763,7768
24022,Jillane,Moors,jmoorsci@vistaprint.com,Project Manager,4548,277,4825
24591,Lemuel,Suddick,lsuddickcj@comsenz.com,Systems Administrator IV,8759,621,9380
24776,Jaymee,Whitebrook,jwhitebrookcm@mlb.com,Developer I,3940,1105,5045
24518,Querida,Pragnell,qpragnellco@amazon.co.uk,Accounting Assistant I,9141,324,9465
24370,Pia,Shaefer,pshaefercr@adobe.com,Tax Accountant,9865,1585,11450
24333,Raynard,Eate,reatecs@opera.com,Programmer Analyst IV,5013,242,5255
24883,Giles,Magnus,gmagnusct@altervista.org,Statistician III,6897,488,7385
24347,Gerianna,Thurstan,gthurstancv@imdb.com,Dental Hygienist,4008,855,4863
24597,Michaela,Hicklingbottom,mhicklingbottomcw@washingtonpost.com,Operator,8301,735,9036
24617,Darcey,Poacher,dpoachercx@wiley.com,Legal Assistant,5490,1489,6979
24837,Paola,Giacopazzi,pgiacopazzid0@sakura.ne.jp,Assistant Media Planner,1955,590,2545
24072,Tami,Hamsher,thamsherd1@europa.eu,Marketing Manager,8605,903,9508
24219,Tiertza,Orpen,torpend2@123-reg.co.uk,Senior Financial Analyst,2070,2000,4070
24196,Perrine,Rontsch,prontschd3@arizona.edu,Geological Engineer,5307,208,5515
24001,Sherrie,Edelheid,sedelheidd4@unc.edu,Data Coordiator,4244,1878,6122
24234,Krispin,Tomicki,ktomickid6@latimes.com,VP Product Management,5857,1029,6886
24168,Silvanus,Chetwind,schetwindd7@umn.edu,VP Marketing,4286,1993,6279
24949,Leslie,Baughan,lbaughand8@amazon.com,Operator,4323,551,4874
24752,Linda,Arnley,larnleyd9@google.ca,Speech Pathologist,1206,1709,2915
24034,Forester,Hue,fhueda@taobao.com,Clinical Specialist,5555,1601,7156
24402,Birk,Winters,bwintersdc@slashdot.org,Account Coordinator,3640,204,3844
24753,Gerard,Andrault,gandraultdd@instagram.com,Legal Assistant,4699,1444,6143
24964,Pyotr,Saffer,psafferdf@dedecms.com,Environmental Tech,5743,1378,7121
24116,Roana,Benedito,rbeneditodg@privacy.gov.au,Nuclear Power Engineer,6020,1180,7200
24905,Dulcia,Wooderson,dwoodersondi@soup.io,Senior Quality Engineer,9009,1898,10907
24391,Avigdor,Flory,aflorydj@shareasale.com,Project Manager,1315,1967,3282
24880,Arlene,Trustrie,atrustriedk@wix.com,Desktop Support Technician,9572,746,10318
24840,Dix,Seddon,dseddondl@npr.org,Legal Assistant,3899,1128,5027
24535,Trevar,Balch,tbalchdm@hhs.gov,Senior Sales Associate,9969,570,10539
24371,Dar,Malham,dmalhamdn@prweb.com,Developer III,8653,1076,9729
24784,Bert,Chappelow,bchappelowdo@aboutads.info,Quality Control Specialist,9416,206,9622
24217,Daryle,Piffe,dpiffedp@tripadvisor.com,VP Quality Control,8049,1070,9119
24598,Denney,Tregiddo,dtregiddodq@mapquest.com,Database Administrator IV,5844,1476,7320
24612,Catherina,Fasey,cfaseydt@spiegel.de,Professor,2681,1284,3965
24407,Anselm,Iskov,aiskovdu@time.com,Database Administrator III,8361,207,8568
24908,Vina,Biddwell,vbiddwelldv@cbsnews.com,Software Engineer I,7756,1948,9704
24395,Earvin,Cozzi,ecozzidw@cbslocal.com,Health Coach III,1760,338,2098
24973,Catharine,Lehenmann,clehenmanndx@about.com,Web Developer IV,2969,1096,4065
24608,Malchy,Beetham,mbeethamdy@mail.ru,Assistant Media Planner,3932,1891,5823
24842,Galven,Pechard,gpecharde0@flickr.com,Software Consultant,3612,1744,5356
24453,Montague,Colt,mcolte1@drupal.org,Sales Associate,6645,1556,8201
24013,Mariann,Ullyott,mullyotte2@jigsy.com,Analog Circuit Design manager,3390,1291,4681
24354,Darnall,Reading,dreadinge3@hhs.gov,Administrative Officer,2725,1823,4548
24922,Elton,MacSween,emacsweene4@marketwatch.com,Civil Engineer,4593,641,5234
24932,Rivy,O'Doireidh,rodoireidhe5@webnode.com,Account Executive,1169,383,1552
24032,Nadeen,Pride,npridee7@samsung.com,Human Resources Manager,2875,1405,4280
24732,Elianore,Gorham,egorhame8@imdb.com,Project Manager,2177,1747,3924
24256,Olivier,Lafflina,olafflinae9@nymag.com,Food Chemist,9592,1743,11335
24641,Wainwright,McGarry,wmcgarryee@google.de,Research Associate,2204,376,2580
24146,Kristy,Coalbran,kcoalbranef@t.co,Senior Quality Engineer,7413,1025,8438
24680,Aurel,Ezzle,aezzleek@bizjournals.com,Software Consultant,7223,888,8111
24225,Mortie,Heeks,mheekseq@ning.com,Electrical Engineer,4820,276,5096
24817,Fred,Sanham,fsanhamer@xinhuanet.com,Automation Specialist III,2307,306,2613
24750,Nerita,Binford,nbinfordeu@dmoz.org,Paralegal,7108,958,8066
24289,Ronnie,Corryer,rcorryerey@oracle.com,Desktop Support Technician,5605,1560,7165
24709,Sherman,Lamers,slamersez@github.com,Pharmacist,2639,1029,3668
24447,Carly,Wrigglesworth,cwrigglesworthf0@example.com,Operator,6882,1676,8558
24031,Jackqueline,Soppit,jsoppitf2@java.com,Developer IV,7261,938,8199
24033,Kamilah,Lorans,kloransf3@seattletimes.com,Environmental Tech,8137,581,8718
24316,Thedric,Gartenfeld,tgartenfeldf4@ezinearticles.com,Research Nurse,4136,328,4464
24408,Susannah,Noteyoung,snoteyoungf5@tumblr.com,Assistant Media Planner,3179,294,3473
24064,Darice,Place,dplacef6@plala.or.jp,VP Sales,9290,1488,10778
24664,Bride,Godwyn,bgodwynf7@cnbc.com,Geological Engineer,9415,615,10030
24626,Cindy,Kolin,ckolinf8@jalbum.net,Staff Scientist,6014,1944,7958
24766,Albertina,Varker,avarkerf9@google.com.br,Financial Advisor,2621,841,3462
24490,Ansel,Dugan,aduganfb@cyberchimps.com,Quality Engineer,2394,1967,4361
24430,Tallie,McGaraghan,tmcgaraghanfc@house.gov,Automation Specialist IV,5168,1314,6482
24904,Kahlil,Tomaskunas,ktomaskunasfd@twitpic.com,Nuclear Power Engineer,4477,916,5393
24540,Shoshanna,Routhorn,srouthornfi@wikimedia.org,VP Accounting,1717,1794,3511
24959,Darb,Knottley,dknottleyfj@taobao.com,Accountant III,8214,206,8420
24563,Ricky,Kleinberer,rkleinbererfk@twitpic.com,Recruiting Manager,6683,599,7282
24409,Lancelot,Keetch,lkeetchfl@icq.com,Account Representative I,2942,1810,4752
24231,Isidoro,Pinnocke,ipinnockefo@usnews.com,Teacher,2925,937,3862
24014,Zilvia,Norewood,znorewoodfp@miitbeian.gov.cn,Programmer III,5174,535,5709
24845,Auguste,Sixsmith,asixsmithft@webmd.com,Systems Administrator I,4111,1608,5719
24328,Gale,Tavner,gtavnerfu@xinhuanet.com,Geological Engineer,6230,568,6798
24079,Bay,Chambers,bchambersfv@flickr.com,Marketing Assistant,9932,507,10439
24456,Peggi,Tyreman,ptyremanfy@moonfruit.com,Senior Quality Engineer,1760,371,2131
24208,Shandie,Hebburn,shebburng2@comcast.net,Assistant Media Planner,1051,1405,2456
24602,Waldemar,Sellens,wsellensg3@youtu.be,Statistician III,3233,295,3528
24605,Jelene,Bimson,jbimsong5@360.cn,Research Nurse,5421,937,6358
24250,Ozzy,Jean,ojeang7@digg.com,Electrical Engineer,6862,1075,7937
24191,Florri,Landell,flandellg8@ibm.com,Accountant III,2140,1293,3433
24449,Ola,Grigorio,ogrigoriog9@addthis.com,Pharmacist,9398,1596,10994
24809,Manuel,Baildon,mbaildongb@hp.com,Database Administrator IV,9427,1069,10496
24375,Stafford,Fulton,sfultongd@soundcloud.com,Safety Technician I,4151,1630,5781
24971,Merline,Simper,msimperge@nhs.uk,Technical Writer,2494,1104,3598
24665,Saudra,Porcas,sporcasgi@eepurl.com,Teacher,9894,1204,11098
24248,Aldon,Joy,ajoygl@vk.com,Executive Secretary,5291,1068,6359
24918,Oby,Ledbetter,oledbettergt@live.com,Director of Sales,9121,1481,10602
24781,Shae,Cloake,scloakegu@senate.gov,Structural Engineer,8070,355,8425
24082,Archie,Haslen,ahaslengv@sogou.com,Account Representative IV,5288,1681,6969
24175,Wallie,Rickword,wrickwordgw@google.ca,Senior Developer,8078,330,8408
24996,Aldon,Ludewig,aludewiggx@economist.com,Marketing Manager,2529,1672,4201
24104,Rosalia,Etter,rettergy@over-blog.com,Programmer Analyst IV,3824,989,4813
24846,Mellie,Hadlee,mhadleegz@constantcontact.com,Analyst Programmer,6207,1508,7715
24005,Devin,Franzonello,dfranzonelloh3@statcounter.com,Account Representative III,7185,1348,8533
24831,Dulce,Menere,dmenereh4@nbcnews.com,VP Quality Control,1247,899,2146
24288,Viola,Cornelissen,vcornelissenh5@netlog.com,Chief Design Engineer,7472,445,7917
24169,Allegra,Clurow,aclurowh6@etsy.com,Assistant Manager,9737,527,10264
24144,Dora,Begley,dbegleyh8@histats.com,Product Engineer,1924,432,2356
24833,Nickie,De Freitas,ndefreitasha@ucsd.edu,Electrical Engineer,4597,514,5111
24444,Aimil,Sleep,asleephb@fc2.com,Health Coach IV,9183,878,10061
24131,Haley,Aharoni,haharonihe@netscape.com,Analyst Programmer,3911,1024,4935
24223,Lynett,Martinovsky,lmartinovskyhg@cisco.com,Automation Specialist III,7041,339,7380
24987,Haroun,Coldwell,hcoldwellhh@tiny.cc,Executive Secretary,2060,1419,3479
24847,Tallulah,Lahiff,tlahiffhi@ning.com,Dental Hygienist,5985,1475,7460
24101,Judd,Jery,jjeryhj@fda.gov,Dental Hygienist,3858,1260,5118
24673,Jerri,Goudman,jgoudmanhl@123-reg.co.uk,Account Representative I,1835,920,2755
24972,Dasie,Yushkov,dyushkovhm@dailymotion.com,Technical Writer,2723,1373,4096
24816,Michelina,Pitkins,mpitkinshn@auda.org.au,Design Engineer,4817,980,5797
24635,Mord,Leare,mleareho@wikia.com,Director of Sales,4911,1924,6835
24336,Winifield,Sudddard,wsudddardhp@friendfeed.com,Chief Design Engineer,3796,1554,5350
24697,Theo,Ramsey,tramseyhq@furl.net,Research Associate,6374,556,6930
24309,Austen,Merrell,amerrellhr@soundcloud.com,Speech Pathologist,1267,1262,2529
24088,Kippy,Byway,kbywayhs@nih.gov,Tax Accountant,5268,540,5808
24160,Breena,Pozzo,bpozzoht@adobe.com,Administrative Assistant I,7185,1185,8370
24801,Shay,Garlett,sgarletthu@quantcast.com,Business Systems Development Analyst,2253,1859,4112
24268,Hartwell,Stanett,hstanetthv@drupal.org,Marketing Assistant,2198,1999,4197
24719,Sig,Stanbro,sstanbrohy@bizjournals.com,Recruiting Manager,3014,1815,4829
24609,Colet,Scough,cscoughi2@nationalgeographic.com,Statistician II,1825,1381,3206
24482,Garnette,Snoad,gsnoadi4@list-manage.com,General Manager,4600,309,4909
24939,Rube,Verty,rvertyi5@vimeo.com,Statistician II,7778,282,8060
24351,Lilah,Blakeley,lblakeleyi7@nps.gov,Marketing Assistant,5453,1326,6779
24828,Graig,Colwill,gcolwilli8@google.it,Help Desk Operator,1654,496,2150
24714,Valentin,Heavyside,vheavysideia@weibo.com,Food Chemist,5727,1933,7660
24542,Fae,Gatehouse,fgatehouseib@spiegel.de,Structural Engineer,2370,1271,3641
24491,Gillan,Cratere,gcratereid@elpais.com,Food Chemist,7280,239,7519
24292,Cassandra,Boni,cboniif@addthis.com,Web Designer I,5850,1901,7751
24283,Lenci,Lucey,lluceyii@odnoklassniki.ru,Occupational Therapist,6857,611,7468
24178,Nels,Sekulla,nsekullaij@indiegogo.com,Junior Executive,1715,967,2682
24037,Pearce,Bytheway,pbythewayik@over-blog.com,Clinical Specialist,7997,1574,9571
24804,Jeralee,Hillett,jhillettim@pcworld.com,Product Engineer,3113,464,3577
24758,Ferdinande,Latimer,flatimerin@yahoo.co.jp,Financial Analyst,6940,1614,8554
24324,Karol,Ouldcott,kouldcottio@sitemeter.com,Social Worker,4533,1904,6437
24237,Templeton,Thandi,tthandiip@csmonitor.com,Legal Assistant,6697,957,7654
24165,Allie,Atrill,aatrilliq@devhub.com,Project Manager,3936,1506,5442
24747,Christos,Davydkov,cdavydkovir@dailymail.co.uk,Product Engineer,1583,906,2489
24192,Mirelle,McLugish,mmclugishis@nymag.com,GIS Technical Architect,7054,1692,8746
24649,Teirtza,Lempenny,tlempennyit@weebly.com,Senior Editor,8247,1459,9706
24522,Beale,O'Nolan,bonolaniw@shutterfly.com,Food Chemist,7651,940,8591
24720,Bailey,Claypool,bclaypoolix@elegantthemes.com,Speech Pathologist,5315,969,6284
24221,Nathan,Chasmar,nchasmarj0@illinois.edu,Database Administrator III,6053,1130,7183
24222,Paulette,Gouth,pgouthj2@gmpg.org,Sales Representative,6235,1466,7701
24658,Essy,Butteris,ebutterisj3@github.com,Design Engineer,7934,961,8895
24429,Blithe,Touzey,btouzeyj4@flavors.me,General Manager,2451,1341,3792
24966,Ann-marie,Bellerby,abellerbyj7@google.nl,Teacher,3823,1834,5657
24655,Hamish,Josskowitz,hjosskowitzj9@domainmarket.com,Web Designer II,8216,1758,9974
24569,Shelly,Giamo,sgiamojb@sourceforge.net,VP Quality Control,4074,1795,5869
24419,Lavina,Beatens,lbeatensjf@themeforest.net,Civil Engineer,9139,1062,10201
24353,Julieta,Antonov,jantonovjh@histats.com,Staff Accountant III,3646,1919,5565
24509,Sharron,Fetters,sfettersji@ovh.net,Junior Executive,6984,921,7905
24827,Rickard,Rye,rryejk@cnbc.com,Legal Assistant,6698,1176,7874
24907,Sella,Bolte,sboltejl@ezinearticles.com,Occupational Therapist,2836,394,3230
24800,Allie,Fildery,afilderyjp@webeden.co.uk,Nuclear Power Engineer,2996,1468,4464
24533,Kelly,Jackalin,kjackalinjq@vkontakte.ru,Computer Systems Analyst II,5262,1533,6795
24021,Reynold,Clancy,rclancyjt@newyorker.com,Director of Sales,1239,766,2005
24107,Efrem,Bradock,ebradockju@last.fm,Marketing Manager,6146,396,6542
24174,Melodie,McCrainor,mmccrainorjx@xinhuanet.com,Biostatistician I,3522,213,3735
24213,Bunnie,Perigo,bperigok0@geocities.com,Business Systems Development Analyst,9249,1715,10964
24326,Karlee,Lornsen,klornsenk4@etsy.com,Health Coach I,8925,1922,10847
24125,Morry,Kenwright,mkenwrightka@edublogs.org,VP Accounting,5029,1113,6142
24997,Reena,Midner,rmidnerkb@state.tx.us,Chemical Engineer,8583,1133,9716
24789,Diane,Yanson,dyansonki@washingtonpost.com,Software Engineer III,2231,855,3086
24526,Gaylene,Cordero,gcorderokj@dedecms.com,VP Accounting,2231,554,2785
24532,Michal,Sercombe,msercombekl@addtoany.com,Structural Analysis Engineer,4912,964,5876
24015,Stephi,Fulker,sfulkerku@cargocollective.com,Registered Nurse,1477,950,2427
24147,Joshia,Aulton,jaultonkw@nymag.com,Staff Accountant IV,3738,573,4311
24606,Lorette,Tompsett,ltompsettkx@histats.com,Staff Scientist,7521,1328,8849
24236,Perle,Morfell,pmorfelll1@amazonaws.com,Operator,5710,440,6150
24986,Hedda,Wortt,hworttl2@shinystat.com,VP Accounting,3473,764,4237
24916,Marianna,Brugmann,mbrugmannl5@salon.com,Database Administrator II,4122,1086,5208
24357,Titus,Malyon,tmalyonl6@mapquest.com,Programmer I,2826,898,3724
24651,Flemming,Elford,felfordl7@mysql.com,Senior Quality Engineer,7171,1233,8404
24631,Ellsworth,Pavic,epaviclb@mlb.com,Account Executive,3079,1346,4425
24341,Scottie,Wigfall,swigfalllc@so-net.ne.jp,Quality Control Specialist,8460,431,8891
24106,Denys,Pollack,dpollackld@prlog.org,Operator,6435,328,6763
24679,Lorens,Crisall,lcrisallli@typepad.com,Nurse Practicioner,9864,1557,11421
24152,Gianina,Purdom,gpurdomlj@microsoft.com,Senior Developer,3766,618,4384
24097,Corena,Badwick,cbadwicklk@hc360.com,Paralegal,4668,1500,6168
24187,Fairleigh,Paule,fpaulell@hugedomains.com,Account Representative I,8566,441,9007
24081,Kimmi,Stuckey,kstuckeyln@about.me,Clinical Specialist,1150,1370,2520
24179,Brittan,Manion,bmanionlo@opensource.org,GIS Technical Architect,2165,1457,3622
24564,Julieta,Antoniat,jantoniatlq@rediff.com,Professor,4653,794,5447
24822,Cristabel,Lamlin,clamlinlr@patch.com,Chief Design Engineer,6674,394,7068
24376,Chad,Casserley,ccasserleyls@dailymotion.com,Senior Financial Analyst,3528,1080,4608
24114,Dino,Felgate,dfelgatelt@ebay.co.uk,Web Designer IV,3170,563,3733
24443,Antonetta,Middle,amiddlelw@kickstarter.com,Structural Analysis Engineer,9403,724,10127
24123,Lindon,Shreeve,lshreevelx@google.nl,Editor,7902,326,8228
24149,Lynn,Occleshaw,loccleshawly@php.net,Senior Developer,2945,299,3244
24185,Janka,MacBey,jmacbeylz@upenn.edu,Budget/Accounting Analyst I,3497,642,4139
24515,Courtenay,Offord,coffordm1@jalbum.net,Engineer IV,8932,862,9794
24260,Dallas,Paddle,dpaddlem3@people.com.cn,Human Resources Assistant IV,1770,1703,3473
24075,Kassia,Khilkov,kkhilkovm4@huffingtonpost.com,Account Coordinator,2034,411,2445
24928,Francis,Acland,faclandm5@virginia.edu,Biostatistician I,4190,507,4697
24393,Cecilla,Sawforde,csawfordem9@reuters.com,Internal Auditor,3839,513,4352
24634,Tedd,McKearnen,tmckearnenma@mtv.com,Mechanical Systems Engineer,5192,1096,6288
24252,Marlie,Boscher,mboschermb@thetimes.co.uk,Administrative Assistant II,7523,1295,8818
24595,Bill,Creed,bcreedmf@hp.com,Budget/Accounting Analyst IV,5498,847,6345
24090,Cathrine,Wincer,cwincermk@ycombinator.com,Assistant Professor,9121,992,10113
24942,Rowe,Niles,rnilesmm@paypal.com,Analog Circuit Design manager,1486,1618,3104
24108,Worthington,Rolfs,wrolfsmn@livejournal.com,Junior Executive,3470,1481,4951
24089,Baillie,Loggie,bloggiemo@statcounter.com,Senior Quality Engineer,4439,457,4896
24096,Nessi,Piet,npietmu@paginegialle.it,Web Developer II,6190,1748,7938
24860,Myrtle,McVeighty,mmcveightymw@feedburner.com,Executive Secretary,1276,1993,3269
24215,Whitney,Aleswell,waleswellmx@wsj.com,Mechanical Systems Engineer,7007,1260,8267
24865,Arleen,Wheeler,awheelern3@elegantthemes.com,Structural Engineer,2300,265,2565
24553,Caron,Pfeffer,cpfeffern7@yellowbook.com,Compensation Analyst,8267,1202,9469
24130,Candy,Salterne,csalternen9@unesco.org,Project Manager,7318,276,7594
24909,Carree,Smart,csmartne@sfgate.com,Office Assistant IV,6765,960,7725
24452,Audra,Carde,acardenf@admin.ch,Food Chemist,7067,1069,8136
24150,Bendicty,Salzburg,bsalzburgng@gizmodo.com,Operator,9004,900,9904
24797,Jillana,Zanelli,jzanellinh@github.com,Analyst Programmer,5641,1336,6977
24194,Ingelbert,Screeton,iscreetonnj@so-net.ne.jp,Community Outreach Specialist,1197,1344,2541
24705,Emlyn,Slewcock,eslewcocknm@soundcloud.com,Account Executive,5564,1486,7050
24028,Raynor,Sharvell,rsharvellno@amazon.co.uk,Product Engineer,6312,1378,7690
24385,Tim,Copcott,tcopcottnt@nasa.gov,Data Coordiator,1323,1009,2332
24590,Talbot,Pabelik,tpabeliknv@go.com,Accounting Assistant II,2030,1226,3256
24850,Ruthanne,Wollers,rwollersnw@vk.com,Registered Nurse,7976,1165,9141
24559,Mariana,Leversuch,mleversuchny@123-reg.co.uk,Statistician III,8639,1294,9933
24044,Ashely,Surfleet,asurfleetnz@dailymail.co.uk,Chemical Engineer,4145,1358,5503
24048,Enriqueta,Duplock,eduplocko0@nhs.uk,Developer III,1324,1722,3046
24042,Nilson,Quaintance,nquaintanceo3@google.de,Electrical Engineer,3511,906,4417
24736,Madelon,Kruse,mkruseo4@statcounter.com,Structural Engineer,9269,1178,10447
24838,Jere,Baglan,jbaglano7@techcrunch.com,Chemical Engineer,2506,1676,4182
24872,Nata,Huzzey,nhuzzeyob@qq.com,Project Manager,5607,778,6385
24495,Elsa,Giovanetti,egiovanettiod@abc.net.au,Engineer III,7738,1128,8866
24693,Lucius,Lehr,llehrof@seesaa.net,Statistician III,5034,1367,6401
24339,Elsinore,Abramowitch,eabramowitchog@github.io,Systems Administrator IV,8284,1205,9489
24390,Nonnah,Tomini,ntominioj@squidoo.com,Desktop Support Technician,5582,1736,7318
24700,Valli,Hillett,vhillettom@soundcloud.com,Computer Systems Analyst I,2205,1557,3762
24287,Alexina,Braam,abraamoq@hostgator.com,Structural Engineer,9528,1222,10750
24574,Antoni,Steffens,asteffensor@gravatar.com,Financial Analyst,3009,348,3357
24499,Myrilla,Shovelin,mshovelinos@netlog.com,General Manager,1355,767,2122
24186,Elnar,Swinfen,eswinfenot@geocities.jp,Help Desk Technician,1510,306,1816
24442,Netta,Magson,nmagsonov@google.com,Associate Professor,5250,1262,6512
24137,Fannie,Pleaden,fpleadenoz@psu.edu,GIS Technical Architect,1677,749,2426
24968,Rem,Smewin,rsmewinp2@vistaprint.com,Electrical Engineer,6794,1763,8557
24678,Claudia,Standbrook,cstandbrookp6@simplemachines.org,Desktop Support Technician,2350,1181,3531
24940,Hayward,Sent,hsentp9@statcounter.com,Help Desk Technician,6405,1216,7621
24117,Ulla,Barlow,ubarlowpc@psu.edu,Software Consultant,1772,1623,3395
24497,Waylen,McCoole,wmccoolepe@dagondesign.com,Accountant I,2947,499,3446
24941,Katti,Gligoraci,kgligoracipf@simplemachines.org,Account Executive,1664,1304,2968
24917,Dale,Eilles,deillespg@parallels.com,Chemical Engineer,6591,1951,8542
24952,Burnard,Medd,bmeddph@patch.com,Senior Sales Associate,3973,1784,5757
24503,Giraud,Roumier,groumierpk@comcast.net,General Manager,9330,1224,10554
24544,Abbi,Leynagh,aleynaghpm@google.fr,Senior Cost Accountant,5498,1350,6848
24706,Bidget,Sheerin,bsheerinpn@google.nl,Geologist II,6271,1443,7714
24166,Thibaut,Balharry,tbalharrypo@senate.gov,VP Quality Control,4928,1641,6569
24230,Alister,Tupie,atupiept@washingtonpost.com,VP Marketing,5717,1686,7403
24592,Waneta,Sowten,wsowtenpv@psu.edu,Office Assistant II,5016,958,5974
24060,Barri,Neame,bneamepx@prlog.org,VP Accounting,7428,257,7685
24061,David,Jimmes,djimmespy@mapquest.com,Librarian,5944,964,6908
24695,Luz,Leakner,lleaknerq0@wiley.com,Speech Pathologist,8825,1717,10542
24255,Duncan,Andries,dandriesq2@chron.com,Electrical Engineer,9292,1469,10761
24931,Lionello,Slocumb,lslocumbq7@adobe.com,Structural Analysis Engineer,3340,826,4166
24981,Wallace,Slobom,wslobomq8@epa.gov,Financial Advisor,1025,516,1541
24202,Ethyl,Danskine,edanskineqe@cnbc.com,Sales Representative,1742,1822,3564
24977,Gui,Wiburn,gwiburnqg@deliciousdays.com,Human Resources Assistant I,8374,1061,9435
24659,Cosimo,Latchmore,clatchmoreqh@umich.edu,Analog Circuit Design manager,1080,1829,2909
24976,Leticia,Hassard,lhassardqi@illinois.edu,Biostatistician I,4776,1581,6357
24313,Cull,Fernihough,cfernihoughqj@microsoft.com,Cost Accountant,8207,1913,10120
24523,Agata,Bootman,abootmanqq@cornell.edu,VP Marketing,7774,1141,8915
24278,Earvin,Ducham,educhamqv@independent.co.uk,Accountant IV,7551,770,8321
24943,Nathanial,Wraggs,nwraggsr1@phoca.cz,Help Desk Technician,2481,1595,4076
24138,Rorie,Dauber,rdauberr4@mail.ru,Operator,3667,1599,5266
24557,Camilla,Beneix,cbeneixr5@admin.ch,Occupational Therapist,9361,905,10266
24866,Janetta,Sharland,jsharlandr6@cdc.gov,Geologist IV,6221,1464,7685
24227,Madge,Borrie,mborrier8@icio.us,Biostatistician IV,9151,372,9523
24170,Holly,Elphinstone,helphinstonerc@cnet.com,Quality Engineer,1478,557,2035
24814,Booth,Daughtrey,bdaughtreyrf@google.de,Health Coach II,9479,1226,10705
24945,Shawna,Jefferys,sjefferysrh@intel.com,Operator,2082,901,2983
25000,Ronnie,Alliott,ralliottrj@linkedin.com,Environmental Specialist,5698,832,6530
24204,Carie,Isles,cislesrk@newsvine.com,Technical Writer,6783,1228,8011
24460,Lonnard,Dunston,ldunstonrl@artisteer.com,Technical Writer,9743,1530,11273
25424,Pennie,Klesel,pklesel0@craigslist.org,Media Manager II,8457,1766,10223
25823,Cy,MacGillavery,cmacgillavery1@fda.gov,Physical Therapy Assistant,5597,1405,7002
25068,Dix,Traynor,dtraynor2@webmd.com,Senior Quality Engineer,3213,1812,5025
25039,Jay,Romayne,jromayne3@senate.gov,Safety Technician IV,6754,1040,7794
25595,Wright,McElhinney,wmcelhinney4@nbcnews.com,Professor,8275,215,8490
25905,Winny,Peasey,wpeasey5@utexas.edu,Computer Systems Analyst IV,6402,1630,8032
25081,Beatrice,Mohring,bmohring6@usa.gov,Software Test Engineer II,4739,1789,6528
25511,Alexa,Ilyasov,ailyasov7@youtube.com,Junior Executive,3251,1170,4421
25696,Agata,Coots,acoots8@unicef.org,Business Systems Development Analyst,1945,1149,3094
25101,Jobye,Woolf,jwoolf9@php.net,GIS Technical Architect,2416,1886,4302
25357,Elmore,Brian,ebriana@blinklist.com,Associate Professor,9103,804,9907
25903,Rhianon,Faier,rfaierb@weebly.com,Financial Advisor,8138,1695,9833
25470,Cristy,Fosher,cfosherc@youtu.be,Professor,8495,201,8696
25965,Yolanda,Davidovicz,ydavidoviczd@infoseek.co.jp,Dental Hygienist,8009,1069,9078
25985,Bradly,Bartholat,bbartholate@netlog.com,Structural Engineer,8314,1650,9964
25270,Melisenda,Cutriss,mcutrissf@linkedin.com,Analyst Programmer,5152,467,5619
25784,Hilde,Quinlan,hquinlang@1und1.de,Help Desk Operator,3749,1230,4979
25814,Zachery,Seary,zsearyh@slate.com,Budget/Accounting Analyst IV,2887,297,3184
25180,Paulo,Tidridge,ptidridgei@booking.com,Data Coordiator,7560,994,8554
25669,Adelina,Hallad,ahalladj@diigo.com,Quality Control Specialist,5184,667,5851
25943,Goddard,Grayer,ggrayerk@yahoo.co.jp,Software Test Engineer I,9345,910,10255
25677,Sabina,Weighell,sweighelll@opera.com,Junior Executive,2477,1654,4131
25746,Zoe,Ternouth,zternouthm@nhs.uk,Nurse,1941,1368,3309
25017,Myrwyn,Patshull,mpatshulln@networksolutions.com,GIS Technical Architect,2440,1500,3940
25724,Sonny,Ferronel,sferronelo@mapy.cz,Web Designer III,2624,1515,4139
25799,Sara,Puzey,spuzeyp@nydailynews.com,Clinical Specialist,3196,1858,5054
25537,Marinna,Shepeard,mshepeardq@google.com.au,Payment Adjustment Coordinator,5956,1151,7107
25812,Stearne,Skoggings,sskoggingsr@npr.org,Electrical Engineer,1879,1343,3222
25934,Gordon,Wilden,gwildens@scribd.com,Professor,5031,1622,6653
25336,Beverie,Bizley,bbizleyt@deliciousdays.com,Clinical Specialist,6027,1519,7546
25254,Janene,Steggals,jsteggalsu@mozilla.org,Structural Engineer,7279,1217,8496
25032,Fionna,Esche,feschev@networkadvertising.org,Senior Editor,2632,1241,3873
25752,Caesar,Balogh,cbaloghw@flavors.me,Automation Specialist IV,5239,1221,6460
25550,Claudie,Funcheon,cfuncheonx@nps.gov,Clinical Specialist,5278,396,5674
25022,Kelvin,Lacrouts,klacroutsy@cam.ac.uk,Electrical Engineer,2289,1946,4235
25826,Brittni,Bennedick,bbennedickz@cdc.gov,Nurse,5237,1294,6531
25189,Obadiah,Fylan,ofylan10@gravatar.com,Junior Executive,4569,442,5011
25539,Marna,Winskill,mwinskill11@umn.edu,Information Systems Manager,2866,1177,4043
25048,Park,Jenkins,pjenkins12@harvard.edu,Sales Associate,9726,794,10520
25626,Kari,Bolderstone,kbolderstone13@guardian.co.uk,Operator,5098,1253,6351
25633,Phip,Wyre,pwyre14@yelp.com,Compensation Analyst,8511,669,9180
25348,Xylia,Devin,xdevin15@theglobeandmail.com,Administrative Assistant III,3314,1261,4575
25502,Matty,Szymonwicz,mszymonwicz16@amazon.de,Project Manager,6782,472,7254
25619,Woodman,Laxson,wlaxson17@free.fr,Programmer Analyst I,7184,983,8167
25153,Neddy,Gifford,ngifford18@amazon.com,Data Coordiator,6371,273,6644
25637,Walt,McMennum,wmcmennum19@tiny.cc,Cost Accountant,2661,1123,3784
25409,Max,Paddle,mpaddle1a@nydailynews.com,VP Accounting,2034,740,2774
25737,Dukie,Tiptaft,dtiptaft1b@fastcompany.com,Health Coach IV,3772,1494,5266
25228,Britt,Cridge,bcridge1c@illinois.edu,Computer Systems Analyst III,2620,1541,4161
25493,Lindon,Freemantle,lfreemantle1d@ycombinator.com,Environmental Tech,8234,578,8812
25435,Benedetto,Cromarty,bcromarty1e@purevolume.com,Speech Pathologist,5119,297,5416
25280,Benedicta,Winkworth,bwinkworth1f@blogger.com,Recruiting Manager,1417,703,2120
25473,Richmound,Boggs,rboggs1g@mozilla.org,Recruiting Manager,5957,703,6660
25644,Tad,Bennion,tbennion1h@nih.gov,Civil Engineer,3217,1138,4355
25045,Ellen,Degoey,edegoey1i@studiopress.com,Financial Advisor,9092,951,10043
25830,Odelinda,Farney,ofarney1j@fc2.com,Community Outreach Specialist,6534,783,7317
25125,Kassey,Kearford,kkearford1k@vimeo.com,Statistician II,8791,1508,10299
25984,Derward,Aleswell,daleswell1l@xing.com,Compensation Analyst,5364,1232,6596
25124,Merv,Pavlata,mpavlata1m@w3.org,Systems Administrator IV,8024,1760,9784
25995,Llewellyn,Farnfield,lfarnfield1n@bigcartel.com,Research Assistant II,7576,568,8144
25135,Cyndie,Iredale,ciredale1o@nature.com,Account Executive,4289,316,4605
25818,Davie,Gillinghams,dgillinghams1p@bandcamp.com,Web Developer I,8534,1551,10085
25846,Cos,Hulles,chulles1q@theguardian.com,Senior Financial Analyst,1219,1933,3152
25123,Libbi,Cokely,lcokely1r@youku.com,Office Assistant II,3279,612,3891
25969,Carree,Frend,cfrend1s@wordpress.org,Sales Associate,4689,274,4963
25921,Wash,Treece,wtreece1t@simplemachines.org,Assistant Manager,2835,783,3618
25756,Darleen,Antat,dantat1u@irs.gov,Sales Representative,1180,764,1944
25097,Corella,De Giorgi,cdegiorgi1w@goo.gl,Social Worker,1829,603,2432
25046,Carina,Larvin,clarvin1x@prweb.com,Recruiter,8152,1112,9264
25196,Regan,Fidgett,rfidgett1y@diigo.com,Registered Nurse,5092,1755,6847
25126,Andrea,Mersh,amersh1z@wiley.com,Nurse Practicioner,4245,540,4785
25682,Mindy,Lindenboim,mlindenboim20@pinterest.com,Software Consultant,7484,414,7898
25698,Harley,Tackes,htackes21@prweb.com,Quality Control Specialist,9585,1522,11107
25967,Harcourt,Loos,hloos22@gravatar.com,Analog Circuit Design manager,7467,685,8152
25875,Charley,Dudden,cdudden23@yahoo.co.jp,Senior Developer,5084,1381,6465
25952,Gustaf,Haller,ghaller24@google.ca,Food Chemist,3001,884,3885
25836,Maggy,Bordiss,mbordiss25@si.edu,Senior Sales Associate,8497,210,8707
25398,Talia,Arrowsmith,tarrowsmith26@wiley.com,Sales Representative,7528,1206,8734
25043,Ynes,Buglar,ybuglar27@g.co,Data Coordiator,6051,411,6462
25335,Sky,Driscoll,sdriscoll28@stumbleupon.com,Speech Pathologist,3513,1462,4975
25872,Herculie,Esby,hesby29@w3.org,Executive Secretary,4351,1377,5728
25454,Issi,Mussotti,imussotti2a@addtoany.com,Social Worker,2598,360,2958
25215,Kenn,Groarty,kgroarty2b@elpais.com,Social Worker,5585,1847,7432
25118,Kelsey,Rennenbach,krennenbach2c@alexa.com,Environmental Tech,9218,1646,10864
25901,Jessica,Bilovus,jbilovus2d@behance.net,Geological Engineer,4102,364,4466
25497,Neddy,Kencott,nkencott2f@bbc.co.uk,Geological Engineer,5083,1437,6520
25058,Konstantine,Ollerhad,kollerhad2g@blinklist.com,Programmer Analyst II,9905,1634,11539
25611,Devin,Tomkinson,dtomkinson2h@blogger.com,Senior Developer,3416,1894,5310
25338,Meagan,Chavrin,mchavrin2i@amazonaws.com,Financial Analyst,9466,248,9714
25482,Lee,Bleby,lbleby2j@csmonitor.com,VP Sales,3285,1126,4411
25407,Augustin,Gages,agages2k@netvibes.com,Human Resources Assistant II,6498,1352,7850
25075,Trever,Vertey,tvertey2l@zdnet.com,Technical Writer,4271,1834,6105
25881,Stella,Gauden,sgauden2m@newyorker.com,VP Accounting,8311,1073,9384
25957,Rouvin,Selburn,rselburn2n@webs.com,Health Coach III,2854,1648,4502
25931,Palmer,Lode,plode2o@people.com.cn,Paralegal,7392,1536,8928
25201,Colver,Weekley,cweekley2p@freewebs.com,Food Chemist,4285,1271,5556
25014,Henka,Attle,hattle2q@ebay.com,Office Assistant II,7170,460,7630
25082,Pearce,Littlecote,plittlecote2r@ft.com,Pharmacist,1327,1685,3012
25622,Jacquette,Coram,jcoram2s@dot.gov,Web Developer IV,6453,459,6912
25531,Alfreda,Clendening,aclendening2t@vinaora.com,Account Executive,9905,1051,10956
25835,Sly,Ransom,sransom2u@cam.ac.uk,Software Test Engineer IV,2302,1283,3585
25467,Honor,Ashall,hashall2v@gravatar.com,Marketing Manager,6256,1748,8004
25397,Jasun,Braddick,jbraddick2w@netvibes.com,Director of Sales,2893,362,3255
25977,Kissie,Dunne,kdunne2x@nature.com,Librarian,2330,929,3259
25786,Rhodia,Cowap,rcowap2y@imgur.com,Dental Hygienist,8401,420,8821
25720,Anders,Yarwood,ayarwood2z@cloudflare.com,Help Desk Technician,2483,1451,3934
25162,Casi,Quadling,cquadling30@about.me,GIS Technical Architect,8376,704,9080
25738,Carl,Weatherby,cweatherby31@nytimes.com,Media Manager III,3310,663,3973
25054,Gav,Chorlton,gchorlton32@dagondesign.com,Geologist IV,5972,1903,7875
25591,Joachim,Girt,jgirt33@networkadvertising.org,Desktop Support Technician,7595,1593,9188
25850,Dimitry,Rhelton,drhelton34@seattletimes.com,Physical Therapy Assistant,3328,1191,4519
25691,Nana,Clewett,nclewett35@si.edu,Office Assistant I,9881,1939,11820
25066,Dru,Tanser,dtanser36@discuz.net,Operator,8504,1876,10380
25091,Jeana,Lethby,jlethby37@shutterfly.com,Product Engineer,2155,618,2773
25404,Zachery,Aleksankov,zaleksankov38@i2i.jp,Mechanical Systems Engineer,4048,1869,5917
25728,Willie,Vitte,wvitte39@sohu.com,Senior Developer,4089,609,4698
25350,Dusty,Ostick,dostick3a@ovh.net,Financial Analyst,3339,1194,4533
25712,Giacomo,Mounch,gmounch3b@ucsd.edu,Marketing Assistant,8390,1986,10376
25116,Windham,Hesse,whesse3c@ihg.com,Human Resources Assistant III,4101,688,4789
25802,Dorrie,Schwander,dschwander3d@google.de,Account Executive,2026,1639,3665
25333,Lucine,Pinnigar,lpinnigar3e@sun.com,Occupational Therapist,4436,1299,5735
25602,Courtney,Dawidowitz,cdawidowitz3g@engadget.com,Staff Accountant II,7910,596,8506
25183,Andrei,Rains,arains3i@tripod.com,Marketing Manager,5256,452,5708
25725,Thibaud,Stoney,tstoney3j@tinypic.com,Paralegal,7359,674,8033
25940,Harman,Slorance,hslorance3k@disqus.com,Pharmacist,3212,845,4057
25329,Kingsly,Sollom,ksollom3l@biglobe.ne.jp,Safety Technician II,1804,1738,3542
25923,Katinka,Jansie,kjansie3n@paginegialle.it,Web Designer I,7404,1061,8465
25877,Franni,Morrowe,fmorrowe3o@tmall.com,Web Developer I,2313,1967,4280
25354,Carroll,Carver,ccarver3p@is.gd,Design Engineer,2331,270,2601
25582,Randie,Sedge,rsedge3q@scribd.com,Analyst Programmer,2739,1615,4354
25972,Dame,Gonsalvo,dgonsalvo3r@nba.com,Community Outreach Specialist,8259,876,9135
25947,Brion,Boughton,bboughton3s@epa.gov,Structural Analysis Engineer,7752,1260,9012
25692,Drud,Redolfi,dredolfi3t@prlog.org,Community Outreach Specialist,7526,1431,8957
25708,Arly,Cough,acough3u@squarespace.com,Senior Cost Accountant,4343,477,4820
25883,Wood,Mettrick,wmettrick3w@etsy.com,Programmer Analyst III,4639,452,5091
25815,Cody,McDonnell,cmcdonnell3x@canalblog.com,Internal Auditor,2163,1578,3741
25707,Gav,Napier,gnapier3y@deviantart.com,Nuclear Power Engineer,6368,1555,7923
25599,Marlowe,MacParlan,mmacparlan3z@youku.com,Software Consultant,8090,1232,9322
25033,Ahmed,Mathias,amathias40@kickstarter.com,Programmer Analyst IV,3286,1478,4764
25421,My,Bostick,mbostick41@github.com,Senior Quality Engineer,3375,1243,4618
25661,Meredithe,Cammoile,mcammoile42@princeton.edu,Information Systems Manager,9377,951,10328
25293,Cointon,Trelevan,ctrelevan44@sciencedaily.com,Account Executive,7264,1773,9037
25100,Hartwell,Timberlake,htimberlake45@spiegel.de,Statistician II,2511,1270,3781
25884,Ericha,Ogborn,eogborn46@amazon.co.uk,Software Consultant,7683,1064,8747
25571,Willis,Veasey,wveasey47@istockphoto.com,Senior Financial Analyst,7327,1654,8981
25960,Caresse,Thebeau,cthebeau48@1und1.de,Office Assistant IV,9713,1527,11240
25655,Gage,Bennet,gbennet4a@whitehouse.gov,Senior Developer,4222,1824,6046
25533,Carlie,Camus,ccamus4b@webeden.co.uk,Media Manager IV,9195,1014,10209
25366,Bord,Lerven,blerven4d@disqus.com,Professor,5792,756,6548
25344,Forster,Carbett,fcarbett4f@github.io,General Manager,8201,627,8828
25606,Jaymie,Downie,jdownie4g@state.gov,Pharmacist,5408,1475,6883
25988,Isidro,Geikie,igeikie4h@t-online.de,Tax Accountant,9093,1935,11028
25131,Sabrina,Norris,snorris4i@hud.gov,Biostatistician IV,7541,871,8412
25281,Ignacius,Robichon,irobichon4j@altervista.org,Accounting Assistant III,6054,1316,7370
25383,Emlynne,Mewburn,emewburn4k@ibm.com,Software Consultant,6069,268,6337
25192,Juliet,Lambrick,jlambrick4m@wunderground.com,Information Systems Manager,5245,1545,6790
25227,Gwenni,Elgee,gelgee4n@usgs.gov,Research Nurse,3951,1228,5179
25825,Martie,MacClure,mmacclure4o@cbc.ca,Accounting Assistant II,5136,929,6065
25994,Imojean,Bockh,ibockh4r@prlog.org,Business Systems Development Analyst,8272,1591,9863
25744,Robers,Lesek,rlesek4s@springer.com,Marketing Manager,3031,585,3616
25514,Donnie,Bundey,dbundey4t@marketwatch.com,Geologist III,4566,262,4828
25073,Belicia,Jolley,bjolley4u@walmart.com,Graphic Designer,5216,1590,6806
25448,Hodge,Bloggett,hbloggett4v@pen.io,Community Outreach Specialist,1327,1464,2791
25088,Madel,Eathorne,meathorne4w@pinterest.com,Junior Executive,1829,1189,3018
25265,Stephani,Slinger,sslinger4y@usgs.gov,Senior Financial Analyst,2666,1704,4370
25867,Nettle,Grouse,ngrouse4z@vinaora.com,Database Administrator II,5823,339,6162
25362,Everard,Quiddinton,equiddinton50@quantcast.com,Account Coordinator,9980,1228,11208
25450,Correy,Skakunas,cskakunas52@addthis.com,Quality Control Specialist,4927,1479,6406
25132,Ilario,Mingardo,imingardo53@jiathis.com,Programmer IV,7331,417,7748
25062,Agnes,Soden,asoden54@epa.gov,Senior Developer,2021,1875,3896
25801,Sanderson,Petcher,spetcher55@oaic.gov.au,Budget/Accounting Analyst II,2252,941,3193
25701,Dalenna,Bushby,dbushby56@nih.gov,Senior Quality Engineer,1225,910,2135
25617,Reiko,Newvell,rnewvell57@wordpress.org,Automation Specialist IV,7832,1936,9768
25050,Stevena,Kefford,skefford58@github.io,Quality Engineer,4464,1059,5523
25924,Paxton,Ditchburn,pditchburn59@hostgator.com,Paralegal,3862,360,4222
25891,Ody,Wadeson,owadeson5a@cdc.gov,Web Designer III,4430,622,5052
25710,Tommie,Stebbings,tstebbings5b@hud.gov,Data Coordiator,4035,529,4564
25136,Isobel,Snelman,isnelman5c@360.cn,Research Assistant II,9408,518,9926
25641,Celene,Tilne,ctilne5f@blog.com,Staff Scientist,6204,1606,7810
25410,Boot,Millwall,bmillwall5h@google.co.uk,Accountant III,9072,612,9684
25341,Johnette,Champerlen,jchamperlen5i@boston.com,Senior Sales Associate,6566,936,7502
25578,Heida,Alves,halves5k@squarespace.com,Compensation Analyst,4068,1746,5814
25922,Philippe,Schimoni,pschimoni5m@scientificamerican.com,Computer Systems Analyst I,9866,1735,11601
25817,Kimmie,Okenden,kokenden5n@weebly.com,Physical Therapy Assistant,6136,880,7016
25285,Janifer,Kits,jkits5p@webs.com,Web Developer II,2068,1019,3087
25309,Belle,Hessel,bhessel5q@goodreads.com,Mechanical Systems Engineer,5030,411,5441
25142,Cindee,Wickrath,cwickrath5r@fc2.com,Registered Nurse,3882,926,4808
25681,Emylee,Yielding,eyielding5s@cnbc.com,Assistant Professor,2339,1315,3654
25360,Row,Grayshan,rgrayshan5u@surveymonkey.com,Information Systems Manager,3918,1343,5261
25653,Hendrik,Gabbetis,hgabbetis5v@privacy.gov.au,Executive Secretary,1138,1444,2582
25630,Kiah,McMurray,kmcmurray5w@xrea.com,VP Accounting,4731,1932,6663
25683,Rodrique,Roe,rroe5y@posterous.com,Design Engineer,3484,504,3988
25794,Ashby,Frantsev,afrantsev5z@springer.com,Technical Writer,5425,1210,6635
25199,Baird,Flynn,bflynn60@cocolog-nifty.com,Compensation Analyst,7013,716,7729
25034,Fancie,Matz,fmatz61@admin.ch,Dental Hygienist,1225,1120,2345
25105,Fanya,Loveitt,floveitt63@xing.com,Payment Adjustment Coordinator,4830,873,5703
25865,Winona,Montague,wmontague64@oracle.com,Staff Scientist,2256,1904,4160
25436,Daryle,Velte,dvelte65@dion.ne.jp,Structural Engineer,3184,286,3470
25506,Jessey,Everwin,jeverwin66@dropbox.com,Data Coordiator,1053,617,1670
25762,Josy,Mahon,jmahon67@homestead.com,VP Quality Control,7244,1489,8733
25106,Edlin,Fabb,efabb68@youtube.com,Quality Engineer,4452,314,4766
25946,Doralia,Yeldham,dyeldham69@addthis.com,Statistician II,1981,1185,3166
25028,Jerrilyn,Pelzer,jpelzer6a@parallels.com,Automation Specialist II,3665,1990,5655
25169,Carlota,Guille,cguille6e@msu.edu,Payment Adjustment Coordinator,2201,1562,3763
25911,Mallory,Foy,mfoy6h@printfriendly.com,Chief Design Engineer,6931,741,7672
25257,Joachim,Father,jfather6i@stanford.edu,Programmer Analyst I,1270,1043,2313
25351,Emlyn,Phythean,ephythean6j@bandcamp.com,Budget/Accounting Analyst IV,8407,806,9213
25200,Irving,Rennix,irennix6k@cisco.com,Research Assistant III,9427,877,10304
25305,Sherline,Canton,scanton6l@oakley.com,Design Engineer,2277,1909,4186
25963,Eloisa,Cammacke,ecammacke6m@hatena.ne.jp,Financial Advisor,2303,1390,3693
25718,Jennifer,O' Gara,jogara6n@home.pl,Project Manager,5425,1509,6934
25585,Isiahi,Tinghill,itinghill6o@redcross.org,Technical Writer,3337,463,3800
25651,Rozamond,Kindle,rkindle6p@craigslist.org,Legal Assistant,7985,776,8761
25968,Nisse,Yegorkov,nyegorkov6q@oracle.com,GIS Technical Architect,9663,1136,10799
25471,Miguel,Andryunin,mandryunin6r@storify.com,VP Marketing,5769,240,6009
25945,Corabella,Alcalde,calcalde6s@webmd.com,Software Test Engineer IV,9750,1609,11359
25759,Pancho,Jarratt,pjarratt6u@amazon.com,Speech Pathologist,4817,1163,5980
25303,Mureil,Gildersleaves,mgildersleaves6v@bravesites.com,Chief Design Engineer,9545,1284,10829
25726,Woodrow,Tupman,wtupman6w@eventbrite.com,Nuclear Power Engineer,7142,894,8036
25306,Dalia,Fairest,dfairest6x@wired.com,Assistant Media Planner,9898,754,10652
25769,Ericka,Fargie,efargie6y@ucla.edu,Staff Accountant IV,6002,1735,7737
25358,Orion,Ten Broek,otenbroek6z@wikipedia.org,Design Engineer,9720,1988,11708
25089,Fabiano,MacCrachen,fmaccrachen70@tinyurl.com,Executive Secretary,3492,251,3743
25851,Berny,Bunten,bbunten71@xinhuanet.com,Senior Financial Analyst,5360,1023,6383
25076,Rowan,LAbbet,rlabbet72@last.fm,Statistician I,7552,482,8034
25859,Sibylla,Ion,sion73@bbb.org,Staff Scientist,5218,487,5705
25795,Conrade,Scurman,cscurman74@google.es,Assistant Media Planner,9253,1558,10811
25296,Jany,Broodes,jbroodes75@multiply.com,Professor,2006,1563,3569
25159,Nolly,Culp,nculp76@typepad.com,Speech Pathologist,2128,932,3060
25130,Erma,Lusty,elusty78@tripod.com,Senior Editor,8874,1000,9874
25800,Georgine,Russan,grussan79@baidu.com,VP Marketing,2997,1127,4124
25822,Ody,Clyde,oclyde7a@vistaprint.com,Systems Administrator II,2554,1532,4086
25176,Gregory,Benzie,gbenzie7b@nasa.gov,Financial Analyst,6282,1833,8115
25168,Cortie,Withrop,cwithrop7d@clickbank.net,Quality Control Specialist,1085,1405,2490
25143,Taryn,Bracher,tbracher7e@ovh.net,Structural Analysis Engineer,7045,1398,8443
25460,Odette,Grishakov,ogrishakov7f@arizona.edu,Developer III,6508,1544,8052
25374,Rudolph,Twine,rtwine7g@people.com.cn,Professor,3598,1864,5462
25298,Lincoln,O' Lone,lolone7h@arstechnica.com,Clinical Specialist,3441,778,4219
25242,Dionisio,Pietz,dpietz7i@bluehost.com,Structural Engineer,6722,279,7001
25221,Nady,Hendrichs,nhendrichs7j@shop-pro.jp,Web Developer III,9719,774,10493
25258,Cami,Eslemont,ceslemont7k@desdev.cn,GIS Technical Architect,5997,554,6551
25074,Leticia,Gerrelt,lgerrelt7l@artisteer.com,Mechanical Systems Engineer,6570,1525,8095
25382,Tessy,Jollie,tjollie7n@ihg.com,Civil Engineer,2340,1040,3380
25267,Roberto,Lait,rlait7o@addtoany.com,Web Developer IV,1656,1240,2896
25927,Kippy,Morrieson,kmorrieson7p@twitter.com,Assistant Media Planner,6543,902,7445
25485,Peggie,Merrin,pmerrin7q@wikimedia.org,Staff Scientist,4974,943,5917
25964,Curr,Greenway,cgreenway7s@networkadvertising.org,Accountant IV,3088,1815,4903
25636,Shanon,Howsego,showsego7u@wikimedia.org,Administrative Assistant II,9712,1408,11120
25510,Horacio,Reboul,hreboul7v@google.cn,Chemical Engineer,1316,532,1848
25164,Kellen,Denne,kdenne7w@wikispaces.com,Financial Advisor,2852,1702,4554
25117,Rolando,Othen,rothen7y@ovh.net,Civil Engineer,1534,856,2390
25346,Ebony,Annets,eannets7z@drupal.org,Community Outreach Specialist,7590,1644,9234
25463,Towny,Neillans,tneillans80@google.co.uk,Accounting Assistant II,4739,1569,6308
25494,Lana,Ettels,lettels82@toplist.cz,Speech Pathologist,8433,1044,9477
25601,Sharona,Brunsdon,sbrunsdon83@vinaora.com,Marketing Manager,7021,1582,8603
25839,Dani,Stacy,dstacy84@army.mil,Design Engineer,5667,719,6386
25625,Maxim,Casajuana,mcasajuana85@purevolume.com,Media Manager I,6129,858,6987
25300,Kleon,Westoll,kwestoll86@wikipedia.org,Help Desk Operator,5728,835,6563
25580,Pascal,Giacopazzi,pgiacopazzi87@blogger.com,Help Desk Technician,1277,1128,2405
25170,Lyell,Kach,lkach89@mail.ru,Assistant Professor,3905,859,4764
25349,Rik,Ingerson,ringerson8a@cnet.com,Actuary,6864,455,7319
25291,Ogdon,Stolle,ostolle8b@dailymail.co.uk,Senior Quality Engineer,1429,1462,2891
25290,Kathrine,Leynham,kleynham8c@usnews.com,Budget/Accounting Analyst II,9657,292,9949
25326,Vasili,Rew,vrew8d@adobe.com,Paralegal,6422,578,7000
25841,Archibald,Lantaph,alantaph8e@bing.com,Structural Engineer,2367,716,3083
25948,Idelle,Latey,ilatey8f@disqus.com,VP Sales,3786,315,4101
25284,Bertie,Hartland,bhartland8h@deviantart.com,Environmental Tech,1877,1626,3503
25564,Regen,Stovell,rstovell8i@list-manage.com,Accounting Assistant II,6100,1062,7162
25805,Emelyne,Postans,epostans8j@addthis.com,Assistant Media Planner,6073,1634,7707
25060,Malinde,Sapseed,msapseed8k@simplemachines.org,Structural Analysis Engineer,1137,1590,2727
25222,Jess,Comettoi,jcomettoi8l@ebay.co.uk,Budget/Accounting Analyst IV,8401,1333,9734
25391,Judie,Tear,jtear8m@nba.com,Media Manager I,2652,469,3121
25103,Shayne,Chaulk,schaulk8n@skype.com,Desktop Support Technician,2472,523,2995
25535,Padgett,Danzey,pdanzey8o@simplemachines.org,Internal Auditor,9630,1148,10778
25278,Peterus,Turner,pturner8p@ftc.gov,Environmental Specialist,1919,843,2762
25426,Moreen,Celand,mceland8r@twitter.com,Compensation Analyst,9841,443,10284
25371,Ewart,Whittuck,ewhittuck8s@4shared.com,Web Developer III,4461,1561,6022
25096,Jammal,Carwithan,jcarwithan8t@answers.com,Graphic Designer,6777,668,7445
25807,Toinette,Edlin,tedlin8u@rediff.com,Web Designer IV,1871,594,2465
25711,Ranice,Halewood,rhalewood8v@studiopress.com,Nuclear Power Engineer,2363,1800,4163
25914,Marje,Melody,mmelody8x@cocolog-nifty.com,Desktop Support Technician,3027,1739,4766
25889,Dov,Reditt,dreditt8y@lulu.com,Financial Advisor,1956,1525,3481
25479,Deana,Dauber,ddauber8z@pen.io,Marketing Assistant,1698,1695,3393
25620,Marquita,Eastes,meastes91@sohu.com,Senior Financial Analyst,9984,1806,11790
25829,Dayle,Bellelli,dbellelli92@springer.com,Graphic Designer,9149,1780,10929
25288,Rossie,Ollerearnshaw,rollerearnshaw93@gov.uk,GIS Technical Architect,3676,630,4306
25438,Collete,De Mattia,cdemattia96@friendfeed.com,Computer Systems Analyst II,5684,1955,7639
25386,Jackson,Peaden,jpeaden97@instagram.com,Product Engineer,4472,1700,6172
25245,Almira,Brydone,abrydone98@acquirethisname.com,Quality Engineer,5604,390,5994
25121,Tabb,Miebes,tmiebes99@delicious.com,Product Engineer,7220,902,8122
25084,Ardisj,Coiley,acoiley9a@example.com,General Manager,5957,1416,7373
25352,Peter,Pash,ppash9b@issuu.com,Senior Sales Associate,8090,923,9013
25731,Wynnie,Pettwood,wpettwood9d@photobucket.com,Marketing Assistant,2320,1678,3998
25462,Herold,Allabarton,hallabarton9i@seattletimes.com,Financial Advisor,5158,1797,6955
25793,Gayleen,Gaffer,ggaffer9j@slate.com,Occupational Therapist,5317,1299,6616
25040,Vinnie,Bauduccio,vbauduccio9l@virginia.edu,Administrative Officer,2529,904,3433
25356,Darwin,Derks,dderks9m@phpbb.com,Programmer III,3059,679,3738
25226,Hillel,Davidman,hdavidman9n@prweb.com,Teacher,5324,1577,6901
25406,Rosy,Rudgard,rrudgard9p@epa.gov,Product Engineer,6799,1171,7970
25274,Jacynth,Wedge,jwedge9q@cdc.gov,Product Engineer,1443,658,2101
25157,Luciana,Restorick,lrestorick9r@dyndns.org,Paralegal,8790,396,9186
25868,Weston,Prazer,wprazer9s@oracle.com,Compensation Analyst,2004,1754,3758
25579,Coreen,Elias,celias9u@springer.com,Teacher,7346,1548,8894
25041,Ginevra,Wrench,gwrench9x@sun.com,General Manager,7640,808,8448
25283,Alleen,Charpling,acharpling9y@tamu.edu,Compensation Analyst,5704,1605,7309
25996,Gail,Dumphry,gdumphry9z@comsenz.com,Help Desk Operator,4120,1609,5729
25635,Ramonda,Aliman,ralimana2@ted.com,Senior Editor,8349,1765,10114
25205,Guglielmo,Alldis,galldisa5@sciencedaily.com,Senior Editor,1914,1997,3911
25102,Theo,Gore,tgorea6@fotki.com,Assistant Professor,9976,1344,11320
25519,Cliff,Cruz,ccruza7@theguardian.com,Quality Engineer,1887,587,2474
25560,Dulcinea,Mauser,dmausera8@addthis.com,Software Engineer IV,4451,1020,5471
25854,Barby,Goosnell,bgoosnellac@tiny.cc,Senior Editor,7377,1581,8958
25315,Antoinette,Lehemann,alehemannad@scribd.com,Associate Professor,1534,277,1811
25232,Gardiner,Giraths,ggirathsag@people.com.cn,Legal Assistant,3199,220,3419
25779,Darrel,Dunks,ddunksah@who.int,Analog Circuit Design manager,7475,550,8025
25155,Malinda,Nevins,mnevinsaj@cnet.com,Research Nurse,6137,1002,7139
25990,Kristina,Emms,kemmsak@globo.com,Environmental Tech,7499,1603,9102
25342,Maddie,Hammel,mhammelal@imdb.com,Occupational Therapist,1223,1040,2263
25286,Chevalier,Veitch,cveitcham@twitter.com,Quality Engineer,4635,1090,5725
25781,Porter,Tomaskov,ptomaskovan@webmd.com,Dental Hygienist,6096,459,6555
25206,Thomasa,Simic,tsimicaq@furl.net,Statistician II,4461,1017,5478
25148,Rick,Storck,rstorckar@e-recht24.de,Information Systems Manager,9918,696,10614
25083,Robers,Chelam,rchelamas@devhub.com,Research Associate,9991,1110,11101
25950,Curtis,Legging,cleggingau@printfriendly.com,Recruiter,6516,570,7086
25607,Ambrosio,Cristea,acristeaav@forbes.com,Internal Auditor,1873,1256,3129
25899,Loree,McCurley,lmccurleyax@instagram.com,General Manager,8257,1994,10251
25804,Hurleigh,Clymer,hclymeray@businessweek.com,Computer Systems Analyst I,2179,1984,4163
25455,Otis,Bingham,obinghamaz@businessweek.com,Project Manager,2421,1031,3452
25757,Janenna,Frankland,jfranklandb0@google.de,Environmental Specialist,4102,354,4456
25702,Tina,Di Napoli,tdinapolib1@google.nl,Sales Representative,3795,1707,5502
25671,Editha,Kroll,ekrollb2@mail.ru,Product Engineer,4416,1896,6312
25847,Dorella,Donavan,ddonavanb4@newsvine.com,Information Systems Manager,9922,1628,11550
25184,Lindsy,Bowlands,lbowlandsb7@va.gov,Senior Developer,7171,1795,8966
25419,Leia,Fencott,lfencottb8@uiuc.edu,Software Test Engineer I,4003,1220,5223
25765,Mitch,Guerro,mguerrob9@ovh.net,Legal Assistant,1625,1410,3035
25673,Garvin,Schwerin,gschwerinba@ucla.edu,Programmer III,6755,752,7507
25517,Rhona,Jodlkowski,rjodlkowskibb@bing.com,Social Worker,4517,1591,6108
25520,Tanney,Ogilvie,togilviebc@sitemeter.com,Marketing Manager,9151,903,10054
25385,Willem,Geraghty,wgeraghtybf@bloomberg.com,Research Nurse,1261,1234,2495
25549,Carri,Kaubisch,ckaubischbg@hp.com,Systems Administrator I,6830,1399,8229
25596,Venita,Churchin,vchurchinbh@google.es,Analyst Programmer,4584,1265,5849
25615,Olivette,Georg,ogeorgbk@tinypic.com,Analyst Programmer,9361,578,9939
25052,Chicky,Di Batista,cdibatistabm@accuweather.com,Financial Analyst,4414,1450,5864
25213,Korella,Barfford,kbarffordbn@last.fm,Senior Developer,9644,1098,10742
25422,Job,Mounsey,jmounseybp@woothemes.com,Associate Professor,7498,323,7821
25377,Emmye,Sanbrook,esanbrookbr@epa.gov,Software Test Engineer III,2786,1018,3804
25202,Jefferson,Iacovino,jiacovinobs@themeforest.net,Information Systems Manager,2364,1053,3417
25873,Mortimer,Detoile,mdetoilebt@yellowbook.com,Paralegal,4119,651,4770
25949,Page,Templman,ptemplmanbw@harvard.edu,Office Assistant II,5695,840,6535
25166,Wilmer,Ruzic,wruzicbx@scientificamerican.com,Media Manager II,7307,361,7668
25469,Avery,Molan,amolanby@cnn.com,Research Nurse,6375,394,6769
25754,Carson,Durdan,cdurdanbz@feedburner.com,Chemical Engineer,7751,952,8703
25264,Kaleena,Pember,kpemberc1@techcrunch.com,Financial Analyst,1241,600,1841
25069,Mada,Stroband,mstrobandc4@simplemachines.org,Financial Analyst,4976,1008,5984
25749,Gilbertine,Trevon,gtrevonc5@dion.ne.jp,Speech Pathologist,5903,632,6535
25193,Marquita,Adriani,madrianic6@oracle.com,Speech Pathologist,9952,479,10431
25431,Betty,Furphy,bfurphyc7@homestead.com,Operator,1448,764,2212
25959,Connor,Meecher,cmeecherc9@oracle.com,Engineer II,6588,1908,8496
25212,Tatiania,Harnes,tharnesca@1688.com,Librarian,5610,1901,7511
25518,Sherwynd,Tout,stoutcb@nature.com,Staff Scientist,6453,1572,8025
25175,Cammie,Greenough,cgreenoughcc@latimes.com,Teacher,2578,891,3469
25313,Norbert,Crier,ncriercf@home.pl,Sales Associate,7565,1632,9197
25038,Dian,Ghiraldi,dghiraldich@yandex.ru,Senior Cost Accountant,2396,1322,3718
25230,Candida,O'Corr,cocorrcj@telegraph.co.uk,Research Associate,4630,662,5292
25920,Yoshi,Kaaskooper,ykaaskooperck@cargocollective.com,Clinical Specialist,3217,328,3545
25238,Abraham,Terrill,aterrillco@vk.com,Assistant Professor,5724,280,6004
25425,Ardys,Kneal,aknealct@slate.com,Safety Technician III,5038,472,5510
25160,Parrnell,Lamberto,plambertocw@google.com,Internal Auditor,5043,1381,6424
25408,Melonie,Maddinon,mmaddinoncy@chronoengine.com,Nurse Practicioner,9844,765,10609
25999,Alvin,Eisikowitz,aeisikowitzcz@indiatimes.com,Director of Sales,7872,1648,9520
25363,Fiorenze,Krysztowczyk,fkrysztowczykd1@nifty.com,Structural Analysis Engineer,4118,1308,5426
25317,Johannes,Yashanov,jyashanovd2@pen.io,Programmer Analyst I,5072,1852,6924
25466,Giulia,Spoerl,gspoerld3@last.fm,VP Sales,7177,472,7649
25250,Benni,Liddall,bliddalld5@addthis.com,Research Assistant IV,4328,1028,5356
25770,Viv,Butteris,vbutterisd6@blogspot.com,Librarian,1136,1678,2814
25989,Aldric,Ramelet,arameletd7@alexa.com,Database Administrator IV,9064,562,9626
25634,Cordie,Yakovlev,cyakovlevd8@chronoengine.com,Account Representative II,9676,1085,10761
25647,Marthe,Robertacci,mrobertaccid9@mozilla.org,Human Resources Manager,9005,1042,10047
25618,Charmion,Menier,cmenierda@ca.gov,Recruiting Manager,2286,1290,3576
25271,Maria,Reddell,mreddelldc@godaddy.com,Geological Engineer,5276,1430,6706
25179,Shelby,Sedwick,ssedwickdg@cmu.edu,Geologist II,4057,221,4278
25666,Schuyler,Jacobsen,sjacobsendh@yelp.com,Recruiter,5795,817,6612
25475,Darrin,Rippingale,drippingaledk@jugem.jp,Senior Editor,7456,1189,8645
25481,Amory,Pitkeathley,apitkeathleydm@aboutads.info,Accountant III,3361,1906,5267
25007,Stephanus,Filov,sfilovdr@wikimedia.org,Teacher,7829,1683,9512
25042,Vincenty,Mellor,vmellordt@list-manage.com,Research Assistant II,6663,997,7660
25266,Sharleen,Votier,svotierdu@businessweek.com,Data Coordiator,4573,414,4987
25614,Robbert,Foulger,rfoulgerdx@unblog.fr,Nurse,2889,561,3450
25962,Guy,Caulkett,gcaulkettdy@over-blog.com,Administrative Officer,1538,1251,2789
25464,Emmit,Mattisson,emattissone0@123-reg.co.uk,Budget/Accounting Analyst III,1048,484,1532
25289,Nettie,Chong,nchonge1@timesonline.co.uk,Executive Secretary,8611,1844,10455
25971,Lynnelle,Tothe,ltothee2@jalbum.net,Community Outreach Specialist,4163,1033,5196
25339,Lonna,Springford,lspringforde3@cisco.com,Data Coordiator,2318,261,2579
25171,Leigha,Husher,lhushere5@mozilla.org,Software Engineer I,9221,883,10104
25235,Lamar,Hodjetts,lhodjettse6@vimeo.com,Help Desk Technician,5498,1644,7142
25553,Claire,Lautie,clautiee8@marriott.com,Clinical Specialist,9115,229,9344
25913,Ardenia,Tetla,atetlaea@wunderground.com,Financial Advisor,1803,587,2390
25643,Wini,Skipper,wskipperec@bloglovin.com,Senior Quality Engineer,3181,1321,4502
25563,Ruthanne,McGennis,rmcgennised@reddit.com,Quality Control Specialist,8287,1350,9637
25140,Ethelbert,Scola,escolaee@unesco.org,Paralegal,1356,1432,2788
25879,Thacher,Hefferon,thefferoneg@goo.ne.jp,Chemical Engineer,1339,1487,2826
25609,Jaine,Clemensen,jclemenseneh@mapy.cz,Food Chemist,6298,1169,7467
25420,Riva,Gasticke,rgastickeej@princeton.edu,Product Engineer,7799,907,8706
25234,Kira,Guntrip,kguntripen@utexas.edu,VP Marketing,8802,777,9579
25987,Linc,Barus,lbarusep@odnoklassniki.ru,Graphic Designer,2134,739,2873
25299,Rodney,Bumphrey,rbumphreyer@ftc.gov,Help Desk Technician,6058,275,6333
25024,Rowena,Mellody,rmellodyes@marriott.com,Dental Hygienist,9077,258,9335
25013,Randall,Banisch,rbanischet@trellian.com,Information Systems Manager,6246,1484,7730
25163,Amara,Dunster,adunstereu@google.co.jp,Senior Financial Analyst,9296,1004,10300
25900,Jody,O'Fogarty,jofogartyev@bing.com,Senior Editor,5761,1243,7004
25753,Robinetta,Dionisio,rdionisioew@nbcnews.com,Administrative Officer,9949,1023,10972
25113,Keen,Cotmore,kcotmoreex@latimes.com,Web Developer I,1884,789,2673
25961,Karmen,Greenland,kgreenlandey@admin.ch,Staff Scientist,4309,471,4780
25821,Daune,Fallowes,dfallowesf1@cnbc.com,Software Test Engineer III,9822,1982,11804
25840,Jacquie,Blackburne,jblackburnef2@youku.com,Electrical Engineer,3667,1880,5547
25001,Monique,McPeake,mmcpeakef3@yahoo.co.jp,Health Coach IV,9711,340,10051
25067,Jordana,Blader,jbladerf4@phpbb.com,Librarian,3269,546,3815
25670,Josie,Churms,jchurmsf7@seesaa.net,Technical Writer,7633,696,8329
25982,Marika,Dymond,mdymondf9@howstuffworks.com,Assistant Professor,6548,431,6979
25516,Ernie,Gopsall,egopsallfa@hc360.com,Nuclear Power Engineer,5834,1384,7218
25694,Merrielle,Wisam,mwisamfc@youku.com,Automation Specialist III,5809,813,6622
25486,Joy,Fairhurst,jfairhurstfd@ca.gov,Director of Sales,3916,1499,5415
25660,Humfrey,Sanham,hsanhamfe@etsy.com,Teacher,7121,956,8077
25544,Perry,Rhymer,prhymerff@soundcloud.com,Accounting Assistant II,2375,1269,3644
25501,Brianne,Firman,bfirmanfg@reverbnation.com,Account Representative IV,6873,330,7203
25134,Ealasaid,Gannaway,egannawayfh@woothemes.com,Sales Associate,8279,1340,9619
25495,Ezequiel,Passe,epassefl@blogger.com,Paralegal,6652,1336,7988
25119,Alexine,Shavel,ashavelfm@prweb.com,Human Resources Assistant I,7696,221,7917
25129,Rosalinda,Smithyman,rsmithymanfo@bravesites.com,Environmental Specialist,3381,1741,5122
25880,Alene,Stoade,astoadefp@twitter.com,Quality Engineer,6046,863,6909
25570,Erminie,Leyden,eleydenfq@jigsy.com,Senior Cost Accountant,1110,1330,2440
25440,Dulcia,Kernock,dkernockfs@engadget.com,Administrative Officer,2110,515,2625
25897,Evonne,Kaming,ekamingft@reference.com,Editor,8990,1054,10044
25332,Shelagh,Philippou,sphilippoufw@goodreads.com,Engineer I,8508,1535,10043
25446,Jillie,Hollyer,jhollyerfx@eepurl.com,Tax Accountant,4033,730,4763
25848,Barnett,Timmes,btimmesfy@discuz.net,Marketing Assistant,5988,1035,7023
25998,Sharline,Rodear,srodearg0@free.fr,Geologist II,4416,1982,6398
25668,Cicely,Harflete,charfleteg1@nifty.com,General Manager,2043,1909,3952
25147,Chrissy,Giddins,cgiddinsg2@pagesperso-orange.fr,Paralegal,6324,1710,8034
25496,Marcelline,Stallard,mstallardg4@ning.com,Pharmacist,9730,775,10505
25127,Melicent,Coumbe,mcoumbeg6@angelfire.com,Human Resources Manager,9399,432,9831
25951,Fabio,Giotto,fgiottog7@linkedin.com,Geologist I,4783,1058,5841
25832,Berke,Mutter,bmutterg8@unblog.fr,Staff Scientist,3568,296,3864
25318,Alix,Goreisr,agoreisrgc@ibm.com,Biostatistician II,4489,844,5333
25567,Hillel,Ewbank,hewbankgd@list-manage.com,Nurse,7782,752,8534
25191,Lark,Housam,lhousamgf@over-blog.com,Research Assistant IV,1023,635,1658
25513,Halie,Daleman,hdalemangg@sfgate.com,Nurse,1903,1732,3635
25002,Sunny,Schonfeld,sschonfeldgh@nba.com,Registered Nurse,9916,702,10618
25492,Eal,Galle,egallegi@sourceforge.net,Computer Systems Analyst IV,4950,1907,6857
25730,Lorne,Piperley,lpiperleygl@sohu.com,Staff Scientist,9926,758,10684
25439,Amalle,Willeman,awillemangq@xing.com,Web Developer II,5722,1155,6877
25689,Nadeen,Rees,nreesgr@vinaora.com,Research Associate,6000,595,6595
25755,Leigh,Challenger,lchallengergt@google.es,Senior Financial Analyst,4691,1879,6570
25918,Coriss,Seamer,cseamergv@columbia.edu,Programmer Analyst I,6244,1032,7276
25174,Ofilia,Gogerty,ogogertygx@pen.io,Recruiting Manager,3156,1119,4275
25255,Beilul,Kemery,bkemerygz@networksolutions.com,Budget/Accounting Analyst I,8006,747,8753
25654,Nerty,Ronnay,nronnayh0@dailymotion.com,Desktop Support Technician,2955,1483,4438
25020,Pavia,Ferrand,pferrandh1@zdnet.com,Analog Circuit Design manager,6156,249,6405
25259,Cacilia,Durgan,cdurganh4@ihg.com,Pharmacist,2689,1738,4427
25005,Verla,Ordish,vordishh5@nih.gov,Cost Accountant,3578,1755,5333
25503,Dorena,Smurfitt,dsmurfitth7@usgs.gov,Assistant Media Planner,5525,376,5901
25739,Novelia,Setter,nsetterhd@friendfeed.com,Senior Developer,8223,748,8971
25413,Cecile,Brookes,cbrookeshg@ft.com,Help Desk Operator,9402,1538,10940
25853,Wallis,Goskar,wgoskarhn@symantec.com,Nuclear Power Engineer,1937,1532,3469
25239,Samara,Cabrales,scabralesho@posterous.com,Automation Specialist III,9095,1382,10477
25627,Suzette,Island,sislandhp@pen.io,Help Desk Technician,8460,1412,9872
25396,Christophorus,Maas,cmaashr@purevolume.com,Human Resources Manager,2289,1933,4222
25534,Delcina,Mozzi,dmozzihv@eepurl.com,Human Resources Assistant I,5354,884,6238
25870,Mira,Sowle,msowlehw@so-net.ne.jp,Media Manager I,7632,1628,9260
25465,Laney,Castanyer,lcastanyeri3@over-blog.com,Technical Writer,7635,1527,9162
25427,Meriel,Grattage,mgrattagei5@blogger.com,Librarian,4719,746,5465
25071,Brook,Nickols,bnickolsi6@drupal.org,Software Engineer II,4253,1322,5575
25434,Janine,Heis,jheisi7@blog.com,Sales Associate,5169,1474,6643
25359,Jarrad,Redmayne,jredmaynei8@ed.gov,Account Coordinator,8077,608,8685
25292,Massimiliano,Netti,mnettiia@dailymotion.com,Electrical Engineer,3680,1459,5139
25866,Piggy,Banbrook,pbanbrookic@skype.com,Cost Accountant,9867,1401,11268
25210,Wallas,Windus,wwindusie@artisteer.com,Junior Executive,4424,1102,5526
25428,Waite,Sorsbie,wsorsbieif@goodreads.com,Senior Developer,7076,1582,8658
25978,Torrence,Ruslin,truslinih@smugmug.com,Mechanical Systems Engineer,4742,1965,6707
25449,Stanton,Albinson,salbinsonii@eventbrite.com,Speech Pathologist,9918,639,10557
25675,Venita,Crowth,vcrowthij@chron.com,Technical Writer,3589,1250,4839
26000,Evita,Galpen,egalpenik@wikipedia.org,Project Manager,6209,441,6650
25935,Randolf,Seignior,rseigniorim@cornell.edu,VP Sales,1320,457,1777
25672,Erskine,Meneghelli,emeneghelliir@google.com.au,Environmental Specialist,3335,280,3615
25141,Maurise,Tummons,mtummonsis@rakuten.co.jp,General Manager,9008,1249,10257
25904,Jordan,Scarlin,jscarliniu@yellowbook.com,Occupational Therapist,1501,1229,2730
25122,Gloria,Brelsford,gbrelsfordiv@chicagotribune.com,Design Engineer,7669,852,8521
25182,Netty,McColm,nmccolmiw@state.gov,Executive Secretary,2734,1119,3853
25610,Jessie,Colvin,jcolvinix@salon.com,Structural Engineer,4096,364,4460
25112,Christiano,Saggers,csaggersiy@soup.io,Actuary,9803,500,10303
25451,Valerye,Ca,vcaiz@homestead.com,Senior Editor,2246,1563,3809
25552,Marjie,Juzek,mjuzekj2@geocities.com,Recruiter,7973,1389,9362
25916,Rip,Longson,rlongsonj4@wufoo.com,Assistant Professor,9936,385,10321
25808,Michell,Madine,mmadinej6@cbc.ca,Data Coordiator,5362,700,6062
25220,Rheba,Tilmouth,rtilmouthj7@microsoft.com,VP Marketing,9120,631,9751
25639,Jacquette,Chieze,jchiezeje@hhs.gov,Financial Advisor,6129,967,7096
25980,Harlin,Perin,hperinjf@sfgate.com,Assistant Media Planner,2783,1334,4117
25597,Ardra,Stidson,astidsonjg@google.es,Quality Control Specialist,8993,1866,10859
25736,Xaviera,McCuffie,xmccuffiejj@hud.gov,General Manager,2930,1903,4833
25107,Izabel,Ferenczi,iferenczijk@sourceforge.net,Dental Hygienist,4864,1106,5970
25144,Kellyann,Agott,kagottjl@sfgate.com,Professor,8075,456,8531
25444,Misty,Selcraig,mselcraigjm@icq.com,Electrical Engineer,1810,1532,3342
25252,Emelyne,Willerton,ewillertonjp@devhub.com,Associate Professor,8177,903,9080
25750,Hayley,Guisby,hguisbyjq@wisc.edu,Media Manager II,7684,1612,9296
25646,Glyn,Kipling,gkiplingjt@miibeian.gov.cn,Environmental Tech,9842,1687,11529
25679,Thoma,Petry,tpetryju@purevolume.com,Staff Scientist,3056,1137,4193
25008,Alina,Eingerfield,aeingerfieldjy@mysql.com,Engineer III,9993,969,10962
25240,Sharon,Girogetti,sgirogettik2@rediff.com,Payment Adjustment Coordinator,1786,870,2656
25029,Martha,Felgat,mfelgatk3@amazon.co.jp,Account Coordinator,4147,1507,5654
25094,Benjamin,Chatin,bchatink5@cloudflare.com,Food Chemist,2587,1473,4060
25405,Celestyn,Wolseley,cwolseleyka@seesaa.net,Business Systems Development Analyst,9045,239,9284
25416,Inger,Gayler,igaylerkb@usgs.gov,Web Designer III,4534,559,5093
25751,Findlay,Lopez,flopezkc@seesaa.net,Product Engineer,5353,1278,6631
25312,Ryley,Doige,rdoigekd@freewebs.com,Automation Specialist III,8081,1689,9770
25932,Casar,Turford,cturfordke@phpbb.com,Senior Cost Accountant,1973,524,2497
25368,Jephthah,Shepherdson,jshepherdsonkf@dmoz.org,Senior Developer,5392,1172,6564
25297,Rogerio,Burgott,rburgottki@eventbrite.com,Programmer I,5446,768,6214
25729,Baxy,Cuncliffe,bcuncliffekj@google.ca,Computer Systems Analyst I,3749,762,4511
25111,Belia,Klambt,bklambtkl@msu.edu,Human Resources Manager,3378,1125,4503
25380,Elroy,Boyd,eboydkm@shop-pro.jp,Nuclear Power Engineer,7576,1920,9496
25307,Simona,Bodesson,sbodessonkq@dedecms.com,Account Coordinator,6418,1128,7546
25558,Silvana,Triggol,striggolkv@blinklist.com,Associate Professor,4957,665,5622
25432,Vida,Silbermann,vsilbermannkw@google.com.hk,Junior Executive,5177,1638,6815
25885,Michel,Rathe,mrathekx@sina.com.cn,Staff Accountant IV,2017,855,2872
25869,Donella,Downham,ddownhamkz@sfgate.com,Sales Representative,2212,295,2507
25085,Jorrie,Artus,jartusl1@cbslocal.com,Staff Scientist,7840,1204,9044
25526,Charity,Latehouse,clatehousel2@dagondesign.com,Environmental Specialist,3641,842,4483
25624,Shani,Pluvier,spluvierl4@nps.gov,Registered Nurse,3534,892,4426
25861,Eberto,Panketh,epankethl6@zdnet.com,Research Associate,6406,501,6907
25477,Alasdair,Clerc,aclercl8@mapquest.com,Research Nurse,7217,1590,8807
25311,Tonye,Heinssen,theinssenla@yahoo.co.jp,Senior Quality Engineer,5840,1529,7369
25820,Mahala,Broadist,mbroadistlc@blogspot.com,Nurse,1715,1712,3427
25216,Horace,Ebbrell,hebbrelllg@va.gov,Director of Sales,4873,500,5373
25774,Lianne,Thebeau,lthebeauli@wordpress.com,Programmer II,6613,433,7046
25229,Bendick,Kempshall,bkempshalllk@topsy.com,Environmental Tech,1340,1343,2683
25906,Adela,Dilnot,adilnotll@nytimes.com,Electrical Engineer,6425,516,6941
25529,Kiel,Jeays,kjeayslo@spotify.com,Nuclear Power Engineer,2027,989,3016
25562,Ross,Farfull,rfarfulllp@nature.com,VP Sales,3716,1220,4936
25536,Culley,Mazzilli,cmazzillilq@woothemes.com,Assistant Media Planner,6938,955,7893
25706,Xever,Kovnot,xkovnotlr@cbsnews.com,Financial Analyst,9745,1044,10789
25320,Chevy,Grishakin,cgrishakinlx@nsw.gov.au,Office Assistant II,4454,677,5131
25659,Dagmar,Lovelock,dlovelockly@slate.com,Sales Representative,5563,1010,6573
25842,Frederik,Templeman,ftemplemanlz@cocolog-nifty.com,Technical Writer,2121,232,2353
25664,Rita,Seamen,rseamenm1@joomla.org,Project Manager,8154,970,9124
25713,Arnold,Cessford,acessfordm2@army.mil,Mechanical Systems Engineer,3869,1217,5086
25933,Alec,Sloss,aslossm5@nih.gov,Paralegal,1165,338,1503
25037,Kendell,Vanichev,kvanichevm9@myspace.com,Product Engineer,8790,387,9177
25512,Pascal,Holley,pholleyma@list-manage.com,Chief Design Engineer,3218,1710,4928
25236,Rozelle,Senn,rsennmb@cbsnews.com,Senior Editor,6817,1580,8397
25530,Nikita,Dangerfield,ndangerfieldme@ft.com,Quality Control Specialist,8023,313,8336
25158,Debora,Udell,dudellmh@prlog.org,Nuclear Power Engineer,5625,1013,6638
25260,Cass,Leil,cleilmk@ovh.net,Assistant Manager,2866,1330,4196
25824,Idette,Woolbrook,iwoolbrookmm@gravatar.com,Sales Associate,4679,1651,6330
25095,Artemis,Orteau,aorteaumn@mit.edu,Dental Hygienist,9889,914,10803
25953,Margie,Woloschinski,mwoloschinskimp@wiley.com,Health Coach II,1535,1701,3236
25218,Chas,Malkie,cmalkiemt@berkeley.edu,Account Coordinator,3974,1793,5767
25367,Shellie,Labern,slabernmu@twitter.com,Junior Executive,5562,217,5779
25331,Camila,Loody,cloodymv@cdc.gov,Nurse,3454,1720,5174
25532,Clarie,Murrison,cmurrisonmx@nps.gov,Accounting Assistant III,2401,1451,3852
25151,Alene,Jurgen,ajurgenn1@independent.co.uk,Food Chemist,6152,1889,8041
25837,Emmeline,Crannell,ecrannelln3@ucsd.edu,Graphic Designer,9522,1687,11209
25849,Babette,Paulin,bpaulinn4@auda.org.au,Administrative Assistant IV,5938,1228,7166
25099,Nickie,Cardew,ncardewnd@posterous.com,Research Assistant I,1409,787,2196
25656,Renault,Shreeves,rshreevesne@themeforest.net,Administrative Officer,6563,223,6786
25098,Reena,Cahani,rcahaning@slashdot.org,Assistant Media Planner,7046,787,7833
25860,Aeriel,Aujean,aaujeannh@craigslist.org,Actuary,5309,985,6294
25773,Sidnee,Hugli,shuglini@wiley.com,Structural Analysis Engineer,5021,690,5711
25572,Eolande,Adnams,eadnamsnj@constantcontact.com,Mechanical Systems Engineer,1065,459,1524
25907,Emmanuel,Milliere,emillierenk@weebly.com,Librarian,1902,1045,2947
25912,Bentlee,Boldero,bbolderonm@naver.com,Help Desk Technician,5109,983,6092
25057,Delmer,Scurrah,dscurrahnn@reverbnation.com,Office Assistant II,4641,1057,5698
25855,Tawsha,Antonutti,tantonuttinp@bloomberg.com,Civil Engineer,3866,736,4602
25415,Anette,Scorton,ascortonnv@gizmodo.com,Software Consultant,6359,1226,7585
25858,Farrel,Cullon,fcullonnw@ow.ly,Structural Engineer,2794,792,3586
25373,Bethanne,Toupe,btoupeny@earthlink.net,Payment Adjustment Coordinator,7856,722,8578
25791,Charlotte,Dorbin,cdorbinnz@dailymail.co.uk,Safety Technician I,4057,1932,5989
25565,Haleigh,Dumbare,hdumbareo0@vk.com,Food Chemist,8585,954,9539
25347,Terrill,Summons,tsummonso1@google.com.br,Programmer Analyst III,8213,796,9009
25657,Hulda,Eldin,heldino2@businessweek.com,Graphic Designer,6824,1330,8154
25515,Rowland,Poundsford,rpoundsfordo8@opensource.org,Sales Representative,3846,252,4098
25676,Gale,Feeny,gfeenyob@xinhuanet.com,VP Sales,6908,1496,8404
25487,Packston,Corbett,pcorbettoe@trellian.com,Mechanical Systems Engineer,1067,1438,2505
25944,Olivette,Cottu,ocottuoi@prnewswire.com,Programmer IV,4860,997,5857
25233,Terrence,Cawker,tcawkeroj@marketwatch.com,Recruiter,7322,640,7962
25441,Arlette,Goly,agolyok@123-reg.co.uk,Tax Accountant,1649,538,2187
25186,Loella,Bartoleyn,lbartoleynom@ezinearticles.com,Design Engineer,1854,305,2159
25966,Marleen,Gallamore,mgallamoreoo@prnewswire.com,Account Representative IV,3364,881,4245
25498,Kizzie,Bernardini,kbernardinioq@admin.ch,Civil Engineer,1194,646,1840
25716,Lance,Jaulme,ljaulmeor@live.com,Marketing Assistant,1191,1329,2520
25551,Anton,Tooth,atoothos@ovh.net,Sales Associate,8918,1073,9991
25686,Byran,Sholl,bshollou@bing.com,Staff Accountant I,9180,733,9913
25414,Catherin,Tureville,cturevillep3@icq.com,Marketing Manager,9854,835,10689
25321,Spense,Andreacci,sandreaccipa@ask.com,Database Administrator I,2513,1939,4452
25247,Kacie,Proger,kprogerpd@4shared.com,Librarian,2805,507,3312
25246,Isabeau,Yegoshin,iyegoshinpf@purevolume.com,Administrative Officer,6608,1748,8356
25150,Terence,Shank,tshankph@bloomberg.com,Senior Developer,6168,650,6818
25087,Mohammed,Dawnay,mdawnaypj@oracle.com,Professor,9697,1126,10823
25133,Benoit,Tock,btockpl@scribd.com,Teacher,5618,1913,7531
25330,Kathye,Espinosa,kespinosapm@tripadvisor.com,Technical Writer,4004,1937,5941
25072,Delmer,Aulton,daultonpo@google.ru,Librarian,7457,292,7749
25304,Olenolin,Oldfield-Cherry,ooldfieldcherryps@netvibes.com,Physical Therapy Assistant,2661,283,2944
25209,Iona,Bockmaster,ibockmasterpt@thetimes.co.uk,Actuary,3211,1319,4530
25378,Lela,Dragoe,ldragoepw@constantcontact.com,Programmer Analyst I,3464,1052,4516
25587,Amye,Flatt,aflattpx@imgur.com,Editor,9278,1493,10771
25684,Templeton,Kilbride,tkilbrideq0@stanford.edu,Recruiting Manager,3856,876,4732
25392,Emlyn,Cronin,ecroninq1@house.gov,Media Manager II,2545,856,3401
25375,Sophronia,Janew,sjanewq3@buzzfeed.com,Research Nurse,7924,1886,9810
25187,Matilda,Bizzey,mbizzeyq8@weebly.com,Safety Technician IV,1363,585,1948
25662,Joseph,Eberdt,jeberdtq9@wordpress.org,Account Coordinator,5800,588,6388
25629,Laure,Hencke,lhenckeqb@yahoo.com,Technical Writer,1970,1402,3372
25586,Inesita,Leftley,ileftleyqd@answers.com,Statistician III,3345,772,4117
25390,Bevon,Povey,bpoveyqk@edublogs.org,Recruiter,8254,523,8777
25910,Florentia,Stuckford,fstuckfordqo@skyrock.com,Clinical Specialist,2280,1666,3946
25590,Kaspar,Meddows,kmeddowsqs@wordpress.org,Graphic Designer,4715,1384,6099
25719,Tiffanie,Barstock,tbarstockqt@diigo.com,Community Outreach Specialist,2218,1402,3620
25219,Fernande,Hatherell,fhatherellqv@skyrock.com,Junior Executive,1068,1192,2260
25833,Kakalina,O'Loughlin,koloughlinqz@tmall.com,Mechanical Systems Engineer,3163,325,3488
25484,Nata,Dawnay,ndawnayr1@nature.com,Analyst Programmer,9437,800,10237
25561,Heda,Depka,hdepkar3@indiegogo.com,Assistant Manager,4766,1889,6655
25430,Skipp,Craine,scrainer5@chronoengine.com,Chemical Engineer,1964,739,2703
25992,Rora,Chaney,rchaneyra@hibu.com,Director of Sales,8285,1171,9456
25243,Leela,Le Guin,lleguinrl@slashdot.org,Computer Systems Analyst II,4881,1293,6174
25566,Talbert,Lampert,tlampertrm@uol.com.br,Compensation Analyst,8742,1872,10614
25638,Bill,Prattin,bprattinrp@studiopress.com,Geologist IV,4538,1032,5570
25616,Jo-anne,Itzik,jitzikrq@unicef.org,Sales Representative,1736,607,2343
26631,Midge,Wadforth,mwadforth0@youtu.be,Civil Engineer,4380,1847,6227
26812,Ruthe,Chasson,rchasson1@woothemes.com,Product Engineer,1684,701,2385
26425,Standford,Brozsset,sbrozsset2@va.gov,Geologist I,7219,1076,8295
26346,Helene,Greer,hgreer3@twitter.com,Compensation Analyst,9908,867,10775
26918,Heriberto,Hicklingbottom,hhicklingbottom4@rakuten.co.jp,Automation Specialist I,8246,1771,10017
26416,Reggie,Grover,rgrover5@sourceforge.net,Speech Pathologist,2050,374,2424
26579,Nikolia,Brewin,nbrewin6@wikispaces.com,Civil Engineer,7067,1187,8254
26966,Sebastien,Dollin,sdollin7@bbb.org,Payment Adjustment Coordinator,3470,1053,4523
26185,Tan,Fairbeard,tfairbeard8@google.com,Quality Engineer,9454,660,10114
26909,Selia,Hambleton,shambleton9@sitemeter.com,VP Accounting,9247,1625,10872
26066,Brendin,Murdoch,bmurdocha@mozilla.com,Internal Auditor,5024,1235,6259
26827,Amelina,Denerley,adenerleyb@umn.edu,Environmental Specialist,8379,1747,10126
26564,Niles,Poveleye,npoveleyec@fema.gov,Project Manager,6341,1265,7606
26334,Manfred,Orviss,morvissd@mtv.com,Financial Analyst,9535,1497,11032
26329,Nappy,Malicki,nmalickie@artisteer.com,Dental Hygienist,2509,1443,3952
26758,Michaelina,Lower,mlowerf@pbs.org,Human Resources Manager,6137,1788,7925
26670,Boyd,Kimble,bkimbleg@gravatar.com,Senior Editor,1030,1337,2367
26700,Codee,Telling,ctellingh@histats.com,Senior Financial Analyst,1521,345,1866
26298,Ezra,Danford,edanfordi@wired.com,Social Worker,9723,1232,10955
26036,Bethena,Laidler,blaidlerj@geocities.jp,Safety Technician II,8156,569,8725
26449,Trixi,Adaway,tadawayk@usgs.gov,General Manager,2069,758,2827
26908,Adams,Satterlee,asatterleel@ucoz.com,Administrative Officer,7245,1223,8468
26491,Tulley,Probert,tprobertm@weather.com,GIS Technical Architect,2537,1573,4110
26293,Mackenzie,Finnis,mfinnisn@miitbeian.gov.cn,Physical Therapy Assistant,9014,1775,10789
26097,Betty,Lathan,blathano@earthlink.net,Human Resources Assistant II,2845,1950,4795
26071,Maddi,Duval,mduvalp@yellowpages.com,Civil Engineer,6777,1158,7935
26721,Kim,Wotherspoon,kwotherspoonq@vinaora.com,Programmer I,3493,382,3875
26524,Kinny,Janssen,kjanssenr@tiny.cc,Chief Design Engineer,1250,863,2113
26283,Vanna,Gunney,vgunneys@umn.edu,Operator,9750,1577,11327
26073,Prudy,Ruberti,prubertit@miibeian.gov.cn,Graphic Designer,6321,909,7230
26852,Arthur,Wakely,awakelyu@state.tx.us,Office Assistant IV,9097,1957,11054
26234,Kyle,Speedin,kspeedinv@irs.gov,Systems Administrator II,4951,1188,6139
26795,Eddie,Rayson,eraysonw@4shared.com,Biostatistician III,8829,617,9446
26301,Heath,Barrow,hbarrowx@cmu.edu,Electrical Engineer,1864,1413,3277
26179,Ada,Joscelin,ajosceliny@xing.com,Engineer IV,4853,1663,6516
26744,Asa,Saddleton,asaddletonz@theguardian.com,Automation Specialist IV,2582,352,2934
26213,Candace,Probbings,cprobbings10@bloglovin.com,Human Resources Assistant I,8181,1217,9398
26695,Hodge,Garton,hgarton11@usnews.com,Quality Control Specialist,3359,552,3911
26507,Cherish,Smewin,csmewin12@prweb.com,Product Engineer,3853,461,4314
26582,Guendolen,Prothero,gprothero13@state.gov,Help Desk Operator,2282,1083,3365
26353,Arnuad,Lyttle,alyttle14@google.pl,Executive Secretary,2796,1466,4262
26840,Stace,Aronovich,saronovich15@parallels.com,Senior Sales Associate,8917,1690,10607
26296,Christiano,Sconce,csconce16@dailymotion.com,Cost Accountant,2293,1084,3377
26374,Bobbee,Hounihan,bhounihan17@wikispaces.com,Recruiter,4721,252,4973
26328,Claudia,Noell,cnoell18@eventbrite.com,Software Consultant,7648,1348,8996
26829,Fleurette,Klessmann,fklessmann19@rambler.ru,Administrative Assistant III,8701,362,9063
26527,Tabbatha,Collen,tcollen1a@cbslocal.com,Data Coordiator,7518,1902,9420
26392,Torin,Dunley,tdunley1b@gov.uk,Sales Associate,1789,1575,3364
26474,Hannie,Kruse,hkruse1c@deliciousdays.com,Engineer II,8565,1867,10432
26555,Farleigh,Gerren,fgerren1d@mail.ru,Office Assistant IV,9723,1950,11673
26431,Irwin,Yvens,iyvens1e@xinhuanet.com,Senior Editor,6589,1260,7849
26249,Catha,Finan,cfinan1f@taobao.com,Administrative Officer,6280,1677,7957
26835,Owen,Oloshkin,ooloshkin1g@xinhuanet.com,Nurse,9310,284,9594
26677,Arlan,Aizik,aaizik1h@github.io,Sales Associate,1542,898,2440
26788,Sheelagh,McPeeters,smcpeeters1i@ow.ly,Desktop Support Technician,5113,1828,6941
26114,Walt,Fettis,wfettis1j@multiply.com,Registered Nurse,9493,1080,10573
26993,Melvyn,Pleager,mpleager1k@bluehost.com,Food Chemist,6048,1823,7871
26377,Merill,Ferrey,mferrey1l@google.com.br,Chief Design Engineer,9134,1855,10989
26093,Franklin,Marchbank,fmarchbank1m@smugmug.com,VP Quality Control,8048,556,8604
26727,Farra,D' Angelo,fdangelo1n@va.gov,Associate Professor,5579,1781,7360
26451,Spike,Higounet,shigounet1o@typepad.com,Safety Technician II,1632,240,1872
26706,Penelopa,Alstead,palstead1p@examiner.com,Software Test Engineer IV,6094,1833,7927
26941,Loella,Guillerman,lguillerman1q@mail.ru,Compensation Analyst,1783,821,2604
26287,Torr,Baudon,tbaudon1r@woothemes.com,Accountant I,3566,1169,4735
26589,Rhodie,Kornacki,rkornacki1s@imdb.com,Help Desk Technician,2765,616,3381
26825,Danna,Dy,ddy1t@blinklist.com,Technical Writer,2964,1721,4685
26671,Trula,Clarricoates,tclarricoates1u@godaddy.com,Pharmacist,9194,1554,10748
26025,Nanete,McNevin,nmcnevin1v@chron.com,Librarian,3190,1151,4341
26673,Joanie,Errigo,jerrigo1w@cafepress.com,Community Outreach Specialist,9178,1283,10461
26395,Sile,Napolitano,snapolitano1x@rakuten.co.jp,Accounting Assistant I,1206,1135,2341
26045,Ranique,Wimes,rwimes1y@google.com.hk,Graphic Designer,6528,1466,7994
26445,Olimpia,Berrane,oberrane1z@google.pl,Editor,9849,1369,11218
26864,Aeriela,Palffrey,apalffrey20@scribd.com,Business Systems Development Analyst,8007,387,8394
26062,Cornelle,Lombard,clombard21@moonfruit.com,Librarian,5562,414,5976
26042,Clayborn,Durrant,cdurrant22@spotify.com,Programmer I,6835,392,7227
26709,Lyda,Kasper,lkasper23@cbslocal.com,Legal Assistant,7819,789,8608
26845,Flora,Gloy,fgloy24@businessweek.com,Senior Quality Engineer,1782,705,2487
26571,Celestina,Oxenham,coxenham25@ca.gov,Librarian,5191,1024,6215
26535,Drew,Redit,dredit26@seesaa.net,Web Developer I,5745,439,6184
26616,Gonzalo,Le Marquis,glemarquis27@comcast.net,Actuary,9447,1827,11274
26505,Hal,Josilevich,hjosilevich28@twitter.com,Help Desk Technician,9793,1227,11020
26563,Nananne,De la Yglesia,ndelayglesia2a@msn.com,Chief Design Engineer,2948,1319,4267
26077,Justinn,Lehmann,jlehmann2b@xrea.com,Administrative Officer,2383,249,2632
26263,Allie,Gravells,agravells2c@netvibes.com,Editor,7719,316,8035
26679,Kalil,Palphreyman,kpalphreyman2d@nytimes.com,Tax Accountant,1612,1122,2734
26479,Renee,Gaven,rgaven2e@symantec.com,Editor,9428,1516,10944
26914,Reece,Toward,rtoward2f@eepurl.com,Executive Secretary,9256,1091,10347
26848,Vevay,Coniam,vconiam2g@alexa.com,Project Manager,3370,963,4333
26756,Oona,Belz,obelz2h@hao123.com,Sales Representative,3872,1075,4947
26260,Orelia,Pennrington,opennrington2i@google.co.jp,Nurse,6035,1534,7569
26714,Shawn,Kubacki,skubacki2j@mlb.com,Paralegal,4016,1538,5554
26103,Rolland,Venard,rvenard2k@latimes.com,Administrative Officer,4958,1124,6082
26202,Kandace,Birrane,kbirrane2l@taobao.com,Quality Control Specialist,1822,1006,2828
26207,Panchito,Gerbi,pgerbi2m@nyu.edu,Engineer II,9502,2000,11502
26348,Jermain,Shoorbrooke,jshoorbrooke2n@webeden.co.uk,Account Representative III,7390,1713,9103
26830,Andeee,Scrivinor,ascrivinor2o@woothemes.com,Biostatistician IV,8968,1870,10838
26400,Ric,O'Shiel,roshiel2p@ning.com,Tax Accountant,4678,348,5026
26655,Sukey,Seabourne,sseabourne2q@stanford.edu,Financial Analyst,4335,324,4659
26391,Suzi,Brechin,sbrechin2r@ask.com,Accounting Assistant IV,2187,1629,3816
26203,Gauthier,Sallinger,gsallinger2s@walmart.com,Desktop Support Technician,7861,801,8662
26823,Elissa,Sapseed,esapseed2t@instagram.com,Food Chemist,2096,1582,3678
26089,Yule,Flescher,yflescher2u@elegantthemes.com,Assistant Professor,6280,1586,7866
26794,Isahella,Stallard,istallard2v@patch.com,Associate Professor,9847,491,10338
26980,Sherie,Sumsion,ssumsion2w@prnewswire.com,Senior Cost Accountant,9178,1944,11122
26715,Rossie,Kirman,rkirman2x@nbcnews.com,Operator,1695,1493,3188
26836,Brandi,Woodlands,bwoodlands2y@tmall.com,Marketing Assistant,7070,326,7396
26454,Tiffie,Grinsted,tgrinsted2z@spotify.com,Electrical Engineer,6818,1098,7916
26109,Xaviera,Pharrow,xpharrow30@free.fr,Analog Circuit Design manager,5102,873,5975
26204,Nicolais,Hendrikse,nhendrikse31@typepad.com,Sales Representative,4060,287,4347
26486,Rebeka,Roderick,rroderick32@dedecms.com,Librarian,4957,1693,6650
26870,Rudolfo,Snare,rsnare33@de.vu,VP Accounting,8028,1958,9986
26741,Chan,Lyddy,clyddy34@skyrock.com,Assistant Media Planner,9464,1176,10640
26753,Elizabeth,Mateo,emateo35@cyberchimps.com,Financial Analyst,1695,214,1909
26526,Alleen,Shergill,ashergill36@skype.com,Systems Administrator I,5973,1055,7028
26837,Barnabe,Gilliver,bgilliver37@illinois.edu,Graphic Designer,7258,1679,8937
26396,Nessi,Matevushev,nmatevushev38@google.de,Automation Specialist II,3554,1511,5065
26271,Guido,Dowsett,gdowsett39@dell.com,Analyst Programmer,9514,422,9936
26258,Demetria,Eberdt,deberdt3a@imgur.com,GIS Technical Architect,1739,524,2263
26028,Tami,Flaherty,tflaherty3b@shutterfly.com,Librarian,3668,1483,5151
26194,Nikoletta,Kembrey,nkembrey3c@comsenz.com,Administrative Officer,7433,1638,9071
26412,Clemmie,Giacobillo,cgiacobillo3d@zdnet.com,Speech Pathologist,9845,1338,11183
26250,Zia,Cockshoot,zcockshoot3e@hp.com,Senior Developer,3198,507,3705
26654,Berti,Cabena,bcabena3g@intel.com,Social Worker,7739,1122,8861
26754,Gram,Mason,gmason3h@webmd.com,Web Developer IV,9658,842,10500
26844,Aridatha,Paiton,apaiton3i@weebly.com,Information Systems Manager,7819,964,8783
26791,Luce,Sima,lsima3j@xing.com,Technical Writer,2770,1472,4242
26297,Hilary,Dyott,hdyott3k@nba.com,Professor,3131,1613,4744
26278,Hillery,Haddrell,hhaddrell3l@netscape.com,Sales Representative,8144,707,8851
26471,Arman,Pendlebery,apendlebery3m@nsw.gov.au,General Manager,7678,580,8258
26083,Amii,Oakhill,aoakhill3o@tripod.com,Legal Assistant,4270,1401,5671
26362,Kathrine,Conkey,kconkey3p@slate.com,Business Systems Development Analyst,5656,373,6029
26363,Maggi,Hegg,mhegg3q@sfgate.com,Geological Engineer,4755,939,5694
26685,Craggie,Scinelli,cscinelli3r@weibo.com,Nuclear Power Engineer,8782,1436,10218
26595,Jehu,Detloff,jdetloff3s@latimes.com,Structural Analysis Engineer,6465,1808,8273
26688,Archy,Garken,agarken3t@linkedin.com,Statistician IV,2868,1542,4410
26647,Patton,Jolliss,pjolliss3u@ca.gov,Research Assistant II,6691,1134,7825
26739,Jillayne,Braam,jbraam3v@washingtonpost.com,VP Marketing,4707,1302,6009
26008,Yule,Cresser,ycresser3w@acquirethisname.com,Web Developer IV,6140,926,7066
26642,Ellyn,De Malchar,edemalchar3x@ow.ly,Safety Technician III,6549,694,7243
26389,Hussein,Trewin,htrewin3y@51.la,Design Engineer,3929,950,4879
26088,Noak,Rediers,nrediers3z@nsw.gov.au,General Manager,5407,521,5928
26653,Hyacintha,Gravet,hgravet40@aboutads.info,Professor,4027,1675,5702
26143,Rawley,Covert,rcovert41@intel.com,Marketing Assistant,9679,1469,11148
26056,Nonah,Styant,nstyant42@webeden.co.uk,Developer III,7763,1792,9555
26784,Bruno,Bartoshevich,bbartoshevich43@exblog.jp,Senior Cost Accountant,2374,913,3287
26529,Clarice,Ranahan,cranahan44@shinystat.com,Environmental Tech,6154,1900,8054
26663,Lyle,Clash,lclash45@dedecms.com,Accounting Assistant II,1458,1049,2507
26052,Paulina,Champley,pchampley48@163.com,Analyst Programmer,7653,1922,9575
26514,Pegeen,Petri,ppetri49@ed.gov,Computer Systems Analyst I,6375,1787,8162
26628,Timothee,Flowerden,tflowerden4a@hud.gov,Senior Sales Associate,7421,537,7958
26299,Adrianne,Prewett,aprewett4b@weebly.com,GIS Technical Architect,6076,1398,7474
26152,Flori,Yushachkov,fyushachkov4c@java.com,Paralegal,1581,1130,2711
26495,Melantha,Spriggen,mspriggen4d@gravatar.com,Marketing Manager,6484,885,7369
26427,Trace,Veryard,tveryard4e@army.mil,Pharmacist,7912,250,8162
26100,Lorilyn,Charlet,lcharlet4f@blogtalkradio.com,Staff Scientist,8893,386,9279
26117,Carmencita,Kisbee,ckisbee4g@ask.com,Paralegal,9723,1994,11717
26223,Jazmin,Banks,jbanks4h@wufoo.com,Product Engineer,9020,324,9344
26691,Anatole,Kelleway,akelleway4i@wired.com,Chief Design Engineer,6012,640,6652
26153,Mellicent,Negal,mnegal4j@techcrunch.com,Web Designer IV,4095,899,4994
26368,Genovera,Gownge,ggownge4k@csmonitor.com,Civil Engineer,8383,1667,10050
26552,Sandi,Hathway,shathway4l@tamu.edu,Web Developer III,3416,1542,4958
26489,Beilul,Bothie,bbothie4m@seattletimes.com,Database Administrator II,5423,756,6179
26003,Gunar,McClinton,gmcclinton4n@irs.gov,Systems Administrator IV,7783,665,8448
26889,Caryl,Calcott,ccalcott4p@miitbeian.gov.cn,Actuary,7518,1130,8648
26437,Zabrina,Cheston,zcheston4q@irs.gov,Research Assistant III,3078,1653,4731
26674,Anderson,Stabler,astabler4r@washington.edu,Analog Circuit Design manager,8731,1787,10518
26770,Wat,Springall,wspringall4s@stanford.edu,General Manager,8346,950,9296
26667,Pacorro,Annon,pannon4t@mayoclinic.com,Administrative Assistant III,6618,709,7327
26347,Myranda,Wolland,mwolland4u@homestead.com,Research Assistant III,5497,1466,6963
26365,Brant,Deftie,bdeftie4v@ftc.gov,Help Desk Technician,2350,1083,3433
26205,Milena,Regitz,mregitz4w@howstuffworks.com,Quality Engineer,3195,1735,4930
26140,Alleyn,Ralling,aralling4x@joomla.org,Web Developer II,1441,752,2193
26121,Katlin,Stryde,kstryde4y@reuters.com,Social Worker,1761,1310,3071
26818,Arlen,Morl,amorl4z@gnu.org,Nuclear Power Engineer,3846,665,4511
26241,Jess,Bolles,jbolles50@google.pl,Software Test Engineer IV,2796,840,3636
26790,Bartel,Bendin,bbendin51@bravesites.com,Senior Developer,2294,317,2611
26717,Liam,Carnier,lcarnier52@illinois.edu,Librarian,5986,1892,7878
26102,Loralyn,Confort,lconfort53@sfgate.com,Senior Developer,4560,1326,5886
26893,Ailsun,Sictornes,asictornes54@webs.com,Accounting Assistant II,2543,1820,4363
26171,Enid,Child,echild55@wp.com,Executive Secretary,3914,1121,5035
26373,Reginauld,Putman,rputman56@topsy.com,Mechanical Systems Engineer,3197,814,4011
26857,Cara,Philott,cphilott57@google.com.br,Senior Quality Engineer,6724,1889,8613
26085,Iolande,Dibben,idibben58@dropbox.com,Internal Auditor,6487,1134,7621
26359,Stephanus,Legg,slegg5a@twitpic.com,Developer I,6456,590,7046
26885,Sheri,Frayling,sfrayling5b@hugedomains.com,Clinical Specialist,9332,234,9566
26561,Sidonia,McMarquis,smcmarquis5d@smugmug.com,Engineer IV,5492,1300,6792
26030,Jdavie,Norker,jnorker5i@census.gov,Data Coordiator,6196,860,7056
26612,Kippy,Melin,kmelin5j@samsung.com,Media Manager II,8256,1990,10246
26543,Imojean,Rosoman,irosoman5k@huffingtonpost.com,Programmer Analyst II,7861,296,8157
26175,Pepe,Wort,pwort5l@goo.gl,Senior Editor,7338,1124,8462
26081,Tadeo,Andrioli,tandrioli5m@godaddy.com,Executive Secretary,5687,440,6127
26584,Rowen,Levens,rlevens5n@tumblr.com,Marketing Assistant,2826,1261,4087
26040,Jeffry,Borth,jborth5p@usa.gov,Quality Control Specialist,9050,527,9577
26774,Lenna,Iacovino,liacovino5q@liveinternet.ru,Director of Sales,7918,1220,9138
26814,Darsie,Spoole,dspoole5r@360.cn,Senior Cost Accountant,6921,1818,8739
26879,Ashly,Olivey,aolivey5t@youku.com,Analog Circuit Design manager,1284,437,1721
26482,Berton,Huyton,bhuyton5u@howstuffworks.com,Software Test Engineer II,2269,1304,3573
26577,Malorie,Houlton,mhoulton5v@dion.ne.jp,Physical Therapy Assistant,7456,707,8163
26775,Avictor,Singleton,asingleton5w@gnu.org,Recruiting Manager,8800,1177,9977
26757,Woodrow,Welldrake,wwelldrake5x@usa.gov,Office Assistant III,6327,1391,7718
26843,Warren,Parbrook,wparbrook5z@tuttocitta.it,Assistant Professor,6102,910,7012
26824,Dedie,MacNess,dmacness60@bing.com,Nurse,9404,1588,10992
26676,Niall,Boltwood,nboltwood61@chicagotribune.com,Quality Control Specialist,1598,1883,3481
26464,Christine,Audiss,caudiss62@github.io,Human Resources Manager,1780,348,2128
26307,Irina,Abdie,iabdie63@blinklist.com,Design Engineer,7939,1093,9032
26763,Ashlan,McKilroe,amckilroe64@answers.com,Senior Quality Engineer,8003,831,8834
26762,Kirby,Tinan,ktinan65@epa.gov,Media Manager IV,7371,1312,8683
26183,Lily,Strephan,lstrephan66@jigsy.com,Automation Specialist IV,4066,1641,5707
26149,Constance,Benoey,cbenoey67@example.com,Civil Engineer,7467,1045,8512
26027,Maria,Borborough,mborborough68@ox.ac.uk,Assistant Professor,4211,1747,5958
26026,Carmina,Postill,cpostill69@g.co,VP Product Management,9234,1254,10488
26112,Lalo,Scarsbrick,lscarsbrick6a@webmd.com,VP Sales,2350,924,3274
26513,Wanda,Castaneda,wcastaneda6b@liveinternet.ru,Accounting Assistant III,8774,344,9118
27000,Adora,Porker,aporker6c@yale.edu,Actuary,1193,1323,2516
26408,Domini,Harnett,dharnett6d@deliciousdays.com,Software Test Engineer II,6455,1751,8206
26692,Loreen,Wardall,lwardall6e@newsvine.com,Senior Financial Analyst,6974,659,7633
26920,Mattheus,Reinard,mreinard6f@artisteer.com,Chemical Engineer,1592,567,2159
26901,Dewain,Winckworth,dwinckworth6g@washington.edu,Web Developer II,5722,1277,6999
26976,Cristionna,Dunnett,cdunnett6h@admin.ch,Civil Engineer,1158,921,2079
26863,Beverly,Guidotti,bguidotti6i@vimeo.com,Quality Engineer,8106,1175,9281
26981,Hewet,Bentham3,hbentham6k@bizjournals.com,Paralegal,6843,440,7283
26637,Jenelle,Ayliffe,jayliffe6l@theglobeandmail.com,Software Test Engineer I,9418,1308,10726
26958,Sarah,Joy,sjoy6m@usgs.gov,Web Developer I,4466,267,4733
26436,Eugenio,Van Hesteren,evanhesteren6n@phpbb.com,Systems Administrator IV,4342,577,4919
26261,Roxanne,Livett,rlivett6o@networkadvertising.org,Quality Engineer,9863,1909,11772
26032,Fanny,Kalinovich,fkalinovich6p@tuttocitta.it,Software Test Engineer IV,9631,841,10472
26176,Rozanne,Way,rway6r@163.com,Geologist III,5769,200,5969
26292,Calla,Stebbing,cstebbing6s@acquirethisname.com,Human Resources Assistant III,3197,756,3953
26247,Corrine,Rosi,crosi6t@theglobeandmail.com,Technical Writer,7744,815,8559
26279,Fleur,Jonuzi,fjonuzi6u@columbia.edu,Operator,6261,1680,7941
26366,Mayne,Bridge,mbridge6v@noaa.gov,Account Representative II,8912,214,9126
26509,Godiva,Ferrarese,gferrarese6w@delicious.com,General Manager,2382,1187,3569
26424,Marin,Hampshire,mhampshire6x@aol.com,Automation Specialist III,7669,319,7988
26704,Pauly,Jorgensen,pjorgensen6z@youtube.com,Analyst Programmer,2805,1040,3845
26274,Katerine,Chawner,kchawner70@pcworld.com,Structural Analysis Engineer,2438,252,2690
26419,Ladonna,Knapton,lknapton71@constantcontact.com,Environmental Specialist,2753,292,3045
26622,Kesley,Taylerson,ktaylerson72@squidoo.com,Analyst Programmer,9541,1287,10828
26446,Kamila,Beckham,kbeckham74@cam.ac.uk,Design Engineer,7962,705,8667
26607,Reider,Howselee,rhowselee75@fastcompany.com,Social Worker,6706,1274,7980
26566,Anitra,Fishburn,afishburn76@pcworld.com,VP Marketing,2656,890,3546
26010,Yettie,Turnor,yturnor78@blogspot.com,Editor,1279,1904,3183
26462,Beulah,Eastridge,beastridge7c@aol.com,Librarian,7791,1350,9141
26528,Trenton,Eallis,teallis7f@ehow.com,Business Systems Development Analyst,9376,1902,11278
26669,Marna,Littrik,mlittrik7g@huffingtonpost.com,Nurse,6996,1017,8013
26828,Paten,Dmitrichenko,pdmitrichenko7h@bbc.co.uk,Programmer II,9436,665,10101
26285,Hagen,Snoxill,hsnoxill7j@yahoo.com,Information Systems Manager,6664,1090,7754
26698,Myranda,Daen,mdaen7k@tinyurl.com,Quality Control Specialist,9479,272,9751
26055,Lucita,Missen,lmissen7l@nydailynews.com,Paralegal,4840,1614,6454
26520,Gabie,Kilbey,gkilbey7m@privacy.gov.au,Nurse,3448,596,4044
26016,Rorke,Pearde,rpearde7n@cdc.gov,Web Developer II,6873,1434,8307
26021,Merline,Atte-Stone,mattestone7o@blogger.com,Geological Engineer,3436,1691,5127
26163,Lewes,Miner,lminer7p@google.com.hk,Research Associate,3254,1495,4749
26187,Trenton,Kisar,tkisar7r@who.int,Junior Executive,6069,891,6960
26633,Sibilla,Fahy,sfahy7s@illinois.edu,Senior Financial Analyst,3990,1281,5271
26162,Catarina,Kyle,ckyle7t@time.com,VP Sales,7990,1676,9666
26004,Terrie,Lanbertoni,tlanbertoni7u@vk.com,Recruiter,3976,1545,5521
26562,Margarette,Everwin,meverwin7x@bloomberg.com,Clinical Specialist,8088,1822,9910
26606,Gwennie,Gloves,ggloves7y@dailymotion.com,VP Accounting,6045,1853,7898
26897,Travis,Younge,tyounge7z@cnet.com,Software Test Engineer IV,8903,1297,10200
26882,Emelyne,Derell,ederell80@ebay.co.uk,Biostatistician III,5631,1386,7017
26859,Clo,Gandrich,cgandrich82@cdbaby.com,Data Coordiator,8187,1347,9534
26819,Karlotta,Tunnah,ktunnah83@epa.gov,Civil Engineer,6640,470,7110
26115,Martino,Greves,mgreves85@unicef.org,Cost Accountant,9385,1676,11061
26765,Leif,Elton,lelton86@woothemes.com,Research Associate,9007,917,9924
26705,Hanna,Braben,hbraben87@flavors.me,Human Resources Assistant III,2627,456,3083
26510,Davie,Yegorovnin,dyegorovnin88@dailymotion.com,Senior Sales Associate,8748,1421,10169
26068,Otho,Barette,obarette8b@huffingtonpost.com,Research Associate,8430,1299,9729
26159,Sorcha,Frantz,sfrantz8c@arizona.edu,Junior Executive,6199,1399,7598
26661,Lynnett,Mattusevich,lmattusevich8e@angelfire.com,Accounting Assistant IV,2258,1877,4135
26862,Mariette,O' Hern,mohern8g@comsenz.com,Executive Secretary,8603,922,9525
26588,Fidela,Ronchka,fronchka8i@tinypic.com,Software Test Engineer I,7097,1865,8962
26610,Hanny,Cocking,hcocking8k@statcounter.com,Food Chemist,8237,670,8907
26521,Adolph,Leggett,aleggett8l@bbb.org,Nurse Practicioner,2287,1570,3857
26782,Consuelo,Gercken,cgercken8n@pagesperso-orange.fr,Software Consultant,3396,302,3698
26087,Cyb,Ferreo,cferreo8p@comsenz.com,VP Sales,6462,1399,7861
26134,Hedwig,Dyble,hdyble8q@google.com.br,Computer Systems Analyst I,3150,1069,4219
26650,Hunt,Ayerst,hayerst8r@123-reg.co.uk,General Manager,6928,1240,8168
26948,Sella,Tabbernor,stabbernor8t@tamu.edu,Programmer Analyst III,3521,501,4022
26139,Douglas,Willgoose,dwillgoose8u@mayoclinic.com,Assistant Media Planner,3740,1912,5652
26164,Adrian,Landeg,alandeg8w@amazon.co.uk,Clinical Specialist,2940,1395,4335
26684,Lillis,Hampstead,lhampstead8y@flickr.com,Senior Editor,6954,1121,8075
26455,Norene,Aubin,naubin8z@cdc.gov,Structural Engineer,4295,942,5237
26785,Magda,Standbrook,mstandbrook90@parallels.com,Biostatistician III,2553,1189,3742
26538,Boone,Kintzel,bkintzel91@about.com,Human Resources Manager,8118,1348,9466
26951,Edmon,Feldfisher,efeldfisher92@princeton.edu,Internal Auditor,5386,455,5841
26195,Dulcy,Pilgram,dpilgram93@gov.uk,Design Engineer,4756,757,5513
26438,Renee,Kornilyev,rkornilyev94@earthlink.net,Desktop Support Technician,9971,1714,11685
26933,Maddalena,Molesworth,mmolesworth96@wikispaces.com,Occupational Therapist,7147,1125,8272
26061,Marty,Wealthall,mwealthall98@zdnet.com,Food Chemist,4705,1287,5992
26450,Dominick,Fairman,dfairman99@360.cn,Staff Accountant II,9911,1809,11720
26805,Ken,Hursey,khursey9a@multiply.com,Associate Professor,2071,1560,3631
26116,Caryl,Roddam,croddam9b@japanpost.jp,Automation Specialist III,7276,1915,9191
26312,Murdock,Tidbald,mtidbald9d@vimeo.com,Project Manager,9597,600,10197
26035,Crichton,Wands,cwands9e@skyrock.com,Recruiter,6105,609,6714
26738,Dolorita,Bigley,dbigley9g@themeforest.net,Research Assistant IV,2985,244,3229
26815,Brooke,Jarrad,bjarrad9h@slideshare.net,General Manager,2356,1683,4039
26051,Sterling,Matthews,smatthews9i@youku.com,Software Consultant,4518,1874,6392
26336,Nester,Jirusek,njirusek9j@issuu.com,Web Designer III,3404,852,4256
26542,Faunie,McKain,fmckain9m@dagondesign.com,Research Nurse,1978,976,2954
26158,Elvina,O'Siaghail,eosiaghail9n@gnu.org,Statistician III,1283,801,2084
26690,Wain,Bergeon,wbergeon9o@answers.com,Sales Representative,2570,951,3521
26772,Elvina,Blowin,eblowin9p@twitter.com,Senior Cost Accountant,1881,800,2681
26972,Lusa,Drinkel,ldrinkel9r@google.it,Structural Engineer,7317,1629,8946
26311,Avram,Pisco,apisco9s@free.fr,Safety Technician II,1469,1163,2632
26973,Ephrem,Whittek,ewhittek9t@flavors.me,Staff Scientist,8190,1569,9759
26911,Sula,Spores,sspores9u@nytimes.com,Dental Hygienist,6295,208,6503
26665,Jane,Chittey,jchittey9x@networkadvertising.org,Design Engineer,9017,693,9710
26888,Levon,Goane,lgoanea0@sitemeter.com,Recruiter,2762,201,2963
26720,Frazier,Andrez,fandreza3@twitpic.com,Help Desk Operator,7485,737,8222
26501,Monti,Brakespear,mbrakespeara5@time.com,Staff Scientist,9257,1129,10386
26498,Abramo,Wicks,awicksa6@topsy.com,Web Developer II,4339,1788,6127
26332,Serene,Varden,svardena7@istockphoto.com,Project Manager,7098,624,7722
26800,Elnar,Agdahl,eagdahla8@hubpages.com,Assistant Manager,2831,1275,4106
26494,Emelia,Symcock,esymcocka9@yolasite.com,Compensation Analyst,5847,201,6048
26248,Ruperto,MacGillavery,rmacgillaveryaa@wiley.com,Senior Sales Associate,8101,664,8765
26548,Eartha,Losseljong,elosseljongab@nbcnews.com,Mechanical Systems Engineer,3768,366,4134
26490,Maggie,Gergus,mgergusac@psu.edu,VP Quality Control,8903,1800,10703
26221,Pamela,Cater,pcaterad@livejournal.com,Clinical Specialist,5355,1912,7267
26718,Anthea,Behning,abehningaf@1und1.de,Engineer IV,6335,809,7144
26687,Codie,Dowears,cdowearsah@amazon.co.uk,Payment Adjustment Coordinator,8425,327,8752
26344,Ricki,Ambrosini,rambrosiniai@blinklist.com,Computer Systems Analyst II,3805,859,4664
26644,Justine,Cristoforetti,jcristoforettiaj@comsenz.com,Automation Specialist IV,1571,1532,3103
26964,Edd,Matejovsky,ematejovskyak@slate.com,Geological Engineer,3826,878,4704
26125,Sidoney,Feye,sfeyeal@123-reg.co.uk,Teacher,6519,319,6838
26411,Edgar,Champkin,echampkinam@dot.gov,VP Product Management,7709,398,8107
26065,Ramsey,Penniall,rpenniallan@parallels.com,Automation Specialist III,4227,1470,5697
26047,Howie,Martineau,hmartineauao@noaa.gov,Analog Circuit Design manager,7899,1136,9035
26289,Fan,Munehay,fmunehayaq@delicious.com,Director of Sales,6074,1549,7623
26272,Allyn,Turford,aturfordar@uiuc.edu,Recruiter,9184,1662,10846
26029,Land,Mc Caughan,lmccaughanas@parallels.com,Food Chemist,6274,458,6732
26766,Carlita,Mcwhinney,cmcwhinneyat@simplemachines.org,Project Manager,8597,1824,10421
26876,Claudia,Richarz,cricharzau@cornell.edu,General Manager,4338,350,4688
26768,Hobart,McShee,hmcsheeav@photobucket.com,Librarian,9610,389,9999
26325,Billy,Gusticke,bgustickeaw@ovh.net,Accounting Assistant I,1072,237,1309
26413,Teri,Westoff,twestoffay@java.com,Speech Pathologist,4692,741,5433
26403,Steven,Pyser,spyseraz@house.gov,Chemical Engineer,2962,506,3468
26358,Marj,Chamney,mchamneyb1@t-online.de,Actuary,3780,1848,5628
26352,Dyanne,Vost,dvostb2@nbcnews.com,Professor,2060,1482,3542
26240,Nathalie,Coneybeare,nconeybeareb3@mail.ru,Professor,3512,214,3726
26936,Jean,Devorill,jdevorillb4@dagondesign.com,Director of Sales,6873,863,7736
26316,Keene,Python,kpythonb5@ifeng.com,Director of Sales,7118,547,7665
26132,Cariotta,Lambrechts,clambrechtsb6@bigcartel.com,Marketing Assistant,4157,1074,5231
26982,Merrile,Messenger,mmessengerb7@clickbank.net,Geological Engineer,2208,359,2567
26841,Burgess,Brookson,bbrooksonb9@about.me,Sales Representative,3026,1685,4711
26503,Clarissa,Franz-Schoninger,cfranzschoningerbb@vkontakte.ru,Food Chemist,6863,1549,8412
26569,Roman,MacGille,rmacgillebc@weebly.com,Physical Therapy Assistant,2999,542,3541
26277,Yankee,Le Huquet,ylehuquetbd@reverbnation.com,Assistant Manager,2228,326,2554
26508,Shalne,Treneman,strenemanbf@umich.edu,Social Worker,3022,992,4014
26926,Cody,Olcot,colcotbg@topsy.com,Payment Adjustment Coordinator,4469,1351,5820
26196,Dalston,Tyreman,dtyremanbh@surveymonkey.com,Human Resources Assistant I,1532,1730,3262
26817,Kaitlin,Whitticks,kwhitticksbi@foxnews.com,Budget/Accounting Analyst II,4676,941,5617
26452,Claudia,Hubatsch,chubatschbj@apache.org,Automation Specialist IV,9508,1362,10870
26891,Moises,Chetter,mchetterbk@google.com,Internal Auditor,7071,214,7285
26822,Stephani,Ferrarin,sferrarinbl@mapy.cz,Human Resources Manager,1229,1455,2684
26855,Olav,Lidington,olidingtonbm@goo.gl,Structural Engineer,5526,1361,6887
26405,Ninnetta,Goodbody,ngoodbodybn@nasa.gov,Financial Analyst,9866,478,10344
26224,Margarette,Fibbings,mfibbingsbo@flavors.me,Librarian,4442,930,5372
26080,Bartram,Sewter,bsewterbp@zdnet.com,Senior Quality Engineer,8624,1343,9967
26531,Amitie,Gerson,agersonbq@tmall.com,Internal Auditor,9517,1851,11368
26944,Keary,Tracy,ktracybr@ihg.com,Help Desk Operator,5984,1226,7210
26649,Nerissa,Buckbee,nbuckbeebs@amazon.co.jp,Web Developer I,6658,299,6957
26613,Glennie,Pavlov,gpavlovbt@phpbb.com,Computer Systems Analyst IV,3324,1976,5300
26611,Zsazsa,Colbertson,zcolbertsonbu@com.com,Nuclear Power Engineer,2030,1367,3397
26199,Frazier,Beche,fbechebv@jimdo.com,Recruiting Manager,1648,459,2107
26499,Elset,Grigoire,egrigoirebw@ibm.com,Database Administrator III,2783,270,3053
26225,Mal,Crocket,mcrocketby@spiegel.de,Biostatistician I,4090,1516,5606
26280,Willey,Melladew,wmelladewc0@tmall.com,Research Assistant II,6956,1117,8073
26752,Tommi,Kos,tkosc1@bigcartel.com,General Manager,9637,591,10228
26568,Giralda,Espinet,gespinetc3@ezinearticles.com,Marketing Assistant,3644,1724,5368
26354,Tandy,Sackett,tsackettc4@mit.edu,Food Chemist,2802,787,3589
26592,Juditha,Scaice,jscaicec6@independent.co.uk,Data Coordiator,8581,549,9130
26226,Wolfgang,Dacke,wdackec7@cbsnews.com,Geological Engineer,5989,897,6886
26581,Chrissie,Vannikov,cvannikovc8@addthis.com,Administrative Assistant I,4216,1229,5445
26033,Fayre,Fearnside,ffearnsidecc@washington.edu,Electrical Engineer,7515,426,7941
26693,Bab,Tregent,btregentcd@who.int,Sales Associate,2783,1972,4755
26605,Rutger,Beneyto,rbeneytoce@behance.net,Product Engineer,1114,384,1498
26084,Cherlyn,Kalkofer,ckalkofercg@meetup.com,Civil Engineer,2662,1214,3876
26237,Ronna,Crummay,rcrummaych@vimeo.com,Recruiting Manager,5928,627,6555
26439,Dinah,Pitsall,dpitsallck@webmd.com,Database Administrator II,6192,1422,7614
26854,Charo,Cleverly,ccleverlycn@hubpages.com,Librarian,1310,1318,2628
26924,Fields,Duffan,fduffanco@patch.com,Research Associate,1038,294,1332
26734,Horatia,Gyurkovics,hgyurkovicsct@digg.com,Clinical Specialist,7061,1952,9013
26867,Garald,Pope,gpopecu@bigcartel.com,Web Developer IV,1062,608,1670
26433,Eadie,Sirette,esirettecv@bbc.co.uk,VP Product Management,2775,1632,4407
26286,Farand,Schleswig-Holstein,fschleswigholsteincw@surveymonkey.com,Staff Scientist,9635,1804,11439
26394,Lezlie,Aspinal,laspinalcz@slashdot.org,Graphic Designer,3287,381,3668
26623,Harrietta,Kynd,hkyndd0@csmonitor.com,Sales Associate,1923,1280,3203
26481,Daisy,Phaup,dphaupd2@noaa.gov,Quality Control Specialist,8952,499,9451
26621,Lavina,Usherwood,lusherwoodd5@moonfruit.com,Administrative Assistant II,4367,1611,5978
26034,Noellyn,Goodall,ngoodalld6@joomla.org,Senior Quality Engineer,1387,1655,3042
26385,Jeanie,Draude,jdrauded9@umich.edu,Internal Auditor,4332,360,4692
26015,Leanor,Ramelet,lrameletda@theguardian.com,Research Assistant III,4301,487,4788
26245,Cody,Kenshole,ckensholedb@1und1.de,Media Manager IV,5203,298,5501
26603,Alikee,Corrigan,acorrigandc@hc360.com,Structural Analysis Engineer,2600,837,3437
26415,Lizzie,Josephov,ljosephovdd@skype.com,VP Marketing,2353,740,3093
26148,Sonia,Barlow,sbarlowde@sogou.com,Engineer II,6065,1575,7640
26076,Amye,Purkess,apurkessdg@ovh.net,Web Developer II,2089,1820,3909
26243,Reed,Scherme,rschermedi@virginia.edu,Physical Therapy Assistant,9260,1451,10711
26989,Ky,Curtoys,kcurtoysdk@cyberchimps.com,Computer Systems Analyst II,9319,1354,10673
26060,Mathe,Breakwell,mbreakwelldm@opensource.org,Business Systems Development Analyst,8244,479,8723
26560,Chere,Melmeth,cmelmethdn@flavors.me,Design Engineer,8126,1085,9211
26725,Sarette,Longcaster,slongcasterdp@oracle.com,VP Quality Control,5845,735,6580
26092,Ilario,Tough,itoughdr@edublogs.org,Pharmacist,2672,331,3003
26537,Emalee,Reitenbach,ereitenbachdt@hubpages.com,Sales Representative,4812,1613,6425
26723,Micheline,Dufty,mduftydv@nih.gov,Health Coach IV,4522,207,4729
26608,Iseabal,MacCarlich,imaccarlichdx@ft.com,Accountant IV,9283,1435,10718
26350,Millicent,Amber,mambere0@instagram.com,Analog Circuit Design manager,1286,203,1489
26124,Obediah,Ray,oraye1@oakley.com,Automation Specialist III,7766,1792,9558
26264,Anselma,Reymers,areymerse2@psu.edu,Automation Specialist IV,7435,1299,8734
26058,David,Pithcock,dpithcocke3@cbc.ca,Budget/Accounting Analyst III,3669,1390,5059
26900,Colas,Reilinger,creilingere4@java.com,Senior Quality Engineer,6034,678,6712
26167,Ernesto,Wanderschek,ewanderscheke5@nba.com,Cost Accountant,8227,835,9062
26318,Jordana,Temple,jtemplee6@weebly.com,Analog Circuit Design manager,5354,1676,7030
26645,Ros,McAneny,rmcanenye7@unesco.org,Database Administrator I,7674,1149,8823
26168,Wilden,McCurtain,wmccurtaine9@businessinsider.com,Editor,9515,357,9872
26422,Hy,Oldale,holdaleeb@typepad.com,Food Chemist,1894,1631,3525
26925,Kean,Gripton,kgriptonec@nature.com,Operator,5454,1584,7038
26007,Bevan,Yoxen,byoxened@cbsnews.com,Structural Analysis Engineer,4903,1343,6246
26967,Kile,Primo,kprimoef@sphinn.com,Technical Writer,5156,1706,6862
26904,Tripp,Warriner,twarrinereg@pbs.org,Programmer Analyst IV,9816,1057,10873
26265,Osbourne,Draayer,odraayerel@google.it,Physical Therapy Assistant,3509,367,3876
26314,Glendon,Roylance,groylanceem@ihg.com,Senior Sales Associate,2557,1898,4455
26866,Sheffie,Fruish,sfruishen@google.ca,Senior Editor,8604,751,9355
26994,Desirae,Whittlesey,dwhittleseyep@nifty.com,Dental Hygienist,6120,1493,7613
26011,Moyra,Orrobin,morrobineq@blogtalkradio.com,Director of Sales,9443,1201,10644
26708,Robbin,Luc,rlucer@nydailynews.com,Web Developer I,9759,1682,11441
26750,Colet,Hamlin,chamlines@altervista.org,Programmer Analyst IV,1662,1483,3145
26104,Jacklin,Ivantyev,jivantyevet@printfriendly.com,Media Manager III,5441,1628,7069
26317,Lizzie,Gosdin,lgosdineu@reference.com,Mechanical Systems Engineer,9611,695,10306
26681,Brocky,Harvie,bharvieev@jalbum.net,Assistant Professor,3397,879,4276
26402,Richy,Feander,rfeanderex@seesaa.net,Associate Professor,4775,1697,6472
26342,Ariana,Cough,acoughey@about.me,Environmental Tech,8608,1331,9939
26233,Blaire,Constanza,bconstanzaf0@buzzfeed.com,Structural Engineer,9320,614,9934
26745,Wallis,Gorvin,wgorvinf1@engadget.com,Occupational Therapist,4687,233,4920
26601,Pooh,Restorick,prestorickf2@si.edu,Executive Secretary,6454,1894,8348
26212,Nerita,Giacovetti,ngiacovettif4@devhub.com,GIS Technical Architect,5454,1748,7202
26694,Godiva,Honeyghan,ghoneyghanf5@google.pl,Junior Executive,2598,1034,3632
26206,Holly,Duncanson,hduncansonf7@sciencedirect.com,Nuclear Power Engineer,7540,1828,9368
26998,Merrile,Phinnessy,mphinnessyf8@meetup.com,Dental Hygienist,3974,1783,5757
26414,Winfred,Ellcome,wellcomef9@pinterest.com,Web Designer IV,4953,1714,6667
26996,Hayward,Gabala,hgabalafb@imageshack.us,Staff Accountant I,3031,771,3802
26748,Frannie,Ternault,fternaultfg@nih.gov,Physical Therapy Assistant,6032,1127,7159
26106,Ezequiel,MacCheyne,emaccheynefj@ycombinator.com,Assistant Manager,8011,1591,9602
26357,Aguistin,Capeling,acapelingfk@amazon.co.jp,Compensation Analyst,2390,1889,4279
26999,Vincenz,Martinec,vmartinecfn@upenn.edu,Health Coach IV,8743,1100,9843
26943,Nealon,Smiz,nsmizfq@google.it,Nuclear Power Engineer,7672,1221,8893
26551,Darb,Kemmet,dkemmetfr@techcrunch.com,Chemical Engineer,1421,928,2349
26614,Leontine,Frear,lfrearfu@theatlantic.com,Legal Assistant,7651,1182,8833
26420,Marge,Clow,mclowfx@wp.com,Executive Secretary,4193,600,4793
26456,Kania,Navan,knavanfy@apple.com,VP Quality Control,3588,1480,5068
26636,Trisha,Hodjetts,thodjettsfz@mit.edu,Clinical Specialist,6088,444,6532
26369,Nicki,Beer,nbeerg1@tumblr.com,Geologist I,6470,502,6972
26310,Sheridan,Chadd,schaddg2@usda.gov,VP Marketing,8921,1222,10143
26927,Lena,Klyn,lklyng4@constantcontact.com,Nuclear Power Engineer,3059,1557,4616
26364,Jamill,Livard,jlivardg6@harvard.edu,Geologist I,6421,1023,7444
26388,Constantine,Cavil,ccavilg7@nymag.com,Environmental Specialist,1819,1266,3085
26228,Budd,Scoterbosh,bscoterboshg8@ameblo.jp,Assistant Manager,2214,861,3075
26842,Patsy,Minerdo,pminerdogc@networkadvertising.org,General Manager,3270,907,4177
26361,Antonella,Whipple,awhipplegf@blogtalkradio.com,Community Outreach Specialist,1553,729,2282
26777,Bobette,Kilgallen,bkilgallengg@cdbaby.com,Mechanical Systems Engineer,4548,1531,6079
26099,Beverly,Decroix,bdecroixgi@altervista.org,Media Manager IV,8719,635,9354
26460,Kylila,Veal,kvealgl@yale.edu,Assistant Media Planner,8638,1117,9755
26256,May,Tunesi,mtunesigm@soundcloud.com,Pharmacist,8795,1699,10494
26834,Adriaens,McConway,amcconwaygo@samsung.com,Teacher,1714,863,2577
26940,Trever,Presdee,tpresdeegp@t.co,Teacher,5680,851,6531
26672,Rhys,Wippermann,rwippermanngq@reuters.com,Legal Assistant,9284,1484,10768
26921,Orlando,Ghiron,oghirongr@aboutads.info,Mechanical Systems Engineer,2355,569,2924
26846,Mehetabel,Mirralls,mmirrallsgt@reuters.com,Information Systems Manager,4896,260,5156
26666,Odelinda,Wayon,owayongu@quantcast.com,Safety Technician II,4997,1850,6847
26850,Dennis,Joly,djolygv@go.com,Chemical Engineer,2082,400,2482
26488,Kennedy,Heustice,kheusticegx@sciencedirect.com,Pharmacist,9901,721,10622
26012,Roseann,Hopkyns,rhopkynsgy@edublogs.org,Clinical Specialist,2192,1542,3734
26039,Kerri,Cannell,kcannellgz@reddit.com,Software Test Engineer IV,1788,1158,2946
26522,Augustus,Sebright,asebrighth2@reference.com,Account Representative III,2641,270,2911
26873,Ferrel,Dockrill,fdockrillh3@businessweek.com,Data Coordiator,4297,506,4803
26230,Vere,Dowthwaite,vdowthwaiteh4@imdb.com,Health Coach I,6901,897,7798
26118,Clea,Padwick,cpadwickh8@privacy.gov.au,Staff Scientist,8994,1906,10900
26356,Felic,Enion,fenionhc@bbc.co.uk,Chemical Engineer,2794,1061,3855
26746,Rudy,Stimson,rstimsonhf@paginegialle.it,Sales Associate,6542,907,7449
26816,Tadeo,Eltringham,teltringhamhi@tinypic.com,Senior Developer,4313,789,5102
26417,Bruis,Blois,bbloishj@trellian.com,Senior Editor,7458,1411,8869
26151,Alexandro,Rouby,aroubyhk@sciencedaily.com,Analyst Programmer,7183,1446,8629
26397,Bernice,Lippiett,blippietthn@craigslist.org,Physical Therapy Assistant,1045,269,1314
26619,Ruben,Sivess,rsivessho@hatena.ne.jp,Marketing Assistant,3601,595,4196
26702,Parker,Boatwright,pboatwrighthp@qq.com,Automation Specialist IV,6201,1255,7456
26997,Pierrette,Stanlack,pstanlackhq@nhs.uk,Desktop Support Technician,9808,772,10580
26043,Mendy,Gogay,mgogayhr@ovh.net,Media Manager III,4059,1502,5561
26251,Krispin,Dobbie,kdobbiehs@loc.gov,Speech Pathologist,2628,1415,4043
26064,Brant,Kerley,bkerleyht@purevolume.com,Assistant Manager,2476,1486,3962
26978,Tybie,Caston,tcastonhu@barnesandnoble.com,VP Product Management,5945,1677,7622
26343,Shayna,Sollas,ssollashv@prnewswire.com,Staff Scientist,6440,697,7137
26063,Martica,Lincke,mlinckehw@yolasite.com,Human Resources Manager,8471,1127,9598
26130,Ki,Bambery,kbamberyi2@ucoz.com,Technical Writer,9411,1534,10945
26556,Alie,Martinetto,amartinettoi5@marketwatch.com,Paralegal,4113,1372,5485
26591,Natal,Lumby,nlumbyi6@answers.com,GIS Technical Architect,8447,1970,10417
26075,Lura,Sheards,lsheardsib@technorati.com,VP Sales,6121,565,6686
26096,Lemmy,Bandiera,lbandieraie@wikispaces.com,Geological Engineer,3018,968,3986
26001,Sammy,Fould,sfouldif@godaddy.com,Marketing Assistant,6188,470,6658
26145,Faber,Skelding,fskeldingih@spotify.com,Structural Analysis Engineer,8521,1902,10423
26544,Kinnie,Huffy,khuffyii@blog.com,Registered Nurse,4450,1283,5733
26217,Zacharie,Von Hindenburg,zvonhindenburgik@vkontakte.ru,Business Systems Development Analyst,9167,1679,10846
26826,Annamarie,Spink,aspinkil@hostgator.com,Analog Circuit Design manager,2458,1380,3838
26618,Jorie,Carleman,jcarlemanio@last.fm,Speech Pathologist,3728,615,4343
26583,Nada,Dakers,ndakersiq@ovh.net,Pharmacist,7711,1128,8839
26594,Corabel,Teasdale-Markie,cteasdalemarkieir@biblegateway.com,Mechanical Systems Engineer,1164,661,1825
26337,Alicia,Burgott,aburgottit@sciencedaily.com,Editor,7160,806,7966
26974,Tuckie,Brunstan,tbrunstaniu@flickr.com,VP Marketing,9103,1836,10939
26573,Scarface,Joannic,sjoanniciv@tumblr.com,Associate Professor,1636,261,1897
26877,Olivette,Bowcock,obowcockiy@google.pl,Business Systems Development Analyst,6097,1985,8082
26559,Joell,Halloran,jhalloranj0@ox.ac.uk,Accountant I,5376,1983,7359
26947,Raphaela,Rasher,rrasherj2@bravesites.com,Analyst Programmer,7728,428,8156
26968,Radcliffe,Crawforth,rcrawforthj9@stumbleupon.com,Systems Administrator III,9120,735,9855
26220,Shepard,Sheryne,ssherynejd@yale.edu,Structural Engineer,9030,1888,10918
26686,Barbie,Morrallee,bmorralleeje@flavors.me,Clinical Specialist,4198,1165,5363
26934,Amby,Cherrington,acherringtonjf@java.com,Executive Secretary,6358,1156,7514
26880,Ruggiero,Thomen,rthomenjg@whitehouse.gov,Help Desk Technician,6905,924,7829
26209,Corny,Gozzett,cgozzettji@archive.org,Media Manager I,5427,1541,6968
26865,Koressa,Puzey,kpuzeyjj@omniture.com,Software Consultant,8416,731,9147
26975,Lydia,Spurrier,lspurrierjl@about.me,Physical Therapy Assistant,6320,851,7171
26111,Elaina,Ingerith,eingerithjm@tiny.cc,Senior Developer,1772,911,2683
26658,Rudie,Loker,rlokerjn@nsw.gov.au,Associate Professor,3867,907,4774
26432,Nedi,Ankrett,nankrettjo@shareasale.com,Senior Editor,2130,1917,4047
26108,Billie,Yeudall,byeudalljr@usatoday.com,Associate Professor,2239,1307,3546
26541,Heinrik,Origin,horiginjs@seesaa.net,Automation Specialist III,5600,1102,6702
26053,Blair,Axten,baxtenjt@jigsy.com,Budget/Accounting Analyst III,2709,1272,3981
26540,Ruthie,Musso,rmussoju@php.net,Teacher,4594,997,5591
26771,Manon,Hindenberger,mhindenbergerjv@creativecommons.org,Research Associate,9057,919,9976
26957,Terrill,McGraffin,tmcgraffinjw@nytimes.com,Desktop Support Technician,2379,1358,3737
26254,Chandler,O'Dogherty,codoghertyjx@google.co.jp,Electrical Engineer,2818,545,3363
26942,Christyna,Staff,cstaffjy@booking.com,Health Coach IV,1308,1642,2950
26724,Dorey,Rickesies,drickesiesjz@indiegogo.com,Legal Assistant,9919,906,10825
26578,Marcello,Geldert,mgeldertk5@imgur.com,Accounting Assistant I,8024,600,8624
26726,Harli,O'Rudden,horuddenk8@free.fr,Statistician II,1825,1564,3389
26222,Ketty,Stiven,kstivenk9@discovery.com,GIS Technical Architect,2088,702,2790
26962,Larina,McCaughey,lmccaugheykb@foxnews.com,Information Systems Manager,9336,612,9948
26440,Tandy,Breedy,tbreedyke@yelp.com,Account Coordinator,5003,1395,6398
26984,Melba,Le Frank,mlefrankkf@washingtonpost.com,Research Nurse,5085,928,6013
26426,Morissa,Mulrenan,mmulrenankh@tripadvisor.com,Speech Pathologist,1898,202,2100
26751,Lilli,MacKim,lmackimki@theguardian.com,Human Resources Assistant IV,7627,1595,9222
26565,Worth,Cafe,wcafeko@ehow.com,Social Worker,3783,688,4471
26273,Florry,Stride,fstridekp@indiegogo.com,Nurse Practicioner,6475,868,7343
26682,Trista,McElmurray,tmcelmurraykq@cbc.ca,Structural Engineer,3088,522,3610
26856,Marion,Milch,mmilchkr@tiny.cc,Database Administrator I,4080,1446,5526
26910,Else,Klesel,ekleselks@boston.com,Office Assistant II,9244,1172,10416
26127,Celeste,Spohr,cspohrkt@blinklist.com,Chief Design Engineer,4441,1646,6087
26719,Christalle,Goalby,cgoalbyku@unicef.org,Executive Secretary,2901,930,3831
26005,Morly,Bulford,mbulfordkx@forbes.com,Staff Scientist,6857,1198,8055
26094,Lanie,Ellwell,lellwellkz@ft.com,Assistant Media Planner,9256,901,10157
26557,Adi,Lattey,alatteyl0@ocn.ne.jp,Project Manager,4149,777,4926
26128,Omero,Garrat,ogarratl1@jugem.jp,Web Developer I,9610,1719,11329
26376,Avrom,Terney,aterneyl2@unicef.org,Payment Adjustment Coordinator,8067,404,8471
26793,Averell,Odde,aoddel3@nyu.edu,Occupational Therapist,2267,687,2954
26983,Emmalee,Barbier,ebarbierl4@gmpg.org,Assistant Professor,1422,1411,2833
26496,Frans,Sneden,fsnedenl5@github.io,Structural Engineer,3119,1620,4739
26965,Julieta,Arnfield,jarnfieldl6@dot.gov,Senior Sales Associate,6041,1866,7907
26480,Dawn,Creaser,dcreaserl7@typepad.com,Financial Advisor,1038,1105,2143
26339,Patricio,Dulanty,pdulantyl9@tmall.com,Internal Auditor,6717,1426,8143
26330,Briant,Effaunt,beffauntla@berkeley.edu,Assistant Manager,5863,297,6160
26341,Madel,Kezor,mkezorlc@paypal.com,Registered Nurse,4556,570,5126
26457,Bevvy,MattiCCI,bmatticcilh@hatena.ne.jp,Help Desk Operator,1253,1530,2783
26091,Albertina,Pund,apundlm@merriam-webster.com,Mechanical Systems Engineer,3337,1650,4987
26915,Yul,Moret,ymoretln@trellian.com,Administrative Assistant II,2900,1515,4415
26252,Davidde,Hellin,dhellinlq@ebay.com,Mechanical Systems Engineer,6894,684,7578
26638,Cristal,Westhofer,cwesthoferlx@nature.com,Analyst Programmer,6637,697,7334
26550,Beret,Lansdown,blansdownlz@flickr.com,Analyst Programmer,4956,1139,6095
26923,Annamarie,Sedgefield,asedgefieldm5@studiopress.com,Systems Administrator II,7149,866,8015
26902,Langston,Rayworth,lrayworthm6@comcast.net,Chief Design Engineer,3600,621,4221
26737,Ryun,Sute,rsutemb@blogtalkradio.com,Health Coach IV,6875,562,7437
26515,Sarene,Huygen,shuygenmg@newsvine.com,Environmental Specialist,1390,1031,2421
26632,Georgine,Andries,gandriesmh@exblog.jp,Assistant Professor,6201,1786,7987
26945,Wally,Haining,whainingmj@fastcompany.com,Geological Engineer,1321,650,1971
26333,Benoit,Eliaz,beliazmo@ucsd.edu,Teacher,7864,1766,9630
26393,Aurelie,McGrale,amcgralemp@youtube.com,Administrative Officer,8234,904,9138
26500,Anson,Bodley,abodleymq@europa.eu,Civil Engineer,2520,903,3423
26300,Licha,Elvy,lelvymt@merriam-webster.com,Account Coordinator,8712,277,8989
26699,Clayborne,Kaming,ckamingmx@theglobeandmail.com,Assistant Manager,3734,571,4305
26367,Matthew,Icom,micommy@soup.io,Database Administrator II,7677,359,8036
26651,Gae,Marsters,gmarstersmz@netvibes.com,Internal Auditor,8063,686,8749
26447,Efrem,Le Fevre,elefevren0@etsy.com,Human Resources Assistant III,4780,713,5493
26315,Ophelia,Stithe,ostithen3@scientificamerican.com,Administrative Officer,2671,1229,3900
26778,Bride,Garrique,bgarriquen6@moonfruit.com,VP Marketing,1045,845,1890
26173,Adelbert,Fazackerley,afazackerleyn8@ning.com,Electrical Engineer,3973,1423,5396
26504,Gaile,Klimkowski,gklimkowskin9@imgur.com,Environmental Tech,8624,446,9070
26472,Zora,Lotwich,zlotwichnb@dagondesign.com,Operator,9198,452,9650
26988,Lennard,Fereday,lferedaynd@zdnet.com,Quality Control Specialist,6193,1392,7585
26799,Osbert,MacQueen,omacqueenne@1688.com,Sales Associate,9422,1741,11163
26410,Tobit,Frango,tfrangonh@topsy.com,Director of Sales,4266,1951,6217
26390,Kevin,Hubbins,khubbinsnj@ucoz.com,Senior Sales Associate,6767,213,6980
26372,Jakob,Ogilvie,jogilvienl@technorati.com,Mechanical Systems Engineer,1677,391,2068
26295,Heriberto,Wills,hwillsnm@craigslist.org,Human Resources Assistant II,2208,1279,3487
26820,Allison,Bruhnicke,abruhnickenn@china.com.cn,Software Test Engineer I,8945,1803,10748
26002,Farris,Haville,fhavilleno@pcworld.com,Sales Associate,6887,300,7187
26680,Dyanne,Francklyn,dfrancklynnp@washingtonpost.com,Geological Engineer,8012,1704,9716
26242,Hermy,Gordon-Giles,hgordongilesnq@webeden.co.uk,Internal Auditor,8776,1280,10056
26516,Bartie,Punter,bpunterns@devhub.com,Senior Editor,6860,1481,8341
26883,Carolan,McMillam,cmcmillamnt@spotify.com,Graphic Designer,6443,1825,8268
26487,Glen,Loynes,gloynesnv@digg.com,Accountant I,6922,431,7353
26435,Thurstan,Stiles,tstilesny@rambler.ru,Teacher,9292,1387,10679
26780,Micheline,Khomin,mkhomino1@cbc.ca,Programmer III,5364,441,5805
26371,Tami,Novik,tnoviko4@addthis.com,Web Designer IV,6572,1201,7773
26536,Eimile,McFayden,emcfaydeno5@va.gov,Senior Developer,8755,1975,10730
26135,Jobi,Lineker,jlinekero8@deviantart.com,Human Resources Assistant II,6062,1080,7142
26189,Hyatt,Darwin,hdarwino9@toplist.cz,Design Engineer,2618,1926,4544
26050,Fraser,Brugman,fbrugmanob@vkontakte.ru,Food Chemist,9959,970,10929
26458,Harold,Postance,hpostanceoc@google.com.hk,Librarian,1438,1852,3290
26038,Arlie,Pirrie,apirrieoe@upenn.edu,Structural Analysis Engineer,9851,1942,11793
26142,Rickie,Sworn,rswornog@msn.com,Account Executive,8505,1951,10456
26166,Dulcia,McLice,dmcliceoh@indiegogo.com,Web Developer IV,1453,1471,2924
26519,Lynde,Burnsyde,lburnsydeol@typepad.com,Marketing Manager,1936,1454,3390
26322,Sly,Benyon,sbenyonon@patch.com,Dental Hygienist,4880,1561,6441
26079,Devland,D'Ambrogio,ddambrogiooo@vimeo.com,Staff Accountant III,5297,242,5539
26198,Shandee,Suttaby,ssuttabyop@amazon.com,Recruiter,6082,584,6666
26266,Charleen,Barnhart,cbarnhartot@examiner.com,Operator,4138,613,4751
26399,Dorotea,Mallard,dmallardou@usa.gov,VP Product Management,7047,1465,8512
26268,Bartie,Leming,blemingow@jiathis.com,Web Designer II,1944,1231,3175
26567,Berrie,Braker,bbrakerp0@weather.com,Research Associate,8974,1829,10803
26832,Ainslie,Haylock,ahaylockp3@sfgate.com,Product Engineer,4939,803,5742
26423,Petunia,Ceaplen,pceaplenp4@1und1.de,Engineer IV,7658,1673,9331
26193,Ailey,Seery,aseeryp8@home.pl,Accounting Assistant III,7989,1491,9480
26807,Boote,Monument,bmonumentpa@buzzfeed.com,Pharmacist,1299,1936,3235
26804,Ross,Corris,rcorrispb@accuweather.com,Developer I,6301,621,6922
26905,Loralyn,Mosen,lmosenpg@ucla.edu,Physical Therapy Assistant,1628,729,2357
26953,Enid,Coulbeck,ecoulbeckpi@dmoz.org,Chief Design Engineer,6956,779,7735
26054,Michaela,Daber,mdaberpj@wunderground.com,Payment Adjustment Coordinator,7988,1038,9026
26545,Piper,Parkhouse,pparkhousepk@posterous.com,Product Engineer,4314,1860,6174
26169,Salvidor,O'Cannovane,socannovanepl@tinyurl.com,Biostatistician I,6367,1761,8128
26017,Raddie,Gelling,rgellingpn@usa.gov,Assistant Media Planner,8210,1099,9309
26095,Laurene,Nickels,lnickelspq@amazon.de,Actuary,5754,1599,7353
26215,Daniella,Matthisson,dmatthissonpr@google.nl,Sales Associate,7071,1911,8982
26190,Allys,Dyball,adyballps@usgs.gov,Systems Administrator I,1261,1501,2762
26760,Deva,Russe,drussept@cocolog-nifty.com,General Manager,3135,1216,4351
26023,Cammie,Glentworth,cglentworthpv@elegantthemes.com,Editor,9931,646,10577
26664,Garvin,Trewman,gtrewmanpw@blogspot.com,VP Quality Control,6322,695,7017
26200,Felicio,Reyburn,freyburnq2@ca.gov,Chemical Engineer,5149,1909,7058
26769,Waiter,Snalum,wsnalumq3@hibu.com,Tax Accountant,7370,804,8174
26244,Sydel,MacGahy,smacgahyq4@mac.com,Food Chemist,3071,763,3834
26701,Juditha,Jeayes,jjeayesq6@posterous.com,Information Systems Manager,9939,854,10793
26418,Amaleta,Trew,atrewq8@utexas.edu,Sales Associate,5978,1679,7657
26792,Theda,Butter,tbutterq9@mit.edu,Human Resources Manager,2798,1708,4506
26602,Gaspard,Sumpner,gsumpnerqb@tmall.com,Help Desk Operator,7098,292,7390
26231,Paxton,Martill,pmartillqg@wufoo.com,Food Chemist,1529,1348,2877
26710,Minda,Beckingham,mbeckinghamqi@statcounter.com,Account Representative I,6223,932,7155
26668,Giffie,Pabelik,gpabelikqk@tripod.com,Account Coordinator,3386,1199,4585
26779,Seward,Alpe,salpeql@symantec.com,Senior Developer,5061,1493,6554
26208,Jeannine,Collard,jcollardqo@go.com,Account Executive,1885,1578,3463
26048,Alf,Luckham,aluckhamqp@latimes.com,Budget/Accounting Analyst III,6419,1657,8076
26743,Terri,Bresnen,tbresnenqq@51.la,Office Assistant I,2182,349,2531
26186,Emlynne,Newens,enewensqr@scientificamerican.com,Information Systems Manager,6781,1614,8395
26886,Aron,Buffery,abufferyqu@earthlink.net,Teacher,2269,691,2960
26868,Towny,Ramalhete,tramalheteqx@storify.com,Dental Hygienist,1417,1986,3403
26381,Melli,Danes,mdanesr3@elegantthemes.com,Programmer Analyst II,2472,785,3257
26146,Christian,Rabbatts,crabbattsr9@twitpic.com,Software Engineer IV,4527,530,5057
26912,Rudiger,Klimek,rklimekrc@tumblr.com,Administrative Officer,5565,697,6262
26919,Loraine,Marcum,lmarcumre@4shared.com,Social Worker,5925,839,6764
26955,Foster,Simcoe,fsimcoerf@cafepress.com,Research Associate,8418,1063,9481
26150,Hewitt,Rabbage,hrabbagerk@amazon.de,Marketing Manager,8346,1168,9514
26178,Lauralee,Wooland,lwoolandrl@salon.com,Project Manager,7388,1566,8954
26428,Darrelle,Scamerdine,dscamerdinerq@usnews.com,Senior Cost Accountant,7968,379,8347
27008,Berne,Schimmang,bschimmang0@apple.com,Staff Scientist,9603,1478,11081
27269,Alix,Klimentov,aklimentov1@list-manage.com,Payment Adjustment Coordinator,4801,652,5453
27094,Johnathon,Skeath,jskeath2@wikia.com,Occupational Therapist,8456,949,9405
27901,Pancho,Giacovetti,pgiacovetti3@kickstarter.com,Clinical Specialist,5005,922,5927
27591,Manya,Lambert-Ciorwyn,mlambertciorwyn4@slate.com,Teacher,5171,737,5908
27001,Fifine,Gillhespy,fgillhespy5@eventbrite.com,Accounting Assistant II,3280,783,4063
27935,Sioux,Sawbridge,ssawbridge6@symantec.com,Paralegal,8650,1517,10167
27572,Berk,Sertin,bsertin7@pagesperso-orange.fr,Nurse,9678,1086,10764
27318,Dael,Keunemann,dkeunemann8@shinystat.com,Staff Scientist,6234,1652,7886
27392,Anna,Spreull,aspreull9@census.gov,Assistant Professor,3953,1457,5410
27311,Garold,Marco,gmarcoa@infoseek.co.jp,Senior Sales Associate,2015,375,2390
27501,Nil,Heynel,nheynelb@google.ru,Staff Scientist,6892,1428,8320
27931,Nikki,Lamperti,nlampertic@skyrock.com,Operator,6019,328,6347
27936,Zelma,Blest,zblestd@wiley.com,Speech Pathologist,6150,1388,7538
27084,Othella,Fink,ofinke@gizmodo.com,Social Worker,2942,1281,4223
27027,Ardelle,Mouser,amouserf@privacy.gov.au,Cost Accountant,2515,1393,3908
27731,Valentine,Bonass,vbonassg@wsj.com,Tax Accountant,8954,540,9494
27165,Velvet,Dabney,vdabneyh@tripadvisor.com,Internal Auditor,5453,1438,6891
27865,Tammie,Lapley,tlapleyi@marketwatch.com,VP Marketing,9516,1812,11328
27627,Kipp,Aloway,kalowayj@sbwire.com,Desktop Support Technician,1076,1034,2110
27852,Theo,Gomer,tgomerk@domainmarket.com,Assistant Professor,8303,1267,9570
27866,Nissy,Kelling,nkellingl@furl.net,Web Designer II,7052,1496,8548
27798,Lyle,Rettie,lrettiem@spiegel.de,Systems Administrator III,4681,331,5012
27676,Lenette,Claque,lclaquen@g.co,Structural Analysis Engineer,1618,1189,2807
27083,Barris,Danks,bdankso@seattletimes.com,Staff Scientist,9735,1935,11670
27830,Kirby,Gummer,kgummerp@cloudflare.com,Programmer Analyst IV,1026,1936,2962
27450,Gray,De Roeck,gderoeckq@infoseek.co.jp,Design Engineer,7399,934,8333
27395,Armando,Blackly,ablacklyr@google.com,Assistant Manager,8749,1280,10029
27285,Tristan,Cattrall,tcattralls@mac.com,Software Consultant,1407,395,1802
27002,Sayres,Kalberer,skalberert@chicagotribune.com,Programmer II,5374,1753,7127
27218,Gilly,Gerran,ggerranu@hubpages.com,Administrative Assistant III,5434,1113,6547
27684,Evelina,Kill,ekillv@stumbleupon.com,Software Consultant,2890,1981,4871
27699,Yurik,Pietersen,ypietersenw@netscape.com,Assistant Manager,5846,291,6137
27263,Rosa,Piris,rpirisx@cisco.com,Paralegal,4737,1945,6682
27339,Sissy,Hamberstone,shamberstoney@webnode.com,Senior Cost Accountant,5115,781,5896
27630,Maryanne,Dudman,mdudman10@spotify.com,Account Coordinator,9405,240,9645
27489,Chaddy,Myles,cmyles11@mayoclinic.com,General Manager,8478,1058,9536
27532,Tedie,Gribbell,tgribbell12@shutterfly.com,Legal Assistant,7702,1486,9188
27366,Aurel,Dransfield,adransfield13@squidoo.com,Cost Accountant,3292,693,3985
27520,Collin,Aronovich,caronovich14@buzzfeed.com,Software Consultant,4625,902,5527
27601,Janene,Foy,jfoy15@freewebs.com,Human Resources Assistant IV,5303,737,6040
27733,Maddalena,Sones,msones16@gmpg.org,Registered Nurse,7116,281,7397
27070,Germayne,Ballsdon,gballsdon17@elpais.com,Help Desk Operator,3144,495,3639
27766,Eziechiele,Parkman,eparkman18@weibo.com,Account Representative I,4608,657,5265
27490,Billi,Phelit,bphelit19@mayoclinic.com,Recruiting Manager,6745,1090,7835
27783,Ninnette,Sperling,nsperling1a@comcast.net,Software Test Engineer III,4003,1768,5771
27672,Margie,Pont,mpont1b@histats.com,Pharmacist,1231,1575,2806
27589,Veronique,Gumly,vgumly1c@imdb.com,Environmental Tech,3319,1516,4835
27058,Artus,Tyndall,atyndall1e@instagram.com,Biostatistician III,2682,1788,4470
27746,Krista,Ryves,kryves1f@e-recht24.de,Electrical Engineer,7645,1781,9426
27312,Ricky,Vicent,rvicent1g@zdnet.com,Design Engineer,1315,869,2184
27293,Adolphus,Giraudo,agiraudo1h@tuttocitta.it,Chemical Engineer,9273,1590,10863
27671,Ofilia,Connock,oconnock1i@behance.net,Staff Accountant II,3076,599,3675
27146,Bendick,Gowthrop,bgowthrop1j@aol.com,Human Resources Assistant II,5259,1146,6405
27568,Glenden,Craven,gcraven1k@gizmodo.com,Nurse,6487,891,7378
27240,Wye,Capineer,wcapineer1l@chronoengine.com,Systems Administrator I,4994,929,5923
27181,Justen,Fone,jfone1n@hubpages.com,Nurse Practicioner,4142,684,4826
27553,Alicia,Piercy,apiercy1o@networksolutions.com,General Manager,8042,435,8477
27329,Zahara,Routledge,zroutledge1p@edublogs.org,Technical Writer,4066,756,4822
27700,Wally,Vella,wvella1q@imgur.com,Account Executive,6104,705,6809
27477,Briney,Bolam,bbolam1r@spotify.com,Automation Specialist III,3316,1474,4790
27025,Philly,Edgecumbe,pedgecumbe1s@independent.co.uk,Staff Scientist,1631,1526,3157
27947,Florri,Wrotchford,fwrotchford1t@harvard.edu,Health Coach I,3265,1579,4844
27506,Everett,Drohane,edrohane1v@businessweek.com,Clinical Specialist,3577,1387,4964
27914,Cornie,Assender,cassender1w@plala.or.jp,Payment Adjustment Coordinator,7746,1291,9037
27834,Arie,Ellins,aellins1x@auda.org.au,Payment Adjustment Coordinator,3091,616,3707
27877,Vinnie,Dorin,vdorin1y@example.com,Accounting Assistant III,7552,990,8542
27369,Emmerich,Ricard,ericard20@usatoday.com,Statistician II,2077,1572,3649
27718,Niels,Baggs,nbaggs21@diigo.com,VP Quality Control,8228,484,8712
27362,Marthe,Garms,mgarms22@freewebs.com,Analog Circuit Design manager,9600,704,10304
27705,Donal,Barbrook,dbarbrook23@mac.com,Senior Financial Analyst,5918,1658,7576
27454,Olivier,Vost,ovost24@example.com,Database Administrator III,8328,423,8751
27569,Violet,Daborn,vdaborn25@dell.com,Geological Engineer,1132,213,1345
27521,Ramona,McGeachey,rmcgeachey26@taobao.com,Assistant Media Planner,3212,1170,4382
27858,Guthry,Bramah,gbramah27@reuters.com,Paralegal,7881,331,8212
27354,Beverlie,Harses,bharses28@oakley.com,Sales Representative,6923,926,7849
27208,Kelley,Giraudo,kgiraudo29@naver.com,Occupational Therapist,7771,693,8464
27266,Vin,Vondruska,vvondruska2a@istockphoto.com,Analog Circuit Design manager,6752,929,7681
27819,Pernell,Dyton,pdyton2b@com.com,Social Worker,5466,1490,6956
27036,Alasteir,Shorte,ashorte2c@angelfire.com,Physical Therapy Assistant,3096,848,3944
27098,Celestia,Van Haeften,cvanhaeften2e@state.gov,Research Associate,2415,1487,3902
27854,Paton,Elwood,pelwood2g@mapy.cz,Statistician II,4906,1286,6192
27615,Miof mela,Simonel,msimonel2h@clickbank.net,Senior Developer,3283,756,4039
27067,Alisander,Ethridge,aethridge2i@imgur.com,Software Engineer IV,6462,1673,8135
27526,Trish,Lathom,tlathom2j@elegantthemes.com,Financial Analyst,3288,1878,5166
27456,Tymon,Pyrke,tpyrke2k@washington.edu,VP Accounting,3739,322,4061
27587,Wilbur,Allam,wallam2l@addthis.com,Analyst Programmer,8047,1888,9935
27685,Thelma,Braam,tbraam2m@rambler.ru,Safety Technician IV,1311,391,1702
27235,Penelopa,Dibdin,pdibdin2n@jigsy.com,Statistician II,7367,579,7946
27323,Galina,Maso,gmaso2o@networkadvertising.org,Safety Technician III,9312,326,9638
27580,Xymenes,Stivey,xstivey2q@usda.gov,Environmental Specialist,6823,1200,8023
27079,Yvette,Bastone,ybastone2r@forbes.com,Computer Systems Analyst I,2110,517,2627
27811,Fidela,Kynforth,fkynforth2s@cdc.gov,Administrative Assistant III,6176,801,6977
27248,Brittani,Heber,bheber2t@kickstarter.com,Geologist II,1866,1871,3737
27633,Roddie,Kempshall,rkempshall2v@nsw.gov.au,VP Product Management,6248,1157,7405
27523,Anne-marie,Shearme,ashearme2w@sitemeter.com,Recruiting Manager,5647,709,6356
27335,Avis,Gilphillan,agilphillan2x@usgs.gov,Developer IV,4186,259,4445
27691,Rudolfo,Skate,rskate2z@nhs.uk,Database Administrator III,1249,1432,2681
27191,Waylan,Burkwood,wburkwood30@baidu.com,GIS Technical Architect,6216,1099,7315
27435,Kristoffer,Francecione,kfrancecione31@bizjournals.com,Business Systems Development Analyst,9769,1272,11041
27089,Yvor,Wickham,ywickham32@ebay.com,Marketing Manager,5805,617,6422
27060,Charles,Darragh,cdarragh33@ftc.gov,Director of Sales,3665,1929,5594
27958,Marillin,Cottill,mcottill34@twitpic.com,Senior Cost Accountant,9242,878,10120
27224,Carry,Jarratt,cjarratt35@nsw.gov.au,Engineer I,2740,840,3580
27239,Heidie,Grigaut,hgrigaut36@skype.com,Product Engineer,8663,1002,9665
27807,Sylas,Chaldecott,schaldecott37@smh.com.au,Programmer III,2305,256,2561
27444,Dwain,Skinn,dskinn39@wp.com,Cost Accountant,2148,1249,3397
27359,Henriette,Pohl,hpohl3a@wp.com,Senior Editor,8527,1886,10413
27675,Bearnard,Frankowski,bfrankowski3b@vistaprint.com,Account Coordinator,8813,769,9582
27835,Tania,Phelp,tphelp3c@multiply.com,Senior Financial Analyst,1342,917,2259
27324,Shanie,Leander,sleander3d@gnu.org,Engineer IV,5152,1901,7053
27781,Darsie,Mugford,dmugford3f@twitter.com,Web Designer IV,7192,675,7867
27577,Rusty,McGookin,rmcgookin3g@craigslist.org,Biostatistician I,5790,1091,6881
27549,Renae,Bartoszinski,rbartoszinski3h@irs.gov,Account Executive,3620,512,4132
27413,Malcolm,Goodman,mgoodman3i@pbs.org,Senior Quality Engineer,1180,1064,2244
27769,Byrann,Durbann,bdurbann3j@businessweek.com,Operator,3368,876,4244
27604,Gena,Janecek,gjanecek3k@ox.ac.uk,Associate Professor,7971,1446,9417
27868,Milzie,Gallon,mgallon3l@reverbnation.com,Nurse Practicioner,8353,643,8996
27619,Meris,Dusey,mdusey3m@theglobeandmail.com,Chief Design Engineer,8682,1626,10308
27953,Dusty,Slocum,dslocum3n@sogou.com,Recruiting Manager,7102,1175,8277
27556,Glynis,Peppard,gpeppard3o@sourceforge.net,Legal Assistant,6381,708,7089
27065,Lil,Niblett,lniblett3p@alexa.com,Account Coordinator,9397,1946,11343
27226,Kata,Thackwray,kthackwray3q@example.com,Assistant Media Planner,6424,1102,7526
27161,Crysta,Ughini,cughini3r@geocities.jp,Systems Administrator IV,4672,1930,6602
27515,Cairistiona,Mateev,cmateev3s@free.fr,Programmer II,6439,1815,8254
27997,Caz,Meeking,cmeeking3t@cdbaby.com,Software Engineer II,4474,276,4750
27458,Noel,Padula,npadula3v@weibo.com,Speech Pathologist,9156,459,9615
27645,Leigh,Episcopi,lepiscopi3w@princeton.edu,Director of Sales,6460,860,7320
27408,Roddie,Coxhead,rcoxhead3x@csmonitor.com,Nuclear Power Engineer,7815,757,8572
27143,Steffen,Angric,sangric3y@nhs.uk,Legal Assistant,1663,1012,2675
27836,Betti,Leeke,bleeke40@scientificamerican.com,Desktop Support Technician,3920,1395,5315
27120,Truda,Mews,tmews41@elegantthemes.com,Legal Assistant,7768,1465,9233
27341,Kristoforo,Dean,kdean42@msn.com,Sales Representative,8888,934,9822
27052,Chad,Tallboy,ctallboy43@woothemes.com,Dental Hygienist,7551,1445,8996
27912,Carny,Tomasz,ctomasz44@freewebs.com,VP Accounting,5543,327,5870
27654,Munroe,Vanini,mvanini45@biblegateway.com,Marketing Manager,1951,1812,3763
27292,Abbott,Valance,avalance46@smh.com.au,Administrative Officer,2161,1512,3673
27131,Marybeth,Yerrington,myerrington47@goo.gl,Accountant IV,9657,1083,10740
27133,Ealasaid,Skipper,eskipper48@zimbio.com,VP Sales,1149,1425,2574
27483,Michale,Churm,mchurm49@google.com.br,Help Desk Operator,7425,313,7738
27968,Madison,de Guise,mdeguise4a@live.com,Nuclear Power Engineer,5487,1598,7085
27308,Matthew,Greenrde,mgreenrde4b@instagram.com,Financial Advisor,6562,1278,7840
27082,Lorianne,Bambridge,lbambridge4c@instagram.com,Paralegal,2247,1341,3588
27170,Josephine,Mazzey,jmazzey4d@mozilla.org,Financial Analyst,3004,1084,4088
27735,Paige,Mizzi,pmizzi4f@cargocollective.com,Dental Hygienist,9126,1125,10251
27524,Christa,Kem,ckem4g@mediafire.com,Quality Control Specialist,6242,335,6577
27397,Ethelin,Cadreman,ecadreman4h@mac.com,Civil Engineer,8556,918,9474
27845,Lauree,Weild,lweild4i@dion.ne.jp,Senior Financial Analyst,2995,553,3548
27253,Ashton,Kenworthy,akenworthy4j@cnet.com,Chief Design Engineer,1910,1151,3061
27014,Wilfrid,Di Angelo,wdiangelo4k@thetimes.co.uk,Operator,8823,1395,10218
27810,Ulrikaumeko,Coppen,ucoppen4l@godaddy.com,Health Coach IV,3895,1693,5588
27546,Kelbee,Tamblingson,ktamblingson4m@mlb.com,Structural Engineer,5481,1834,7315
27508,Isacco,Westgate,iwestgate4o@webmd.com,Assistant Manager,8603,1856,10459
27475,Merna,Twyning,mtwyning4p@hud.gov,Electrical Engineer,3605,866,4471
27445,Moise,Barkess,mbarkess4t@cafepress.com,VP Sales,9787,392,10179
27227,Giralda,Scimonelli,gscimonelli4u@homestead.com,Senior Sales Associate,2019,989,3008
27409,Marla,Menault,mmenault4v@xinhuanet.com,VP Sales,1870,1781,3651
27617,Giustino,Sargeant,gsargeant4w@economist.com,Registered Nurse,5118,748,5866
27778,Ambrosi,McGilbon,amcgilbon4x@sina.com.cn,Staff Accountant II,1626,1705,3331
27494,Denna,Wilce,dwilce4y@chron.com,Compensation Analyst,3890,308,4198
27724,Kattie,Rosenfrucht,krosenfrucht4z@sakura.ne.jp,Compensation Analyst,8804,383,9187
27398,Torrey,Grinishin,tgrinishin51@infoseek.co.jp,Senior Cost Accountant,6457,410,6867
27166,Glen,Toffolo,gtoffolo52@jiathis.com,Occupational Therapist,4693,1131,5824
27114,Britt,Bleasdille,bbleasdille53@accuweather.com,Librarian,9091,858,9949
27832,Booth,Tennet,btennet56@bbb.org,Research Associate,2765,1764,4529
27419,Isabel,Ellings,iellings57@ow.ly,Account Coordinator,6981,820,7801
27723,Cleon,Proudler,cproudler58@dailymail.co.uk,Physical Therapy Assistant,6580,1117,7697
27574,Bellina,Minshall,bminshall59@patch.com,Recruiter,9509,453,9962
27579,Clarke,Trazzi,ctrazzi5a@ed.gov,Professor,4103,724,4827
27696,Patrizio,Jurisic,pjurisic5b@bigcartel.com,VP Quality Control,3960,678,4638
27434,Dennie,De Mattia,ddemattia5c@elpais.com,VP Quality Control,7159,1038,8197
27736,Annmarie,Reggio,areggio5d@epa.gov,Registered Nurse,9637,834,10471
27190,Tasha,Craighead,tcraighead5e@cdbaby.com,Actuary,9172,496,9668
27106,Dianemarie,Lockhart,dlockhart5f@mail.ru,Environmental Specialist,1699,1695,3394
27470,Bartholemy,Clace,bclace5g@state.gov,VP Accounting,4424,436,4860
27427,Marlane,Thormann,mthormann5h@buzzfeed.com,Account Representative II,6816,252,7068
27139,Early,Hillen,ehillen5i@yolasite.com,Assistant Manager,7336,627,7963
27145,Lizette,Hazelby,lhazelby5k@jimdo.com,Editor,6893,818,7711
27187,Jasmine,Pigrome,jpigrome5l@icio.us,Mechanical Systems Engineer,3545,420,3965
27267,Ernst,Molohan,emolohan5m@miitbeian.gov.cn,Biostatistician II,4707,445,5152
27698,Karyl,Bussons,kbussons5o@sitemeter.com,Business Systems Development Analyst,7299,581,7880
27873,Leland,Pevreal,lpevreal5p@example.com,Accountant III,2627,1285,3912
27360,Uriah,Treat,utreat5q@goo.gl,Nurse,5256,1239,6495
27168,Emmye,Charlet,echarlet5r@sohu.com,Software Test Engineer I,8583,1666,10249
27213,Nate,Cholerton,ncholerton5t@go.com,Office Assistant I,3985,501,4486
27310,Bamby,Jessopp,bjessopp5u@eepurl.com,Computer Systems Analyst III,2764,707,3471
27092,Franciska,Hellin,fhellin5v@networksolutions.com,Mechanical Systems Engineer,5489,591,6080
27087,Agnella,Mohammed,amohammed5w@histats.com,Associate Professor,1238,878,2116
27605,Kelvin,Jaynes,kjaynes5x@sohu.com,Quality Control Specialist,8912,709,9621
27771,Danny,Filipowicz,dfilipowicz5y@weebly.com,Database Administrator IV,5833,1767,7600
27799,Denver,Tapton,dtapton5z@ezinearticles.com,Account Executive,6179,220,6399
27780,Shepperd,Newton,snewton62@g.co,Human Resources Manager,4859,1661,6520
27096,Virgina,Rackley,vrackley63@twitpic.com,Assistant Professor,5960,485,6445
27693,Melisent,Grunson,mgrunson64@amazon.co.uk,Help Desk Technician,5249,1373,6622
27370,Giorgia,Douch,gdouch65@cornell.edu,Research Assistant IV,3760,1486,5246
27960,Julian,Doveston,jdoveston66@live.com,Information Systems Manager,3180,229,3409
27134,Ladonna,Trevaskus,ltrevaskus67@i2i.jp,Legal Assistant,5809,1806,7615
27797,Ardra,Dufaire,adufaire68@tuttocitta.it,Food Chemist,1751,1017,2768
27562,Edan,Mein,emein6a@booking.com,Accounting Assistant III,6838,1689,8527
27681,Imojean,Dyton,idyton6b@wp.com,GIS Technical Architect,2008,1902,3910
27279,Vittorio,Sallows,vsallows6d@google.nl,Community Outreach Specialist,4283,1242,5525
27400,Mallorie,Whitby,mwhitby6e@macromedia.com,Graphic Designer,8180,1871,10051
27548,Zackariah,Lidden,zlidden6f@uol.com.br,Account Representative III,8578,433,9011
27831,Renie,Salomon,rsalomon6g@cam.ac.uk,Electrical Engineer,9662,1653,11315
27105,Helena,Sinncock,hsinncock6i@qq.com,Cost Accountant,8672,265,8937
27928,Ardis,Trewinnard,atrewinnard6j@simplemachines.org,Editor,9031,1017,10048
27923,Andrej,Maudett,amaudett6k@meetup.com,Chief Design Engineer,5325,1033,6358
27966,Tiphanie,Jollie,tjollie6l@addtoany.com,Speech Pathologist,8262,1165,9427
27621,Sib,Klimaszewski,sklimaszewski6m@weebly.com,Data Coordiator,7169,1769,8938
27590,Daune,Brum,dbrum6n@cisco.com,Analyst Programmer,8806,513,9319
27775,Goldy,Gerardeaux,ggerardeaux6o@ameblo.jp,Tax Accountant,6125,1263,7388
27917,Blancha,Betton,bbetton6p@ning.com,Payment Adjustment Coordinator,7565,1942,9507
27502,Delaney,Sillwood,dsillwood6q@ebay.co.uk,Environmental Specialist,8992,944,9936
27542,Meta,Nockells,mnockells6r@china.com.cn,Health Coach II,4436,509,4945
27356,Jarib,Menchenton,jmenchenton6s@163.com,Financial Advisor,2774,872,3646
27333,Arlen,Smalridge,asmalridge6t@zdnet.com,Occupational Therapist,4815,1589,6404
27650,Andrey,Bogie,abogie6u@oakley.com,Pharmacist,3162,446,3608
27673,Kalil,Scowcraft,kscowcraft6v@reference.com,Marketing Assistant,9581,1495,11076
27897,Yule,Foux,yfoux6x@youku.com,Financial Analyst,5766,391,6157
27942,Barry,Screeton,bscreeton6y@is.gd,Senior Editor,5764,248,6012
27825,Johnathon,Tant,jtant6z@slate.com,Geological Engineer,1558,298,1856
27090,Jorge,Powe,jpowe70@cargocollective.com,Clinical Specialist,7575,1672,9247
27321,Rozanna,Dunlap,rdunlap71@dell.com,VP Product Management,1582,1321,2903
27981,Ambrosio,Noon,anoon72@dyndns.org,Information Systems Manager,4069,1734,5803
27970,Ricoriki,Eusden,reusden73@mac.com,Recruiter,3938,448,4386
27353,Opaline,Pavolini,opavolini74@ow.ly,Junior Executive,3108,591,3699
27996,Erica,Parkinson,eparkinson75@typepad.com,Physical Therapy Assistant,7631,206,7837
27209,Nelly,Caldroni,ncaldroni76@home.pl,Occupational Therapist,9744,1575,11319
27820,Fons,Vockings,fvockings77@delicious.com,Account Coordinator,2705,475,3180
27920,Grantley,Smolan,gsmolan78@bandcamp.com,Design Engineer,3587,419,4006
27040,Borg,Cant,bcant79@a8.net,Paralegal,2663,449,3112
27374,Shannan,Thoma,sthoma7a@google.ca,Tax Accountant,9742,982,10724
27971,Marya,Faulks,mfaulks7b@washington.edu,Database Administrator II,7024,1138,8162
27057,Lark,Senter,lsenter7c@eepurl.com,Financial Advisor,1677,1176,2853
27538,Yolanda,Gaiford,ygaiford7e@google.com.br,Recruiting Manager,4695,1130,5825
27481,Georgiana,Downing,gdowning7f@google.ru,Assistant Manager,7550,1572,9122
27485,Julee,Daouze,jdaouze7g@shinystat.com,Senior Cost Accountant,2152,623,2775
27417,Eleni,Chatres,echatres7i@pen.io,Help Desk Technician,1765,932,2697
27838,Inesita,Fleischer,ifleischer7j@virginia.edu,Systems Administrator III,6187,450,6637
27896,Daria,Sobtka,dsobtka7l@nymag.com,Sales Representative,3803,298,4101
27343,Alexei,Roaf,aroaf7m@bloomberg.com,VP Quality Control,9753,852,10605
27396,Aldous,Arthan,aarthan7n@w3.org,Payment Adjustment Coordinator,1672,920,2592
27742,Avram,Sussams,asussams7p@netlog.com,Geologist III,1366,1378,2744
27203,Shayne,Doubrava,sdoubrava7q@columbia.edu,Structural Analysis Engineer,5205,210,5415
27946,Cointon,Voak,cvoak7t@chron.com,Librarian,2012,1114,3126
27010,Marline,Tebbet,mtebbet7u@pen.io,Assistant Professor,6758,211,6969
27701,Jobi,Paulin,jpaulin7v@w3.org,Senior Financial Analyst,8967,1846,10813
27874,Chariot,Della Scala,cdellascala7w@senate.gov,Media Manager IV,4271,1654,5925
27993,Ida,Beeke,ibeeke7x@vk.com,Help Desk Technician,8618,1368,9986
27476,Dorena,Stonhewer,dstonhewer7y@kickstarter.com,Food Chemist,7902,662,8564
27260,Dora,Cawdery,dcawdery7z@redcross.org,Analog Circuit Design manager,1926,1993,3919
27042,Loree,Stenbridge,lstenbridge81@123-reg.co.uk,Teacher,7260,518,7778
27244,Catharine,Speere,cspeere83@prlog.org,Health Coach III,9091,1134,10225
27012,Felic,Berzin,fberzin84@baidu.com,Structural Analysis Engineer,6643,1331,7974
27784,Had,Varfalameev,hvarfalameev85@booking.com,Teacher,7416,1459,8875
27415,Doe,Mattityahou,dmattityahou8a@joomla.org,Payment Adjustment Coordinator,3672,1833,5505
27406,Carlie,Sidery,csidery8b@opensource.org,Senior Sales Associate,4670,1097,5767
27389,Rosalyn,Chiplin,rchiplin8c@tiny.cc,Sales Associate,6447,1021,7468
27140,Sydney,Butterwick,sbutterwick8d@nih.gov,Engineer II,7538,1988,9526
27301,Hilarius,Sobey,hsobey8f@amazon.de,Analog Circuit Design manager,1334,484,1818
27720,Lorain,Jorez,ljorez8g@senate.gov,Business Systems Development Analyst,8976,1855,10831
27103,Shirline,Allbrook,sallbrook8h@harvard.edu,Occupational Therapist,7275,583,7858
27629,Agosto,Flucker,aflucker8i@wikipedia.org,VP Marketing,1957,299,2256
27430,Karlan,Kisbee,kkisbee8k@prlog.org,Programmer Analyst IV,6947,245,7192
27388,Gratiana,Yacobsohn,gyacobsohn8l@cyberchimps.com,Professor,1775,882,2657
27204,Adam,Gerssam,agerssam8m@ustream.tv,Structural Engineer,8819,1658,10477
27212,Nikolos,Gomer,ngomer8n@drupal.org,Geologist I,6400,1540,7940
27188,Peta,Gerauld,pgerauld8o@bbc.co.uk,Environmental Tech,4306,529,4835
27631,Mellicent,Menendes,mmenendes8p@t-online.de,VP Marketing,3956,1307,5263
27243,Milt,Venables,mvenables8r@yelp.com,Social Worker,8353,1353,9706
27516,Phil,Ashingden,pashingden8s@economist.com,Web Designer IV,1877,513,2390
27291,Babs,Bassingden,bbassingden8u@usnews.com,Pharmacist,8705,908,9613
27815,Rollins,Mac Giolla Pheadair,rmacgiollapheadair8v@cafepress.com,Programmer IV,8741,1772,10513
27256,Hayley,Hainge,hhainge8w@japanpost.jp,Automation Specialist III,7343,1671,9014
27487,Winny,Strickland,wstrickland8x@who.int,Systems Administrator I,5784,863,6647
27182,Sean,Rosenfeld,srosenfeld8y@fotki.com,VP Quality Control,1096,1803,2899
27231,Batsheva,Frise,bfrise8z@cmu.edu,Pharmacist,2161,796,2957
27697,Torin,Skellion,tskellion91@admin.ch,Community Outreach Specialist,4089,834,4923
27978,Forest,Cotes,fcotes93@slashdot.org,Civil Engineer,5722,1473,7195
27216,Mada,Lander,mlander94@comsenz.com,Payment Adjustment Coordinator,8258,1153,9411
27033,Obadias,Dudny,odudny96@eventbrite.com,Software Engineer IV,8904,1586,10490
27137,Carlyle,Adamou,cadamou97@pagesperso-orange.fr,Quality Control Specialist,8291,381,8672
27183,Gael,Faltskog,gfaltskog99@drupal.org,GIS Technical Architect,3797,958,4755
27115,Sabina,Swindley,sswindley9a@xing.com,Chemical Engineer,8974,445,9419
27688,Temple,Wildbore,twildbore9b@youku.com,Help Desk Operator,9958,1042,11000
27638,Kizzee,Carette,kcarette9c@ebay.com,Assistant Media Planner,3943,1988,5931
27668,Berty,Pedron,bpedron9d@simplemachines.org,Safety Technician II,6289,1235,7524
27826,Darcie,Ribey,dribey9g@google.com.hk,Dental Hygienist,8728,949,9677
27467,Chaddy,Myles,cmyles9i@histats.com,Associate Professor,3571,1325,4896
27600,Ricardo,Stocking,rstocking9j@opera.com,Web Designer IV,3410,1673,5083
27510,Marchelle,Campana,mcampana9k@ucoz.ru,Accounting Assistant I,9908,1670,11578
27767,Elihu,Beetles,ebeetles9l@tinypic.com,Mechanical Systems Engineer,5962,880,6842
27138,Agna,Ambroisin,aambroisin9n@ucsd.edu,Clinical Specialist,2377,1752,4129
27420,Alane,Hawke,ahawke9p@oakley.com,VP Marketing,9865,1968,11833
27512,Emmet,De Gowe,edegowe9t@hexun.com,VP Sales,6348,231,6579
27586,Maura,Mound,mmound9u@trellian.com,Associate Professor,8264,599,8863
27779,Jedediah,Quilliam,jquilliam9v@adobe.com,Payment Adjustment Coordinator,6682,281,6963
27304,Iris,Sandcroft,isandcroft9y@ovh.net,Marketing Manager,4182,1156,5338
27480,Mycah,Pigram,mpigrama2@dedecms.com,Cost Accountant,3968,925,4893
27713,Tamarah,Le Marchand,tlemarchanda3@blogs.com,Social Worker,3870,979,4849
27747,Storm,Gunney,sgunneya4@mit.edu,Marketing Manager,2032,895,2927
27806,Giralda,Ricson,gricsona5@sitemeter.com,Registered Nurse,2510,1589,4099
27575,Dian,Gilvary,dgilvarya6@ifeng.com,Recruiting Manager,7293,1779,9072
27156,Jeddy,Smidmoor,jsmidmoora8@hp.com,Quality Control Specialist,8874,1004,9878
27918,Gaby,Eacle,geaclea9@vk.com,Community Outreach Specialist,8690,812,9502
27782,Zarah,Corstorphine,zcorstorphineaa@about.com,Automation Specialist IV,7595,1053,8648
27916,Madlin,Denniston,mdennistonab@last.fm,Software Engineer II,4632,979,5611
27186,Josefa,Hurkett,jhurkettac@hatena.ne.jp,Senior Editor,4160,1758,5918
27314,Marne,Horlick,mhorlickad@sciencedaily.com,Engineer IV,2723,1545,4268
27894,Sarine,Keme,skemeae@google.cn,Pharmacist,8484,521,9005
27062,Sharla,Grzesiak,sgrzesiakaf@virginia.edu,Executive Secretary,9493,1882,11375
27342,Trudey,Langlais,tlanglaisag@skyrock.com,Assistant Manager,1200,1232,2432
27124,Celestina,Gilhouley,cgilhouleyah@so-net.ne.jp,Geological Engineer,1647,1097,2744
27054,Robbyn,Sictornes,rsictornesal@virginia.edu,Environmental Tech,3969,229,4198
27007,Bertie,Derkes,bderkesam@com.com,Clinical Specialist,7394,1321,8715
27622,Mame,Heersema,mheersemaan@slashdot.org,Accounting Assistant IV,5204,1770,6974
27192,Geraldine,Banasiak,gbanasiakap@mapquest.com,Director of Sales,5656,299,5955
27576,Mirabelle,Kettow,mkettowaq@ucoz.com,Budget/Accounting Analyst II,6086,1171,7257
27652,Bonny,Birkinshaw,bbirkinshawar@dot.gov,Junior Executive,3962,1749,5711
27245,Hayden,Knighton,hknightonas@gravatar.com,Analyst Programmer,4750,1716,6466
27634,Allsun,Fenn,afennat@bing.com,Accounting Assistant I,2284,558,2842
27500,Raynard,Padilla,rpadillaau@nationalgeographic.com,Statistician II,1039,825,1864
27448,Rickert,Drayson,rdraysonav@independent.co.uk,Account Coordinator,2236,557,2793
27977,Siana,Hammarberg,shammarbergaw@icq.com,VP Sales,5267,335,5602
27198,Conrado,Kelland,ckellandax@cam.ac.uk,Media Manager IV,2521,1287,3808
27201,Elisabetta,Marsham,emarshamay@51.la,Community Outreach Specialist,1037,1007,2044
27326,Delila,Cummungs,dcummungsaz@opera.com,Design Engineer,4085,1236,5321
27905,Pearline,Weaving,pweavingb0@google.nl,Research Assistant II,4173,499,4672
27800,Joni,Petkovic,jpetkovicb1@psu.edu,Senior Sales Associate,9925,1598,11523
27816,Karlis,Hedworth,khedworthb2@mediafire.com,Sales Representative,7028,965,7993
27961,Zacherie,Heale,zhealeb3@vkontakte.ru,Executive Secretary,5300,1184,6484
27338,Bern,Gannicott,bgannicottb5@pbs.org,Help Desk Operator,1578,593,2171
27452,Inigo,McGee,imcgeeb6@chicagotribune.com,Assistant Manager,2721,1107,3828
27910,Benjy,Rue,brueb9@cdc.gov,Nurse,9935,569,10504
27357,Isa,Abatelli,iabatelliba@mysql.com,Senior Financial Analyst,5690,1211,6901
27670,Ephrayim,McEntee,emcenteebb@dyndns.org,Human Resources Assistant I,2872,293,3165
27719,Kerby,Wymer,kwymerbc@unesco.org,Research Nurse,9797,1732,11529
27636,Nicolle,Sheather,nsheatherbd@facebook.com,Speech Pathologist,3136,1888,5024
27237,Tim,Pele,tpelebf@wikipedia.org,Editor,3638,1699,5337
27302,Susette,Schollar,sschollarbg@google.de,Help Desk Technician,1890,1965,3855
27262,Evangelia,Gasnoll,egasnollbh@ask.com,Design Engineer,6333,1576,7909
27074,Hetty,Brounfield,hbrounfieldbi@spotify.com,Systems Administrator III,9330,803,10133
27871,Dalis,Syratt,dsyrattbj@nymag.com,Compensation Analyst,2857,1499,4356
27777,Kristian,Jablonski,kjablonskibl@wufoo.com,Legal Assistant,2620,1607,4227
27853,Tore,Corston,tcorstonbm@mayoclinic.com,Physical Therapy Assistant,5729,1004,6733
27390,Ericha,Kikke,ekikkebp@ezinearticles.com,Civil Engineer,3081,201,3282
27130,Emory,Deeley,edeeleybq@unicef.org,Automation Specialist IV,7014,418,7432
27531,Hirsch,Garey,hgareybr@ox.ac.uk,Software Test Engineer I,3894,830,4724
27482,Winni,Spicer,wspicerbt@yelp.com,Senior Editor,1230,1727,2957
27421,Adoree,Shirtliff,ashirtliffbu@shareasale.com,Account Coordinator,1736,1904,3640
27095,Hazel,Crowest,hcrowestbv@google.nl,Research Nurse,9625,1616,11241
27823,Noland,Newlan,nnewlanby@tripadvisor.com,Biostatistician I,1514,557,2071
27003,Norene,Lindores,nlindoresbz@mozilla.org,Software Engineer III,8133,706,8839
27937,Gisela,Ternault,gternaultc0@europa.eu,Community Outreach Specialist,2453,1667,4120
27751,Sascha,Francisco,sfranciscoc1@domainmarket.com,VP Marketing,5091,368,5459
27334,Gladi,Lindores,glindoresc2@wunderground.com,Research Assistant III,3569,1999,5568
27674,Keen,Scatcher,kscatcherc4@army.mil,Librarian,9995,205,10200
27738,Luciana,Zarfati,lzarfatic5@fastcompany.com,Chief Design Engineer,7634,1947,9581
27449,Nikolia,Gollin,ngollinc6@omniture.com,Quality Engineer,8362,1755,10117
27986,Lane,MacCauley,lmaccauleyc8@sohu.com,Staff Accountant III,1846,1996,3842
27234,Tiffy,Battie,tbattiec9@imageshack.us,Administrative Officer,8042,1825,9867
27563,Rickard,Szabo,rszaboca@weather.com,Business Systems Development Analyst,6152,400,6552
27023,Kaycee,Marsy,kmarsycc@cbc.ca,Financial Analyst,1321,901,2222
27496,Hart,Valti,hvalticd@cocolog-nifty.com,Statistician IV,7106,1000,8106
27903,Puff,Stark,pstarkce@feedburner.com,Speech Pathologist,6724,383,7107
27582,Zitella,Skews,zskewscf@google.nl,Paralegal,3068,853,3921
27511,Alric,Morefield,amorefieldcg@nba.com,Senior Financial Analyst,9992,1287,11279
27687,Jermaine,Elvidge,jelvidgeci@wordpress.org,Media Manager I,2337,1679,4016
27056,Bobina,MacCarrick,bmaccarrickcm@xrea.com,Web Designer II,8581,1019,9600
27603,Shauna,Hawkswell,shawkswellcq@theglobeandmail.com,Database Administrator II,2147,215,2362
27344,Bone,Triplett,btriplettcs@angelfire.com,Payment Adjustment Coordinator,3933,667,4600
27667,Keith,Cockton,kcocktonct@ask.com,Financial Analyst,1343,883,2226
27965,Saidee,Nardi,snardicv@guardian.co.uk,VP Sales,5501,1899,7400
27259,Sarah,Rayhill,srayhillcz@nbcnews.com,Recruiting Manager,7458,413,7871
27066,Teodoro,Sacks,tsacksd1@meetup.com,Design Engineer,5325,617,5942
27371,Noellyn,Itscowicz,nitscowiczd2@apache.org,Accountant IV,3567,1835,5402
27682,Arlana,Pittock,apittockd4@umn.edu,Budget/Accounting Analyst IV,2435,700,3135
27229,Carilyn,Atwood,catwoodd5@canalblog.com,Web Developer III,2081,1825,3906
27840,Marika,Licence,mlicenced6@un.org,Health Coach II,9164,1379,10543
27332,Cletus,Cartmer,ccartmerd8@hubpages.com,Senior Sales Associate,9407,822,10229
27274,Lind,Whapham,lwhaphamd9@sitemeter.com,Product Engineer,6993,1650,8643
27952,Nicolis,Goddert.sf,ngoddertsfda@hibu.com,Recruiter,7894,1898,9792
27651,Mariska,Estcourt,mestcourtdb@ow.ly,Marketing Manager,6859,1167,8026
27592,Georgeanne,Gerber,ggerberdc@princeton.edu,Nurse Practicioner,8421,1240,9661
27939,Vic,Giovannacc@i,vgiovannaccidd@jimdo.com,VP Sales,5543,463,6006
27861,Trudie,Tuffield,ttuffielddg@over-blog.com,Analog Circuit Design manager,7091,1055,8146
27921,Phillipp,Halle,phalledh@washingtonpost.com,Nuclear Power Engineer,6740,1667,8407
27683,Linnea,Hazelton,lhazeltondi@pinterest.com,Executive Secretary,5853,731,6584
27809,Gabbi,Slesser,gslesserdl@cam.ac.uk,Geologist III,9704,894,10598
27661,Orion,Collyer,ocollyerdn@plala.or.jp,Assistant Professor,5958,1955,7913
27864,Genvieve,Jaouen,gjaouendp@economist.com,Environmental Tech,5848,1734,7582
27821,Holt,MacCleay,hmaccleaydq@google.co.uk,Dental Hygienist,5404,1249,6653
27943,Basia,Ruseworth,bruseworthdr@sfgate.com,Civil Engineer,3748,1905,5653
27757,Shelton,Seccombe,sseccombedt@bizjournals.com,Payment Adjustment Coordinator,2846,1467,4313
27252,Goran,Imms,gimmsdv@indiegogo.com,Paralegal,2751,1985,4736
27930,Maudie,Timcke,mtimckedx@delicious.com,Pharmacist,8257,432,8689
27249,Matty,Shulver,mshulvere0@google.nl,Internal Auditor,7783,722,8505
27869,Fanya,McPheat,fmcpheate3@diigo.com,Editor,9758,1357,11115
27554,Elke,Kenafaque,ekenafaquee5@tmall.com,Accountant II,1809,886,2695
27628,Pietra,Keme,pkemee6@linkedin.com,Cost Accountant,8400,1068,9468
27982,Faydra,Klimt,fklimte7@weather.com,Sales Associate,8187,1791,9978
27349,Mechelle,Killner,mkillnere8@weather.com,Assistant Manager,4615,639,5254
27157,Eimile,Fawlo,efawloe9@mapquest.com,General Manager,6706,479,7185
27618,Robers,Uff,ruffea@hao123.com,Community Outreach Specialist,8965,1854,10819
27998,Ki,Ox,koxeb@devhub.com,Environmental Tech,3926,432,4358
27011,Felic,Strowger,fstrowgered@cbslocal.com,Director of Sales,9806,462,10268
27241,Ambrose,Gubbins,agubbinsee@sina.com.cn,Account Representative III,6275,991,7266
27907,Ninon,MacSporran,nmacsporranef@wunderground.com,Information Systems Manager,9289,1843,11132
27425,Henryetta,Barrell,hbarrelleg@sciencedirect.com,Structural Engineer,6620,1022,7642
27734,Saraann,Stoneham,sstonehameh@wikipedia.org,Safety Technician III,9198,700,9898
27206,Gregg,Stubbley,gstubbleyek@csmonitor.com,Accounting Assistant III,1919,1146,3065
27793,Mada,Guys,mguyseo@ucoz.com,Civil Engineer,9219,1544,10763
27759,Joshua,Pollastrone,jpollastroneep@vinaora.com,Quality Engineer,7676,1405,9081
27739,Gerti,Fassmann,gfassmanneq@latimes.com,Actuary,7435,482,7917
27376,Patrick,Metzig,pmetziger@usatoday.com,Community Outreach Specialist,1045,664,1709
27887,Alleyn,Gibberd,agibberdet@addthis.com,Accountant I,3459,1330,4789
27722,Marsh,Rossey,mrosseyeu@gizmodo.com,Mechanical Systems Engineer,2297,860,3157
27635,Westleigh,Scheffler,wschefflerev@barnesandnoble.com,VP Accounting,9968,634,10602
27557,Nadya,Tabram,ntabramew@unicef.org,Recruiting Manager,6507,1194,7701
27665,Griff,Steffan,gsteffanex@nasa.gov,Quality Engineer,9297,232,9529
27561,Allsun,MacTerrelly,amacterrellyez@twitter.com,Software Consultant,7830,1228,9058
27517,Dunstan,Dougliss,ddouglissf1@cdc.gov,Senior Cost Accountant,3895,217,4112
27690,Buiron,Grutchfield,bgrutchfieldf3@army.mil,Statistician III,9723,247,9970
27969,Boy,Windle,bwindlef4@mtv.com,Research Nurse,9084,1125,10209
27571,Erminie,Burdass,eburdassf5@wikia.com,Electrical Engineer,2986,1406,4392
27761,Davey,Hallatt,dhallattf6@pbs.org,Financial Analyst,1689,1046,2735
27223,Luis,Eddicott,leddicottf7@nih.gov,Food Chemist,9337,960,10297
27287,Roland,Koopman,rkoopmanf8@ning.com,Pharmacist,8791,703,9494
27692,Angeli,Yare,ayaref9@un.org,Nuclear Power Engineer,5288,1422,6710
27624,Tobye,Shorto,tshortofb@guardian.co.uk,Software Test Engineer IV,5840,372,6212
27764,Evvie,Manhare,emanhareff@sourceforge.net,Marketing Manager,1029,1693,2722
27895,Zacharias,Obispo,zobispofi@google.it,Clinical Specialist,6661,1826,8487
27842,Emanuel,Rottgers,erottgersfm@princeton.edu,Human Resources Manager,9148,1070,10218
27091,Des,Tassaker,dtassakerfn@bravesites.com,Senior Cost Accountant,4962,934,5896
27704,Trever,Gealle,tgeallefo@ed.gov,Geological Engineer,3000,713,3713
27017,Aksel,Bagehot,abagehotfr@qq.com,Junior Executive,1601,304,1905
27059,Crista,Bransden,cbransdenfs@vimeo.com,Junior Executive,8350,1055,9405
27184,Izaak,Renals,irenalsft@yahoo.com,Nurse,8143,1304,9447
27679,Antoinette,Weatherall,aweatherallfu@amazon.co.jp,Executive Secretary,2328,448,2776
27365,Leroy,Slimm,lslimmfv@bravesites.com,Staff Scientist,4322,632,4954
27632,Larina,Mitchenson,lmitchensonfy@goo.gl,Media Manager I,5283,1472,6755
27268,Arlene,Stannard,astannardfz@booking.com,Mechanical Systems Engineer,3138,224,3362
27649,Georgetta,Bassilashvili,gbassilashvilig0@google.com,Statistician II,1107,1497,2604
27658,Moreen,Bover,mboverg2@biblegateway.com,Statistician I,8874,291,9165
27748,Patricio,Sapwell,psapwellg3@geocities.com,Help Desk Technician,4619,1912,6531
27379,Cyril,Newis,cnewisg5@fotki.com,Quality Engineer,4170,852,5022
27856,Jannelle,Biddwell,jbiddwellg6@whitehouse.gov,Automation Specialist II,9041,1724,10765
27906,Reg,Sydall,rsydallg7@state.gov,Database Administrator I,1394,334,1728
27504,Gabi,Choke,gchokeg8@purevolume.com,GIS Technical Architect,4244,1288,5532
27028,Johnathan,Alpe,jalpeg9@netvibes.com,Systems Administrator III,7168,497,7665
27447,Stella,Tire,stiregd@walmart.com,Human Resources Manager,3253,813,4066
27992,Lanny,Kynan,lkynange@ocn.ne.jp,Librarian,7951,1352,9303
27174,Mallory,Filasov,mfilasovgf@cloudflare.com,VP Sales,7984,810,8794
27242,Deirdre,Hairesnape,dhairesnapegh@hibu.com,Clinical Specialist,5478,901,6379
27164,Kermit,Allebone,kallebonego@friendfeed.com,Geologist II,1732,1089,2821
27013,Shaun,Howey,showeygr@printfriendly.com,Software Test Engineer II,3812,961,4773
27405,Trina,Heddy,theddygt@unc.edu,Pharmacist,2668,602,3270
27593,Lesley,Sreenan,lsreenangu@ow.ly,Teacher,9149,1892,11041
27824,Urson,Kynsey,ukynseygy@parallels.com,Research Assistant II,2344,1405,3749
27102,Griff,Southall,gsouthallgz@chron.com,Automation Specialist IV,8155,444,8599
27474,Lamont,Bouda,lboudah2@yellowbook.com,Speech Pathologist,9849,523,10372
27752,Marris,Trammel,mtrammelh3@go.com,Chemical Engineer,1431,1903,3334
27150,Tymothy,Tindle,ttindleh4@umn.edu,Recruiter,3566,574,4140
27790,Dorree,Penhaligon,dpenhaligonh9@goo.gl,Structural Analysis Engineer,6860,1746,8606
27514,Fergus,Prandi,fprandiha@ft.com,Paralegal,4777,1924,6701
27258,Markos,Lashmar,mlashmarhb@i2i.jp,Mechanical Systems Engineer,9170,1929,11099
27666,Javier,Coney,jconeyhd@sitemeter.com,Recruiter,3235,1359,4594
27299,Sheffie,O'Nion,sonionhe@godaddy.com,Dental Hygienist,5075,886,5961
27980,Carlyle,McMurtyr,cmcmurtyrhf@wisc.edu,Staff Scientist,7638,1821,9459
27951,Christine,Pyle,cpylehg@bbb.org,Environmental Tech,5610,1708,7318
27210,Tynan,Filppetti,tfilppettihi@blogs.com,Help Desk Operator,9610,1225,10835
27795,Olivia,Seacombe,oseacombehk@xing.com,Desktop Support Technician,2141,1291,3432
27110,Burg,O'Dunniom,bodunniomhm@blinklist.com,Civil Engineer,9358,1991,11349
27159,Boigie,Whear,bwhearhn@state.tx.us,Chemical Engineer,1049,875,1924
27954,Joby,Bedlington,jbedlingtonhp@themeforest.net,Community Outreach Specialist,3162,616,3778
27499,Inez,Martel,imartelhs@list-manage.com,Geologist III,1596,654,2250
27460,Nonna,Pray,nprayht@networksolutions.com,Marketing Manager,8455,1804,10259
27331,Berny,Bembrigg,bbembrigghu@jigsy.com,Dental Hygienist,2201,1011,3212
27967,Reggie,Stolze,rstolzehv@cisco.com,GIS Technical Architect,2024,490,2514
27402,Ramsay,Woods,rwoodshw@phoca.cz,Graphic Designer,6735,794,7529
27478,Whitney,Angerstein,wangersteinhy@howstuffworks.com,Software Test Engineer IV,3541,969,4510
27625,Adler,Lawey,alaweyhz@is.gd,Mechanical Systems Engineer,1828,1776,3604
27154,Lawton,Grunder,lgrunderi0@gmpg.org,Administrative Officer,7550,429,7979
27029,Amabelle,O Mullen,aomulleni1@ed.gov,VP Quality Control,8309,228,8537
27127,Leta,Embleton,lembletoni2@google.com,Assistant Professor,1489,1237,2726
27232,Ki,Leonardi,kleonardii4@soup.io,Automation Specialist I,3403,207,3610
27872,Xenos,Cromly,xcromlyi8@opera.com,Structural Engineer,1731,603,2334
27768,Dionysus,Somers,dsomersia@wired.com,Accounting Assistant II,5650,606,6256
27199,Jehu,Edinburgh,jedinburghib@discuz.net,Operator,7077,1494,8571
27509,Marshal,Radage,mradageic@bluehost.com,Account Coordinator,3259,592,3851
27289,Ambrosius,Temblett,atemblettie@latimes.com,Associate Professor,7205,255,7460
27900,Estella,Sunman,esunmanig@mayoclinic.com,Assistant Media Planner,4588,1132,5720
27261,Aylmer,Strutton,astruttonih@t-online.de,Internal Auditor,3775,1265,5040
27995,Lauralee,Jurca,ljurcaij@blogger.com,Help Desk Operator,6999,949,7948
27956,Keith,Windrass,kwindrassik@bbb.org,Internal Auditor,3474,869,4343
27479,Mitchell,Lindenfeld,mlindenfeldil@cnn.com,Geologist IV,7041,988,8029
27507,Tam,Spurett,tspurettim@is.gd,Systems Administrator II,1118,595,1713
27457,Donny,Normanell,dnormanellin@umich.edu,VP Accounting,7128,1534,8662
27637,Tilly,Plait,tplaitip@desdev.cn,Media Manager II,7372,1624,8996
27583,Siegfried,Dallemore,sdallemoreiq@scribd.com,Executive Secretary,9383,1484,10867
27659,Antonetta,Kalisch,akalischir@jiathis.com,Professor,3093,1748,4841
27061,Marita,Owenson,mowensoniv@cornell.edu,Safety Technician I,3304,1886,5190
27442,Junette,Lonie,jlonieiz@addthis.com,Paralegal,6024,1703,7727
27211,Dulcine,Tithacott,dtithacottj1@gravatar.com,Human Resources Assistant III,9732,1822,11554
27525,Dicky,Grishakin,dgrishakinj2@google.fr,Programmer Analyst I,5624,473,6097
27578,Sonia,Menichelli,smenichellij3@squidoo.com,Nurse,4214,1015,5229
27870,Meggi,Dunks,mdunksj4@princeton.edu,Director of Sales,1395,1985,3380
27730,Adore,Brumham,abrumhamj9@yahoo.com,Compensation Analyst,6524,1964,8488
27706,Stinky,Ickovitz,sickovitzjb@tinypic.com,Internal Auditor,1299,1937,3236
27410,Johnathon,Pedley,jpedleyjd@ucoz.ru,Biostatistician III,4920,1497,6417
27069,Myrtle,Borles,mborlesje@ow.ly,Database Administrator III,5111,612,5723
27250,Charmian,Tregale,ctregalejf@desdev.cn,Nuclear Power Engineer,7585,1534,9119
27513,Phillip,Fulks,pfulksjk@altervista.org,Payment Adjustment Coordinator,9709,1269,10978
27282,Juli,Sedgmond,jsedgmondjm@indiegogo.com,Operator,8279,1859,10138
27677,Candi,Devas,cdevasjp@marriott.com,Structural Analysis Engineer,4327,605,4932
27994,Rosina,Greenan,rgreenanjs@com.com,Structural Engineer,5945,1917,7862
27468,Wiatt,Eneas,weneasjv@pagesperso-orange.fr,Associate Professor,7936,1393,9329
27309,Madelle,St. Aubyn,mstaubynjx@nytimes.com,Engineer II,4933,1812,6745
27714,Marguerite,Bickerstasse,mbickerstassek0@tinyurl.com,Actuary,3315,968,4283
27472,Jarret,Cowerd,jcowerdk1@earthlink.net,Assistant Professor,1981,1113,3094
27545,Emmey,Buscombe,ebuscombek2@kickstarter.com,Research Assistant III,6370,1150,7520
27745,Lurleen,Rihanek,lrihanekk4@simplemachines.org,Assistant Manager,5472,1501,6973
27599,Merle,Mullane,mmullaneke@bbc.co.uk,Media Manager IV,4979,1220,6199
27436,Gusty,Greyes,ggreyeskg@desdev.cn,Information Systems Manager,6562,911,7473
27077,Willow,Giacubo,wgiacubokh@1und1.de,Account Executive,1159,763,1922
27141,Torin,Hutchens,thutchenski@php.net,Engineer I,1471,720,2191
27045,Shaine,MacFarland,smacfarlandkp@narod.ru,Sales Representative,1467,673,2140
27785,Andree,Beecheno,abeechenokr@last.fm,Physical Therapy Assistant,7059,622,7681
27340,Rikki,Pabelik,rpabelikku@vinaora.com,Pharmacist,7400,1911,9311
27411,Claudianus,Tipens,ctipenskv@gravatar.com,Accounting Assistant III,4651,1923,6574
27743,Abbie,Fallon,afallonky@bbc.co.uk,Community Outreach Specialist,5622,655,6277
27097,Avery,Hysom,ahysomkz@lycos.com,Data Coordiator,3618,1426,5044
27325,Angie,Comport,acomportl1@xing.com,Environmental Specialist,2573,774,3347
27222,Dar,Relf,drelfl2@51.la,Database Administrator IV,7817,1812,9629
27466,Kristoforo,Lismore,klismorel3@ucsd.edu,Administrative Officer,3057,869,3926
27940,Nelly,Roubay,nroubayl8@flickr.com,Technical Writer,4721,607,5328
27694,Michelina,Duinbleton,mduinbletonlf@washington.edu,Office Assistant II,3902,296,4198
27689,Colan,O'Mahoney,comahoneylg@webs.com,Nurse Practicioner,5890,815,6705
27612,Manuel,Covell,mcovellli@google.de,Mechanical Systems Engineer,6078,1564,7642
27142,Jean,Cavozzi,jcavozzilk@ycombinator.com,Product Engineer,7978,582,8560
27552,Brucie,Menichillo,bmenichilloll@mysql.com,Information Systems Manager,8269,1381,9650
27818,Annadiana,Maro,amarolm@wordpress.com,Assistant Manager,1238,630,1868
27505,Stuart,Pragnell,spragnelllo@msu.edu,VP Quality Control,1822,632,2454
27385,Jessamine,Crysell,jcryselllp@intel.com,Dental Hygienist,1752,1665,3417
27765,Marena,Emmanuel,memmanuellr@google.ca,Senior Financial Analyst,5387,623,6010
27144,Sammy,Hadfield,shadfieldlt@e-recht24.de,Nurse,9736,681,10417
27539,Kylen,Folini,kfolinilv@apple.com,Administrative Officer,6881,523,7404
27119,Nestor,Killeley,nkilleleym0@state.gov,VP Sales,3206,1785,4991
27802,Fidole,Toulamain,ftoulamainm1@auda.org.au,Legal Assistant,4204,1253,5457
27737,Lucas,Edensor,ledensorm2@sogou.com,Project Manager,1891,1549,3440
27535,Sharona,Point,spointm6@jiathis.com,Actuary,6543,1724,8267
27050,Cherye,Cheese,ccheesem7@icq.com,Nuclear Power Engineer,9704,222,9926
27004,Munroe,Thorp,mthorpm8@goo.gl,Actuary,2924,547,3471
27214,Hanna,Spelsbury,hspelsburymb@imgur.com,Marketing Manager,8837,1139,9976
27180,Aguistin,Godthaab,agodthaabmd@github.com,Physical Therapy Assistant,3367,747,4114
27113,Pauly,Clampett,pclampettme@upenn.edu,Marketing Manager,9868,661,10529
27727,Sascha,Portman,sportmanmi@army.mil,Computer Systems Analyst IV,5616,1824,7440
27560,Terry,Brammall,tbrammallmk@mayoclinic.com,VP Accounting,8898,792,9690
27711,Sharline,Da Costa,sdacostaml@si.edu,Marketing Assistant,2432,274,2706
27522,Sheffie,Hindhaugh,shindhaughmm@last.fm,Project Manager,7942,1861,9803
27453,Isahella,Lillecrop,ilillecropmo@vimeo.com,Professor,6495,1961,8456
27039,Lonnard,McGerraghty,lmcgerraghtymr@vk.com,Budget/Accounting Analyst I,6731,893,7624
27175,Berk,Chezelle,bchezellems@msu.edu,Staff Accountant IV,8941,232,9173
27407,Chere,Primak,cprimakmu@blog.com,Paralegal,3392,1124,4516
27729,Hollis,Laugier,hlaugiermv@cdbaby.com,Sales Representative,2992,591,3583
27712,Dorene,Cominetti,dcominettimw@vkontakte.ru,Systems Administrator II,9691,819,10510
28000,Shelly,Ottey,sotteyn2@printfriendly.com,Assistant Professor,4331,1118,5449
27172,Hamish,Waddam,hwaddamn3@baidu.com,General Manager,4270,1480,5750
27035,Howey,Faucherand,hfaucherandn4@smugmug.com,Staff Scientist,3867,1699,5566
27047,Darryl,Coppock.,dcoppockn5@businesswire.com,Media Manager III,6709,339,7048
27663,Drucy,Simson,dsimsonn9@nih.gov,Project Manager,8618,1747,10365
27112,Saba,Reisenstein,sreisensteinna@craigslist.org,Analyst Programmer,1896,606,2502
27776,Calhoun,Waite,cwaitenc@delicious.com,Computer Systems Analyst II,7236,1490,8726
27462,Lilli,Dallyn,ldallynnd@g.co,Research Nurse,6208,1063,7271
27550,Randolph,Peaker,rpeakerng@chronoengine.com,Structural Analysis Engineer,9844,1617,11461
27902,Sydelle,Reed,sreednh@instagram.com,Nuclear Power Engineer,3045,1595,4640
27527,Trish,Foxen,tfoxennj@google.nl,Quality Control Specialist,4956,805,5761
27755,Kenny,Gosneye,kgosneyenl@pagesperso-orange.fr,Programmer Analyst II,2657,752,3409
27857,Jane,Baskwell,jbaskwellnr@pcworld.com,Nurse Practicioner,5250,1462,6712
27570,Arda,Gunderson,agundersonns@rakuten.co.jp,Administrative Assistant I,1294,1640,2934
27330,Seline,Jaumet,sjaumetnt@digg.com,Structural Engineer,4107,755,4862
27597,Linn,Shawcroft,lshawcroftnv@nyu.edu,Administrative Officer,8943,1929,10872
27037,Fin,Antonik,fantoniknz@pinterest.com,Quality Engineer,6870,1689,8559
27126,Carissa,Livezley,clivezleyo0@sakura.ne.jp,Safety Technician III,7011,302,7313
27950,Mordy,Pessolt,mpessolto2@mayoclinic.com,Software Consultant,7101,1626,8727
27885,Wald,Culleford,wcullefordo5@livejournal.com,Design Engineer,1403,1333,2736
27230,Trever,Whitaker,twhitakero9@google.com.br,Technical Writer,1046,1773,2819
27848,Francklin,Forestel,fforesteloa@geocities.jp,Statistician III,7927,910,8837
27829,Homer,Bartlomieczak,hbartlomieczakoc@irs.gov,Occupational Therapist,1262,680,1942
27760,Penelopa,Nias,pniasof@homestead.com,Database Administrator I,7385,970,8355
27016,Sly,Foffano,sfoffanoog@upenn.edu,Human Resources Manager,1005,1114,2119
27851,Royal,Odda,roddaoh@patch.com,Biostatistician II,2531,710,3241
27428,Marwin,Kirke,mkirkeoi@oaic.gov.au,Civil Engineer,7969,1654,9623
27925,Bella,Thickens,bthickensoj@eepurl.com,VP Product Management,2422,1632,4054
27529,Gunar,Bursnell,gbursnellol@cnet.com,Clinical Specialist,6100,1736,7836
27176,Gerti,Burges,gburgesom@fda.gov,Research Nurse,4140,391,4531
27656,Sarina,Longstaffe,slongstaffeop@unc.edu,Sales Representative,9225,491,9716
27740,Cullin,Gosden,cgosdenot@ucoz.com,Senior Financial Analyst,4886,823,5709
27863,Puff,Deinert,pdeinertou@pbs.org,Software Consultant,4156,1734,5890
27381,Chadwick,Meaton,cmeatonp5@ebay.com,Account Coordinator,5303,523,5826
27611,Carlene,O' Borne,cobornep6@geocities.com,Data Coordiator,1433,620,2053
27048,Zane,Skews,zskewsp9@nifty.com,General Manager,8782,245,9027
27812,D'arcy,Petofi,dpetofipb@abc.net.au,Budget/Accounting Analyst IV,2924,678,3602
27721,Cherish,Grandin,cgrandinpd@go.com,Automation Specialist I,2053,990,3043
27657,Valentin,Le Fevre,vlefevreph@berkeley.edu,Dental Hygienist,9906,1086,10992
27791,Annadiane,Mac Giany,amacgianypk@bloomberg.com,Business Systems Development Analyst,4562,1506,6068
27093,Faunie,Batten,fbattenpm@gmpg.org,Programmer Analyst I,4770,496,5266
27440,Lynette,Cavey,lcaveypr@shinystat.com,Research Assistant III,1813,507,2320
27108,Elita,Bickerdyke,ebickerdykepv@google.com.au,Professor,2022,877,2899
27377,Dagny,Edgson,dedgsonpx@newyorker.com,Graphic Designer,8783,1154,9937
27298,Robina,Bottom,rbottompz@foxnews.com,Research Nurse,9504,1539,11043
27303,Trever,Spandley,tspandleyq1@friendfeed.com,Information Systems Manager,1097,270,1367
27352,Etheline,Dorman,edormanq3@ftc.gov,Social Worker,7290,569,7859
27788,Rowena,Biasi,rbiasiq5@wix.com,Chemical Engineer,9199,1613,10812
27459,Victoir,Arrol,varrolq6@forbes.com,Teacher,4584,985,5569
27022,Cathlene,Neave,cneaveq8@princeton.edu,Recruiter,4224,991,5215
27904,Eleen,Batstone,ebatstoneqc@tinyurl.com,Senior Editor,8894,1221,10115
27068,Eolanda,Metts,emettsqf@weebly.com,Operator,8549,1438,9987
27491,Bartlett,Baggot,bbaggotqj@wunderground.com,Sales Representative,9599,1993,11592
27534,Jeanine,Philp,jphilpqk@slashdot.org,Structural Analysis Engineer,3869,474,4343
27758,Fleming,Free,ffreeql@abc.net.au,VP Quality Control,4659,1859,6518
27934,Glori,Wedderburn,gwedderburnqm@bing.com,Environmental Tech,7827,1790,9617
27702,Latrina,Gostling,lgostlingqo@prweb.com,Recruiter,2418,236,2654
27878,Piotr,Waple,pwapleqq@blinklist.com,Account Representative II,1576,334,1910
27319,Viviana,Blewitt,vblewittqt@ed.gov,Project Manager,7168,1888,9056
27469,Evangelia,Woolatt,ewoolattqu@nifty.com,Environmental Specialist,6053,216,6269
27006,Curr,Endley,cendleyr0@dot.gov,Paralegal,8568,1518,10086
27804,Viviana,Kroch,vkrochr1@state.tx.us,Account Executive,9711,1173,10884
27178,Bret,Tunsley,btunsleyr7@histats.com,Financial Advisor,7393,1326,8719
27498,Udell,Soreau,usoreaur8@utexas.edu,Media Manager I,3387,1220,4607
27555,Leigha,Seleway,lselewayrd@dagondesign.com,Junior Executive,5660,1676,7336
27888,Liuka,Battrum,lbattrumri@1und1.de,Registered Nurse,2365,1152,3517
27463,Humfried,Karczinski,hkarczinskirj@trellian.com,Biostatistician II,2225,1438,3663
27228,Lucine,Calverley,lcalverleyrk@house.gov,Human Resources Manager,6926,947,7873
27541,Queenie,Wines,qwinesrl@gmpg.org,Media Manager III,2091,792,2883
27117,Sax,Fullerd,sfullerdrm@hubpages.com,Librarian,4899,644,5543
27383,Debbie,Breming,dbremingrr@acquirethisname.com,Speech Pathologist,1319,1299,2618
28672,Daphene,Inker,dinker0@bloglines.com,Sales Representative,5302,441,5743
28522,Evonne,Sellor,esellor1@slideshare.net,Nuclear Power Engineer,8225,1318,9543
28777,Amber,Buckmaster,abuckmaster2@nsw.gov.au,Engineer I,4321,940,5261
28768,Charil,Drinan,cdrinan3@hostgator.com,Marketing Manager,5184,1114,6298
28583,Daven,Minger,dminger4@tripadvisor.com,Environmental Specialist,8191,1532,9723
28269,Gaylord,Scotter,gscotter5@about.com,VP Marketing,9725,1853,11578
28615,Aharon,Archbould,aarchbould6@cbslocal.com,Nurse Practicioner,7679,1324,9003
28234,Rolf,Madgwich,rmadgwich7@google.com.hk,Software Engineer III,6268,1112,7380
28769,Coleman,Dillingstone,cdillingstone8@mit.edu,Mechanical Systems Engineer,3337,1920,5257
28458,Keir,Wedderburn,kwedderburn9@chicagotribune.com,Paralegal,2287,1926,4213
28580,Osbourn,Blenkin,oblenkina@about.com,Sales Associate,6662,505,7167
28081,Barbi,Berling,bberlingb@mit.edu,Operator,2202,1287,3489
28229,Vassily,MacCartair,vmaccartairc@jalbum.net,Graphic Designer,1174,1709,2883
28802,Tan,Bilsford,tbilsfordd@ycombinator.com,Human Resources Manager,4784,587,5371
28971,Vivian,Pepperell,vpepperelle@networkadvertising.org,Assistant Professor,4187,559,4746
28822,Alys,Heeps,aheepsf@foxnews.com,Business Systems Development Analyst,1719,1107,2826
28943,Colly,Hannigane,channiganeg@fotki.com,Paralegal,2710,641,3351
28190,Kimbell,Storry,kstorryh@mac.com,Structural Engineer,9424,1603,11027
28474,Silvia,Renyard,srenyardi@msu.edu,Account Executive,2431,1752,4183
28033,Leroi,Batsford,lbatsfordj@mapquest.com,Geological Engineer,9319,545,9864
28811,Jammie,Whitwell,jwhitwellk@cdc.gov,Information Systems Manager,3514,1998,5512
28700,Casey,Pomfrett,cpomfrettl@uiuc.edu,Mechanical Systems Engineer,3387,1434,4821
28047,Modestine,Curlis,mcurlism@ycombinator.com,Help Desk Operator,9202,1291,10493
28434,Kriste,Trim,ktrimn@yellowbook.com,Senior Quality Engineer,7993,931,8924
28609,Caprice,Obal,cobalo@com.com,Web Designer III,2626,1984,4610
28708,Adair,Stiggers,astiggersp@google.com.hk,Community Outreach Specialist,1776,498,2274
28617,Flinn,Angier,fangierq@buzzfeed.com,Compensation Analyst,7874,281,8155
28154,Candace,Glader,cgladerr@drupal.org,Safety Technician IV,7155,1777,8932
28370,Carly,Gaffney,cgaffneys@hostgator.com,Quality Engineer,9053,1412,10465
28776,Charmaine,Sibyllina,csibyllinat@blogtalkradio.com,Physical Therapy Assistant,7213,311,7524
28369,Morrie,Benoiton,mbenoitonu@intel.com,Internal Auditor,1419,1948,3367
28665,Herc,Dalzell,hdalzellw@yelp.com,Administrative Officer,4455,1387,5842
28936,Aline,Sinden,asindenx@uol.com.br,Analyst Programmer,8491,1589,10080
28962,Tamma,Sebastian,tsebastiany@discuz.net,Staff Accountant IV,2341,1783,4124
28151,Selestina,Shaefer,sshaeferz@google.com.br,Paralegal,2259,1968,4227
28293,Inesita,Tocqueville,itocqueville10@webs.com,Human Resources Manager,8426,572,8998
28628,Jodi,Neillans,jneillans11@imdb.com,Budget/Accounting Analyst IV,5350,1240,6590
28088,Tiffanie,Lanchbury,tlanchbury12@apache.org,Programmer Analyst II,8382,925,9307
28841,Patrizia,Todaro,ptodaro13@mit.edu,Quality Control Specialist,8357,1185,9542
28981,Gerard,Klimshuk,gklimshuk14@wordpress.org,Clinical Specialist,6113,298,6411
28109,Harmony,Skunes,hskunes15@addthis.com,Product Engineer,3399,1553,4952
28078,Ely,Conochie,econochie16@woothemes.com,Environmental Tech,3518,1794,5312
28386,Geordie,Eite,geite17@epa.gov,Quality Engineer,4646,1177,5823
28790,Delly,Lauder,dlauder18@deviantart.com,Environmental Tech,7945,290,8235
28724,Papageno,Blaxley,pblaxley1a@domainmarket.com,Recruiter,6912,1702,8614
28754,Idelle,Joskovitch,ijoskovitch1b@wisc.edu,Staff Accountant II,1518,583,2101
28285,Desiree,Deards,ddeards1c@wordpress.com,Chief Design Engineer,9090,998,10088
28756,Oralle,Stebbins,ostebbins1d@toplist.cz,Accountant II,6028,623,6651
28863,Niven,Downes,ndownes1e@slashdot.org,Environmental Tech,8891,1340,10231
28162,Beverlie,Sebrook,bsebrook1g@cocolog-nifty.com,Technical Writer,5410,823,6233
28926,Dudley,Strethill,dstrethill1h@opera.com,Speech Pathologist,4454,1440,5894
28823,Gypsy,Jordan,gjordan1i@cnet.com,Assistant Manager,3272,745,4017
28737,Kristy,Priditt,kpriditt1k@merriam-webster.com,Executive Secretary,9223,630,9853
28879,Queenie,Lampbrecht,qlampbrecht1l@nyu.edu,Project Manager,9902,1669,11571
28019,Othilia,Stanmer,ostanmer1m@newyorker.com,Software Engineer II,3612,1945,5557
28548,Rip,Dearsley,rdearsley1n@woothemes.com,Teacher,3196,1071,4267
28488,Phillip,Manchett,pmanchett1o@zimbio.com,Assistant Manager,8033,1911,9944
28421,Sutton,Cumbers,scumbers1p@dmoz.org,Senior Editor,9002,1299,10301
28870,Wiatt,Pautot,wpautot1q@hatena.ne.jp,Web Developer IV,3876,1549,5425
28972,Perla,Isted,pisted1r@homestead.com,Database Administrator IV,3000,1719,4719
28573,Brooks,Brixey,bbrixey1t@archive.org,General Manager,5582,1280,6862
28192,Ermanno,Blaycock,eblaycock1u@yolasite.com,Safety Technician I,3076,1744,4820
28209,Kristian,Duer,kduer1v@wisc.edu,Paralegal,5431,1950,7381
28087,Alexei,Stainson,astainson1w@exblog.jp,Information Systems Manager,8884,271,9155
28461,Lyle,Bjorkan,lbjorkan1y@hc360.com,Internal Auditor,6066,982,7048
28518,Delaney,Garfoot,dgarfoot1z@over-blog.com,Junior Executive,5427,452,5879
28847,Chrissie,McMakin,cmcmakin20@ft.com,Engineer I,5455,1111,6566
28593,Winn,Giannazzi,wgiannazzi21@google.ca,Chief Design Engineer,2183,1869,4052
28393,Tadio,Trouel,ttrouel22@google.com.br,Geological Engineer,6582,526,7108
28907,Noel,Glasspoole,nglasspoole23@flavors.me,Assistant Media Planner,9689,1708,11397
28702,Ashia,Hedingham,ahedingham24@ezinearticles.com,VP Accounting,6431,687,7118
28038,Jae,Yokel,jyokel25@meetup.com,Actuary,4877,1635,6512
28625,Lorry,Duffan,lduffan26@meetup.com,Marketing Assistant,3317,1169,4486
28113,Ermentrude,Jewsbury,ejewsbury27@cnet.com,Web Designer IV,9477,1901,11378
28601,Salem,Elverston,selverston28@yahoo.co.jp,Geological Engineer,7519,645,8164
28153,Dana,Normanvill,dnormanvill2a@youku.com,Associate Professor,7328,1070,8398
28542,Brear,Tomlett,btomlett2b@skyrock.com,Junior Executive,8940,1248,10188
28772,Augustine,Agostini,aagostini2d@narod.ru,Dental Hygienist,9517,1195,10712
28861,Daniella,Firebrace,dfirebrace2e@nhs.uk,Financial Analyst,2167,677,2844
28966,Eloisa,Dargavel,edargavel2g@delicious.com,Analyst Programmer,7617,1382,8999
28387,Marna,Oldcote,moldcote2h@usatoday.com,Actuary,5081,270,5351
28937,Sibylla,Duffin,sduffin2i@instagram.com,Marketing Assistant,1931,597,2528
28045,Karie,Greschik,kgreschik2j@pinterest.com,Cost Accountant,9300,1178,10478
28472,Skelly,Burless,sburless2k@npr.org,Nurse,7308,1878,9186
28429,Esmaria,Noweak,enoweak2l@digg.com,Account Representative III,4614,1578,6192
28066,Addison,Jentin,ajentin2m@live.com,Office Assistant II,9592,208,9800
28163,Rianon,Verty,rverty2n@hao123.com,Financial Advisor,5102,1056,6158
28784,Barbette,Klyn,bklyn2o@over-blog.com,VP Sales,9375,330,9705
28648,Bing,Roebottom,broebottom2p@mayoclinic.com,Community Outreach Specialist,5387,1081,6468
28365,Barclay,Pott,bpott2r@bizjournals.com,Marketing Assistant,7072,1281,8353
28873,Claybourne,Wonter,cwonter2s@imgur.com,Data Coordiator,1345,359,1704
28341,Ephraim,Sendall,esendall2t@wordpress.org,Structural Analysis Engineer,7486,595,8081
28317,Sigismund,Malinson,smalinson2u@ucsd.edu,Staff Scientist,7215,1520,8735
28629,Ericha,Ciccotto,eciccotto2v@zdnet.com,Food Chemist,2166,1580,3746
28974,Amelita,Baines,abaines2w@drupal.org,Geologist III,1381,1471,2852
28897,Jodie,Hardcastle,jhardcastle2y@wikia.com,Electrical Engineer,2725,769,3494
28402,Aridatha,Brunroth,abrunroth2z@cafepress.com,Staff Scientist,5438,1866,7304
28463,Frederigo,Glanister,fglanister30@biglobe.ne.jp,Biostatistician III,2253,1658,3911
28853,Laina,Kilfeather,lkilfeather31@amazon.co.jp,Research Nurse,5298,476,5774
28257,Ethelind,Bodycomb,ebodycomb32@usgs.gov,Sales Associate,6151,830,6981
28262,Eleen,Forestel,eforestel33@sourceforge.net,Mechanical Systems Engineer,2462,688,3150
28855,Melisande,Berling,mberling34@deviantart.com,Chemical Engineer,1875,1921,3796
28121,Fredericka,Hubbis,fhubbis35@infoseek.co.jp,Recruiting Manager,2910,1913,4823
28556,Tad,Lowe,tlowe36@cloudflare.com,Paralegal,6418,1484,7902
28476,Trudie,Silverson,tsilverson37@shutterfly.com,Chemical Engineer,1412,1064,2476
28624,Kerk,Ringe,kringe38@cdc.gov,Sales Associate,9332,1088,10420
28832,Shanta,Kewish,skewish39@issuu.com,Engineer III,5262,1883,7145
28383,Con,Hastie,chastie3a@cisco.com,Electrical Engineer,2152,1957,4109
28710,Druci,Wellman,dwellman3b@arizona.edu,Media Manager I,5299,1928,7227
28098,Conrado,Jobern,cjobern3c@rambler.ru,Help Desk Operator,2821,1451,4272
28455,Creighton,Berr,cberr3d@free.fr,Marketing Assistant,8148,989,9137
28989,Reynard,Burhill,rburhill3e@topsy.com,Web Developer IV,7386,617,8003
28978,Cordelia,McComas,cmccomas3g@soup.io,Web Designer I,1807,637,2444
28867,Andrey,Bontoft,abontoft3h@seattletimes.com,Clinical Specialist,6839,622,7461
28956,Marissa,Fransemai,mfransemai3j@hibu.com,Senior Sales Associate,7679,1692,9371
28773,Cordie,Mayze,cmayze3k@rediff.com,Senior Sales Associate,9528,969,10497
28988,Lexi,Hirth,lhirth3l@weather.com,Human Resources Manager,4805,1823,6628
28826,Lena,Rounds,lrounds3m@google.com.au,Editor,4317,343,4660
28785,Adamo,Greatex,agreatex3n@umich.edu,Human Resources Manager,6160,233,6393
28505,Giacinta,Sturdy,gsturdy3o@ifeng.com,Analyst Programmer,3132,695,3827
28552,Farrel,Dukesbury,fdukesbury3q@answers.com,Chief Design Engineer,8359,1223,9582
28857,Rochella,Thain,rthain3r@symantec.com,Food Chemist,3099,1144,4243
28493,Moselle,Maving,mmaving3s@loc.gov,Editor,2493,618,3111
28944,Lincoln,McLean,lmclean3t@va.gov,Computer Systems Analyst I,6345,247,6592
28516,Tresa,Biasetti,tbiasetti3u@businessweek.com,VP Marketing,3947,733,4680
28313,Mair,Lesley,mlesley3v@printfriendly.com,Senior Sales Associate,2082,941,3023
28206,Ulrick,Christiensen,uchristiensen3w@sun.com,Nurse Practicioner,5537,1014,6551
28023,Payton,Syrett,psyrett3x@about.me,Structural Analysis Engineer,2041,1495,3536
28968,Ravid,Fassbindler,rfassbindler3y@sbwire.com,Account Executive,4120,1265,5385
28453,Nonah,Geockle,ngeockle3z@yellowbook.com,Senior Sales Associate,3491,1457,4948
28536,Netta,Armatidge,narmatidge40@soup.io,Senior Cost Accountant,8729,820,9549
28934,Tanney,France,tfrance41@oaic.gov.au,Physical Therapy Assistant,7014,1440,8454
28309,Alberik,Saker,asaker42@meetup.com,Financial Advisor,9734,1814,11548
28064,Brion,Canty,bcanty43@mayoclinic.com,Mechanical Systems Engineer,4836,1206,6042
28688,Haskell,Meritt,hmeritt44@comcast.net,Web Designer IV,3556,1134,4690
28272,Niki,Willshear,nwillshear46@mlb.com,Software Consultant,1451,708,2159
28780,Glori,MacInnes,gmacinnes47@arizona.edu,Software Consultant,9360,1353,10713
28835,Amerigo,Acosta,aacosta49@aol.com,Librarian,1821,1000,2821
28851,Goldy,Ledner,gledner4a@fastcompany.com,Chief Design Engineer,2836,1310,4146
28634,Suki,Wands,swands4c@cam.ac.uk,Web Developer II,3518,1501,5019
28620,Isaak,Roscamp,iroscamp4d@hhs.gov,Nuclear Power Engineer,1073,713,1786
28243,Herschel,Freezer,hfreezer4e@mit.edu,Social Worker,1460,447,1907
28610,Donnell,Orta,dorta4f@multiply.com,Web Developer I,1526,1142,2668
28094,Sydel,Hoofe,shoofe4h@google.es,Executive Secretary,8978,700,9678
28597,Giuditta,Peert,gpeert4i@wordpress.org,Media Manager II,7062,606,7668
28027,Iago,Cowdroy,icowdroy4k@reverbnation.com,Statistician II,6182,1436,7618
28185,Tersina,Veldstra,tveldstra4l@auda.org.au,Research Assistant II,1491,1059,2550
28588,Christoffer,Adamsson,cadamsson4n@npr.org,Nuclear Power Engineer,1218,1080,2298
28086,Agata,Spiller,aspiller4o@ifeng.com,Information Systems Manager,1725,402,2127
28878,Heinrick,Maw,hmaw4p@merriam-webster.com,Business Systems Development Analyst,4662,1456,6118
28149,Rosetta,Merrick,rmerrick4r@un.org,Nurse Practicioner,7912,820,8732
28980,Byrom,Roscam,broscam4s@cpanel.net,Speech Pathologist,7522,700,8222
28399,Kaiser,Cogger,kcogger4t@unblog.fr,Dental Hygienist,7123,1354,8477
28653,Rufus,Bulman,rbulman4u@php.net,Help Desk Operator,3164,941,4105
28218,Loy,Meffin,lmeffin4v@com.com,Geological Engineer,4152,1566,5718
28749,Janek,Kenforth,jkenforth4w@tripadvisor.com,Internal Auditor,7995,925,8920
28507,Hillard,Gindghill,hgindghill4x@devhub.com,Office Assistant III,5966,706,6672
28525,Sybille,Ferraraccio,sferraraccio4z@netlog.com,Assistant Manager,1078,709,1787
28241,Eilis,Championnet,echampionnet50@parallels.com,VP Quality Control,6887,953,7840
28143,Roderich,Learmont,rlearmont52@abc.net.au,Electrical Engineer,1650,254,1904
28703,Jervis,Entwistle,jentwistle53@ucla.edu,Senior Sales Associate,7317,295,7612
28909,Randi,Vater,rvater54@gov.uk,Web Developer II,1725,801,2526
28052,Erich,Pavlov,epavlov55@opensource.org,Technical Writer,6463,1668,8131
28865,Jenni,Yeskin,jyeskin56@joomla.org,Geologist I,8267,894,9161
28436,Louis,Baldry,lbaldry57@live.com,Assistant Manager,9952,386,10338
28743,Milly,Croisdall,mcroisdall58@bloomberg.com,Senior Sales Associate,4699,214,4913
28200,Hansiain,Dunsford,hdunsford59@tamu.edu,Environmental Specialist,8950,1023,9973
28345,Selia,Ofen,sofen5a@dot.gov,Help Desk Operator,7980,228,8208
28948,Mari,Cattlow,mcattlow5b@newyorker.com,VP Marketing,3760,741,4501
28602,Ignace,Poxton,ipoxton5c@multiply.com,Administrative Officer,4623,1583,6206
28095,Anestassia,Straneo,astraneo5d@hp.com,Senior Editor,6398,1183,7581
28092,Abby,Mariel,amariel5e@yellowpages.com,Media Manager IV,4779,529,5308
28138,Gherardo,Pluthero,gpluthero5f@phoca.cz,Software Test Engineer III,7837,607,8444
28872,Stevie,Kliment,skliment5g@yolasite.com,Legal Assistant,4339,1831,6170
28376,Alli,Grolmann,agrolmann5i@ca.gov,Analog Circuit Design manager,7718,742,8460
28130,Etti,Yarn,eyarn5j@toplist.cz,Quality Engineer,1061,940,2001
28568,Hobie,Loines,hloines5k@si.edu,Assistant Manager,7276,1934,9210
28718,Elisha,Cosyns,ecosyns5l@mtv.com,Financial Advisor,3962,1683,5645
28120,Sutherland,Crutch,scrutch5n@washingtonpost.com,Assistant Manager,5609,316,5925
28337,Augy,Maffucci,amaffucci5o@alibaba.com,Librarian,1339,1677,3016
28289,Arni,Costen,acosten5p@businessinsider.com,Chemical Engineer,9995,534,10529
28142,Berte,Bon,bbon5q@ezinearticles.com,Safety Technician IV,6966,540,7506
28565,Stanly,Bergeau,sbergeau5r@pinterest.com,Structural Analysis Engineer,3835,439,4274
28320,Prescott,Reubbens,preubbens5s@phoca.cz,Technical Writer,5820,1264,7084
28247,Tani,Wallworth,twallworth5t@amazon.co.uk,Health Coach II,3054,1132,4186
28326,Daisi,Rignall,drignall5u@amazon.com,Help Desk Technician,6438,1888,8326
28291,Arv,Fitzgerald,afitzgerald5v@odnoklassniki.ru,Business Systems Development Analyst,3586,1507,5093
28159,Rosaleen,Quantick,rquantick5w@tamu.edu,Software Consultant,5338,947,6285
28340,Bendite,Saunier,bsaunier5x@xrea.com,Food Chemist,5182,467,5649
28862,Ellsworth,O'Heneghan,eoheneghan5y@geocities.jp,Assistant Media Planner,7157,1465,8622
28661,Felita,Hainey,fhainey5z@ucoz.ru,Legal Assistant,4372,1946,6318
28673,Maren,Levi,mlevi60@ifeng.com,Registered Nurse,7632,1411,9043
28663,Cletis,Tawse,ctawse61@netvibes.com,VP Quality Control,8218,1845,10063
28852,Doyle,Smees,dsmees62@seesaa.net,Chief Design Engineer,9444,404,9848
28076,Rori,Evett,revett63@cisco.com,Social Worker,8442,1904,10346
28146,Alard,Fice,afice64@go.com,Geologist III,9279,1304,10583
28408,Rose,De Cristoforo,rdecristoforo65@linkedin.com,Financial Advisor,3813,1950,5763
28642,Josi,Condliffe,jcondliffe66@ca.gov,Research Associate,8092,244,8336
28976,Conni,Lilleman,clilleman67@sitemeter.com,Design Engineer,5874,1082,6956
28728,Christie,Aupol,caupol68@google.com.au,VP Sales,8596,1883,10479
28645,Gaile,Simoncello,gsimoncello69@constantcontact.com,Nuclear Power Engineer,4296,1764,6060
28213,Lazar,Laughnan,llaughnan6a@oaic.gov.au,Office Assistant II,9438,412,9850
28240,Lillian,Valett,lvalett6b@mayoclinic.com,Physical Therapy Assistant,6783,822,7605
28186,Brose,Drewell,bdrewell6c@pinterest.com,Financial Advisor,5291,538,5829
28306,Burlie,Suero,bsuero6d@sun.com,Speech Pathologist,1459,1302,2761
28276,Nanine,Guerrero,nguerrero6e@desdev.cn,Physical Therapy Assistant,5843,1098,6941
28191,Jarrid,Reynard,jreynard6g@edublogs.org,Editor,9906,934,10840
28999,Kristoffer,Stebbings,kstebbings6h@surveymonkey.com,Mechanical Systems Engineer,1587,1784,3371
28246,Niki,Mosedall,nmosedall6i@house.gov,Programmer Analyst III,7089,1462,8551
28118,Cosmo,Gosz,cgosz6j@bandcamp.com,Automation Specialist III,6491,1606,8097
28690,Solly,Gianotti,sgianotti6k@smugmug.com,Dental Hygienist,2797,1224,4021
28171,Alli,Winslade,awinslade6l@ning.com,Pharmacist,6491,1286,7777
28806,Sande,Halligan,shalligan6m@rediff.com,Nurse Practicioner,3747,1568,5315
28714,Gilbertina,Allibone,gallibone6n@fda.gov,Environmental Tech,1624,1988,3612
28794,Dorice,Merton,dmerton6o@oakley.com,Help Desk Operator,8997,697,9694
28425,Lu,MacAlpyne,lmacalpyne6p@free.fr,Staff Accountant IV,3398,1181,4579
28924,Al,Antonelli,aantonelli6q@nydailynews.com,Geologist IV,3362,1775,5137
28122,Guendolen,Luty,gluty6r@fastcompany.com,Compensation Analyst,2832,516,3348
28179,Augusto,Pratton,apratton6u@rambler.ru,Community Outreach Specialist,2815,460,3275
28297,Patin,Bragginton,pbragginton6v@dell.com,Administrative Officer,6494,1728,8222
28684,Jule,Josefer,jjosefer6w@engadget.com,Recruiter,5211,547,5758
28874,Cliff,Nellies,cnellies6y@stanford.edu,Graphic Designer,1095,566,1661
28792,Biron,Burleigh,bburleigh6z@omniture.com,Chemical Engineer,8541,488,9029
28529,Loralee,O'Scannill,loscannill71@washington.edu,Financial Analyst,2552,1578,4130
28586,Odessa,Gotcliff,ogotcliff72@pcworld.com,Structural Analysis Engineer,2693,1882,4575
28839,Morley,Schoolcroft,mschoolcroft73@scribd.com,Product Engineer,8287,1626,9913
28203,Massimo,Duding,mduding74@jimdo.com,Marketing Assistant,2484,1079,3563
28059,Travus,MacPadene,tmacpadene75@china.com.cn,General Manager,3471,609,4080
28331,Elvira,Sabben,esabben76@4shared.com,Marketing Assistant,5930,996,6926
28107,Josi,Asals,jasals77@cnn.com,Systems Administrator II,5687,399,6086
28919,Haze,Kenneway,hkenneway78@youtu.be,Administrative Officer,3853,522,4375
28478,Nanci,Muffen,nmuffen79@icq.com,Web Designer II,1486,1292,2778
28685,Anastassia,Gherardelli,agherardelli7a@bloomberg.com,Associate Professor,1121,1142,2263
28457,Ronnica,Barbier,rbarbier7b@sciencedirect.com,Quality Control Specialist,7107,1129,8236
28144,Clair,Mongain,cmongain7d@yale.edu,Help Desk Operator,6119,1569,7688
28619,Teodora,Towell,ttowell7e@dmoz.org,Associate Professor,4922,1274,6196
28670,Delcina,Haxby,dhaxby7f@mayoclinic.com,Junior Executive,6307,1171,7478
28982,Alair,Qualtro,aqualtro7g@facebook.com,Structural Engineer,7766,1592,9358
28779,Bertrand,Brampton,bbrampton7i@webeden.co.uk,Structural Analysis Engineer,5499,593,6092
28963,Hillier,Oels,hoels7j@upenn.edu,Geological Engineer,4572,913,5485
28927,Cecilia,Willmer,cwillmer7k@yahoo.co.jp,Recruiter,7080,1299,8379
28432,Noland,Reader,nreader7l@intel.com,Mechanical Systems Engineer,2455,1523,3978
28275,Easter,Tait,etait7o@abc.net.au,Project Manager,8712,896,9608
28307,Kim,Fladgate,kfladgate7p@goo.gl,Chemical Engineer,5821,1924,7745
28738,Karyl,Blankman,kblankman7q@so-net.ne.jp,Administrative Officer,1287,1576,2863
28913,Clayton,Andrey,candrey7r@posterous.com,Speech Pathologist,2340,793,3133
28167,Natal,O'Lunney,nolunney7t@amazon.co.uk,Technical Writer,5220,435,5655
28757,Sigismund,Macek,smacek7u@statcounter.com,Social Worker,5100,1242,6342
28477,Mariska,Eagers,meagers7v@cnet.com,Biostatistician IV,7456,1322,8778
28706,Lauri,Riehm,lriehm7x@boston.com,Social Worker,6713,1947,8660
28922,Vanna,Dy,vdy7z@bluehost.com,Professor,9767,1020,10787
28009,Neely,Hadcock,nhadcock82@devhub.com,Sales Associate,6142,1937,8079
28389,Lurlene,Matton,lmatton83@yellowbook.com,Account Representative IV,4575,484,5059
28893,Hilde,Rutland,hrutland84@vinaora.com,Human Resources Manager,8480,709,9189
28694,Yancy,Kitt,ykitt85@meetup.com,Structural Engineer,7708,1245,8953
28242,Conrado,Vaugham,cvaugham87@google.ru,VP Accounting,8508,1789,10297
28638,Noreen,Joll,njoll88@abc.net.au,GIS Technical Architect,5954,1754,7708
28318,Minerva,Divell,mdivell8a@marriott.com,Quality Engineer,8568,956,9524
28044,Vassily,Heaney,vheaney8b@barnesandnoble.com,Pharmacist,3467,848,4315
28411,Trenna,Driscoll,tdriscoll8e@shinystat.com,Office Assistant II,2801,1270,4071
28043,Cassandra,Bosma,cbosma8g@diigo.com,Junior Executive,5344,1316,6660
28492,Perceval,Simons,psimons8h@hhs.gov,Legal Assistant,1338,402,1740
28521,Timothee,Woodard,twoodard8i@csmonitor.com,Software Consultant,4291,912,5203
28520,Judye,Fowley,jfowley8j@nyu.edu,Chemical Engineer,7185,865,8050
28788,Kandy,Harriot,kharriot8k@dot.gov,VP Accounting,4613,513,5126
28014,Devlin,Deegan,ddeegan8l@google.com.br,Social Worker,3136,910,4046
28986,Alida,Bentham3,abentham8n@theguardian.com,Accountant III,3338,1938,5276
28564,Jacquetta,Callaway,jcallaway8p@themeforest.net,Account Representative IV,2432,552,2984
28538,Adiana,Petrazzi,apetrazzi8q@instagram.com,Paralegal,2771,691,3462
28551,Nevsa,Cornelissen,ncornelissen8r@theatlantic.com,Budget/Accounting Analyst I,8757,470,9227
28264,Griswold,Patron,gpatron8s@furl.net,Structural Engineer,4317,1217,5534
28534,Sonja,Lack,slack8x@a8.net,Editor,9045,1972,11017
28946,Rafaela,Gerrit,rgerrit8y@statcounter.com,Structural Engineer,2004,1546,3550
28445,Franchot,Warbeys,fwarbeys8z@cloudflare.com,Computer Systems Analyst IV,8850,471,9321
28699,Annabelle,Robuchon,arobuchon90@vimeo.com,Dental Hygienist,3651,1128,4779
28884,Ludovico,Blaxlande,lblaxlande92@amazon.co.uk,General Manager,4270,479,4749
28495,Dene,Menezes,dmenezes93@bandcamp.com,Desktop Support Technician,5454,1670,7124
28531,Ursulina,Jaffra,ujaffra95@jugem.jp,Software Test Engineer II,7969,490,8459
28102,Esme,Whewell,ewhewell96@hc360.com,Operator,3238,665,3903
28079,Sharron,Aaronson,saaronson98@discovery.com,VP Quality Control,3385,465,3850
28715,Mick,Georgel,mgeorgel99@g.co,Senior Cost Accountant,5123,1818,6941
28290,Silvana,Landes,slandes9a@unicef.org,General Manager,8727,466,9193
28647,Shepherd,Gabbotts,sgabbotts9b@paypal.com,Financial Advisor,1494,1861,3355
28032,Leora,Harrald,lharrald9d@nature.com,Electrical Engineer,5271,1819,7090
28964,Ashley,Delia,adelia9e@linkedin.com,Administrative Officer,8094,1149,9243
28400,Milly,Tallis,mtallis9h@free.fr,Geologist IV,1958,1843,3801
28069,Hurleigh,Lober,hlober9i@blogs.com,Recruiter,9071,407,9478
28954,Pattie,Coldman,pcoldman9j@discuz.net,Quality Control Specialist,8924,1212,10136
28080,Jabez,Jobey,jjobey9k@fda.gov,Nurse Practicioner,4767,1013,5780
28412,Orelle,Galley,ogalley9l@telegraph.co.uk,Senior Cost Accountant,9646,668,10314
28443,Fenelia,Eriksson,feriksson9m@wordpress.org,Biostatistician II,9871,1915,11786
28361,Gibby,Whistan,gwhistan9o@drupal.org,VP Quality Control,8836,434,9270
28908,Kiley,Dudley,kdudley9p@reddit.com,Pharmacist,1009,1690,2699
28504,Paola,Decourt,pdecourt9q@aboutads.info,Chemical Engineer,6909,1790,8699
28053,Cristen,Bysouth,cbysouth9r@sourceforge.net,Health Coach I,3362,1955,5317
28502,Mason,Beckworth,mbeckworth9s@adobe.com,Payment Adjustment Coordinator,7670,503,8173
28139,Alysia,Puddefoot,apuddefoot9t@oracle.com,Office Assistant I,8804,841,9645
28323,Minerva,Clines,mclines9z@youku.com,Statistician II,7102,478,7580
28644,Adriana,Holbie,aholbiea0@addthis.com,Actuary,4104,1982,6086
28499,Weber,Durand,wduranda1@ihg.com,Design Engineer,9298,1056,10354
28251,Mirelle,Cutcliffe,mcutcliffea2@latimes.com,Marketing Assistant,5206,576,5782
28938,Meredithe,Zumbusch,mzumbuscha3@bbc.co.uk,Mechanical Systems Engineer,1435,725,2160
29000,Babbette,MacCartan,bmaccartana4@blogger.com,Help Desk Operator,1427,1944,3371
28170,Daphna,Stevenson,dstevensona5@github.com,Senior Editor,2003,1948,3951
28413,Hillie,Murrigan,hmurrigana6@cnet.com,Systems Administrator IV,1109,550,1659
28931,Gipsy,Fowkes,gfowkesa7@globo.com,Marketing Assistant,8561,257,8818
28018,Jo,Lindores,jlindoresa9@wired.com,Research Assistant III,3774,1280,5054
28734,Doris,Pirrey,dpirreyaa@unc.edu,Speech Pathologist,4341,1980,6321
28881,Dolorita,Atkirk,datkirkab@hp.com,Paralegal,3595,1351,4946
28024,Elwood,Rosthorn,erosthornac@blinklist.com,Engineer II,7922,1090,9012
28212,Colby,McIlwraith,cmcilwraithad@wunderground.com,Nurse,2610,1092,3702
28519,Coral,Pantlin,cpantlinag@xing.com,Actuary,5345,741,6086
28975,Rosalynd,Glasebrook,rglasebrookah@auda.org.au,Community Outreach Specialist,3614,864,4478
28787,Worden,Doll,wdollai@miitbeian.gov.cn,Safety Technician III,1258,749,2007
28316,Shep,McMoyer,smcmoyerak@meetup.com,Tax Accountant,8851,1444,10295
28973,Bernadine,Fitzer,bfitzeral@dmoz.org,Speech Pathologist,7608,733,8341
28175,Amalle,Tremmel,atremmelan@mapquest.com,Nuclear Power Engineer,1269,1507,2776
28104,Pietra,Paszek,ppaszekar@bluehost.com,Graphic Designer,6066,721,6787
28535,Shaw,Crumley,scrumleyas@google.fr,Clinical Specialist,6769,935,7704
28182,Maurine,Kinsett,mkinsettat@deliciousdays.com,Senior Financial Analyst,6860,1559,8419
28750,Elisabetta,Holleworth,eholleworthav@trellian.com,Senior Financial Analyst,6977,1647,8624
28705,Hussein,Claus,hclausax@mediafire.com,Engineer IV,1478,1830,3308
28357,Wally,Covington,wcovingtonay@wisc.edu,Paralegal,2297,1436,3733
28442,Leif,Preto,lpretoaz@independent.co.uk,Nurse Practicioner,6021,1437,7458
28918,Ted,Picford,tpicfordb0@multiply.com,Assistant Media Planner,9007,830,9837
28373,Hilario,Barthelme,hbarthelmeb1@purevolume.com,Software Test Engineer II,9937,1575,11512
28723,Rooney,Estrella,restrellab4@cbc.ca,Information Systems Manager,7984,1974,9958
28475,Gigi,Matschoss,gmatschossb5@cloudflare.com,Director of Sales,2304,204,2508
28157,Wakefield,Cargenven,wcargenvenb6@wunderground.com,Software Engineer I,8493,396,8889
28299,Corbet,Raven,cravenb7@taobao.com,Financial Analyst,2305,1111,3416
28058,Liva,Loines,lloinesb8@cnet.com,Research Nurse,9165,321,9486
28736,Tommi,Cole,tcoleb9@businessweek.com,Pharmacist,5875,499,6374
28864,Kathlin,Tommei,ktommeiba@people.com.cn,Payment Adjustment Coordinator,4009,690,4699
28834,Deidre,Spours,dspoursbc@bluehost.com,Health Coach II,2379,693,3072
28843,Jaymie,Hardcastle,jhardcastlebe@etsy.com,Administrative Assistant III,5293,940,6233
28303,Allsun,Mallows,amallowsbf@networksolutions.com,Human Resources Assistant IV,4265,1635,5900
28744,Luce,Di Carli,ldicarlibg@miitbeian.gov.cn,Assistant Professor,7637,270,7907
28995,Arabelle,Dureden,aduredenbh@patch.com,Director of Sales,3468,1229,4697
28608,Brigitta,Greville,bgrevillebi@guardian.co.uk,Programmer Analyst IV,6250,228,6478
28741,Conrad,Jakovijevic,cjakovijevicbj@microsoft.com,Staff Accountant I,3535,579,4114
28050,Ninon,McMurthy,nmcmurthybl@t-online.de,VP Product Management,7808,452,8260
28827,Freemon,Eastope,feastopebm@twitpic.com,Chief Design Engineer,2594,1512,4106
28091,Pippa,Dumpleton,pdumpletonbn@paypal.com,Project Manager,8244,1831,10075
28589,Elmo,Zecchii,ezecchiibr@aboutads.info,Financial Advisor,4891,294,5185
28008,August,Pegden,apegdenbs@google.co.jp,Technical Writer,6431,401,6832
28666,Tadeas,Conkling,tconklingbt@cam.ac.uk,Biostatistician III,6300,374,6674
28224,Bobby,Ruste,brustebv@ftc.gov,Nuclear Power Engineer,2960,1010,3970
28351,Mattias,Bullimore,mbullimoreby@creativecommons.org,Technical Writer,2939,1847,4786
28210,Hardy,Lyvon,hlyvonbz@cdbaby.com,Statistician I,9182,703,9885
28055,Devin,Echalier,dechalierc0@digg.com,Editor,3598,336,3934
28440,Sumner,Kehoe,skehoec1@wunderground.com,Human Resources Assistant III,9408,1939,11347
28917,Elton,Kruschov,ekruschovc2@pen.io,Health Coach II,1094,232,1326
28134,Frieda,St. Hill,fsthillc3@google.es,Assistant Professor,8105,671,8776
28901,Tara,Lorrie,tlorriec4@nsw.gov.au,Speech Pathologist,9497,1818,11315
28818,Joela,Skipperbottom,jskipperbottomc5@symantec.com,Mechanical Systems Engineer,4475,1905,6380
28592,Stanfield,Sinclaire,ssinclairec7@cbsnews.com,Operator,5762,1021,6783
28310,Gabriel,Zecchi,gzecchic8@google.ru,Food Chemist,8656,625,9281
28591,Ingaborg,Fateley,ifateleyc9@zimbio.com,Staff Scientist,9979,1517,11496
28441,Reynard,Dufton,rduftoncd@cnet.com,Environmental Specialist,7095,1164,8259
28330,Ransell,Reilly,rreillyce@elpais.com,Cost Accountant,8824,236,9060
28124,Marylin,Larkins,mlarkinsch@feedburner.com,Analog Circuit Design manager,5340,1351,6691
28304,Borg,Belshaw,bbelshawci@china.com.cn,Engineer II,7447,1452,8899
28800,Dov,Bruton,dbrutoncj@posterous.com,Senior Editor,7934,474,8408
28880,Tabor,Sharphouse,tsharphousecl@spiegel.de,Internal Auditor,8581,745,9326
28849,Tiler,Weaben,tweabencm@google.ca,Sales Associate,4867,1477,6344
28103,Freedman,Prestage,fprestagecn@paypal.com,Technical Writer,5397,673,6070
28250,Karie,Basili,kbasilico@hatena.ne.jp,Senior Editor,3792,1915,5707
28343,Svend,Spillett,sspillettcp@mapy.cz,General Manager,1947,491,2438
28660,Andre,O'Looney,aolooneyct@ucla.edu,Analog Circuit Design manager,5405,1559,6964
28713,Kalila,Mallord,kmallordcv@scribd.com,Systems Administrator II,7283,1288,8571
28921,Holden,Swafield,hswafieldcx@paginegialle.it,Structural Analysis Engineer,1691,813,2504
28070,Jamie,Seage,jseagecz@google.co.uk,Senior Cost Accountant,3739,1229,4968
28358,Lesley,Birts,lbirtsd0@meetup.com,Developer II,1613,1784,3397
28498,Noelani,Mollene,nmollened2@shutterfly.com,Software Engineer II,9633,1999,11632
28418,Vinnie,Tydeman,vtydemand3@fotki.com,Senior Financial Analyst,6948,492,7440
28423,Tabor,Overal,toverald4@rambler.ru,Internal Auditor,1702,827,2529
28126,Filide,Shoesmith,fshoesmithd5@tmall.com,Technical Writer,3174,688,3862
28089,Hamel,Marval,hmarvald6@chron.com,Internal Auditor,7099,1051,8150
28559,Katharyn,Kirkbride,kkirkbridedd@hp.com,Account Coordinator,1022,1373,2395
28480,Mariya,Cesaric,mcesaricdg@symantec.com,Administrative Officer,4681,1750,6431
28677,Even,Tease,eteasedh@washington.edu,Data Coordiator,2309,1584,3893
28828,Kassandra,Longo,klongodi@flavors.me,Human Resources Manager,4515,1700,6215
28125,Annamarie,De Stoop,adestoopdj@umn.edu,Senior Cost Accountant,3504,1780,5284
28211,Reinald,Paoletto,rpaolettodk@chron.com,Senior Financial Analyst,1585,1780,3365
28315,Elvyn,Haighton,ehaightondm@mtv.com,Food Chemist,6405,720,7125
28950,Rowney,Febry,rfebrydn@businessinsider.com,Statistician III,7630,1023,8653
28487,Anya,Fifield,afifielddp@telegraph.co.uk,General Manager,2738,1763,4501
28462,Gypsy,Droogan,gdroogandq@opera.com,Research Associate,7245,868,8113
28627,Alic,Yalden,ayaldendt@sbwire.com,Paralegal,7981,1219,9200
28068,Jasen,McAllester,jmcallesterdu@tmall.com,Programmer I,2941,559,3500
28558,Ronda,O'Lunny,rolunnydw@cnbc.com,Senior Cost Accountant,7241,1901,9142
28689,Holden,Franzelini,hfranzelinidx@zimbio.com,Help Desk Technician,5517,1882,7399
28378,Reyna,Bailes,rbailesdy@sciencedirect.com,Account Executive,6544,1599,8143
28905,Kimberlyn,Keavy,kkeavydz@tripadvisor.com,Developer III,1967,1738,3705
28288,Nadean,Dalla,ndallae0@mit.edu,General Manager,8658,458,9116
28489,Helli,Schimann,hschimanne1@google.co.jp,Administrative Officer,9658,796,10454
28578,Essy,Sally,esallye3@house.gov,Media Manager I,3169,918,4087
28979,Winni,Bagley,wbagleye4@lycos.com,Civil Engineer,6842,1894,8736
28543,Orion,Greaves,ogreavese5@rakuten.co.jp,Business Systems Development Analyst,5608,922,6530
28969,Kora,Klaaassen,kklaaassene6@webs.com,Legal Assistant,9829,1529,11358
28547,Farlee,Coulter,fcoultere7@weather.com,Administrative Officer,4606,1218,5824
28222,Lanette,McKinnell,lmckinnelle8@cornell.edu,VP Marketing,6345,1298,7643
28041,Janaye,Bello,jbelloe9@deliciousdays.com,Mechanical Systems Engineer,1001,1568,2569
28727,Wenona,Melly,wmellyea@ucoz.ru,Librarian,6578,391,6969
28042,Mirabella,Oldridge,moldridgeeb@cocolog-nifty.com,Assistant Manager,4495,624,5119
28196,Omero,Dobrovolny,odobrovolnyee@woothemes.com,Structural Engineer,3559,1930,5489
28496,Melisse,Kilbey,mkilbeyef@elegantthemes.com,Assistant Manager,6715,1521,8236
28025,Sheela,Winterson,swintersoneg@arizona.edu,Research Assistant II,8563,1211,9774
28825,Leoline,Olliff,lolliffeh@pen.io,Account Coordinator,8202,1054,9256
28334,Esther,McGreary,emcgrearyei@springer.com,Structural Analysis Engineer,3325,768,4093
28336,Stefania,Raithby,sraithbyej@eventbrite.com,Analyst Programmer,2756,1912,4668
28598,Dinah,Bratch,dbratchek@facebook.com,Administrative Officer,8290,386,8676
28947,Stanleigh,Steptowe,ssteptoweel@eventbrite.com,Chief Design Engineer,1834,1869,3703
28145,Sabra,Bennell,sbennellem@tinyurl.com,Business Systems Development Analyst,1584,633,2217
28266,Aeriell,Roddie,aroddieen@businesswire.com,Associate Professor,6472,1314,7786
28892,Bernardine,Lippiett,blippiettep@scientificamerican.com,Staff Accountant III,5797,807,6604
28587,Gnni,Otterwell,gotterwelleq@geocities.jp,Web Developer I,1308,1915,3223
28657,Nell,Ruprechter,nruprechteres@slideshare.net,Assistant Professor,6445,1995,8440
28829,Liane,Linkin,llinkinew@last.fm,Librarian,6149,1821,7970
28054,Izak,Klimschak,iklimschakex@nydailynews.com,Research Nurse,6277,679,6956
28747,Yvonne,Selliman,ysellimanez@flavors.me,Software Consultant,9973,878,10851
28368,Marijn,Dmiterko,mdmiterkof2@globo.com,Quality Engineer,1888,963,2851
28877,Averell,Southorn,asouthornf3@symantec.com,Clinical Specialist,9953,805,10758
28732,Coleen,Zoane,czoanef4@gizmodo.com,Design Engineer,2725,973,3698
28178,Vincenty,McCafferty,vmccaffertyf5@spotify.com,Systems Administrator I,6490,1672,8162
28001,Mara,Varden,mvardenf7@oaic.gov.au,Nuclear Power Engineer,7395,827,8222
28886,Aindrea,Hensmans,ahensmansf8@opera.com,Information Systems Manager,9846,332,10178
28500,Tadd,McWard,tmcwardfa@disqus.com,Database Administrator II,9617,1464,11081
28403,Tilda,Bolesma,tbolesmafb@wordpress.org,Structural Analysis Engineer,4633,588,5221
28652,Nedda,Jarret,njarretfc@xinhuanet.com,Senior Cost Accountant,1957,1128,3085
28049,Glenn,Louw,glouwfd@devhub.com,Design Engineer,6506,243,6749
28056,Julee,Kobisch,jkobischfe@hexun.com,Human Resources Manager,7897,978,8875
28933,Beniamino,Widdop,bwiddopff@cnet.com,Software Consultant,8149,1821,9970
28150,Rayner,Bloxsom,rbloxsomfg@1und1.de,Sales Associate,2972,687,3659
28614,Rolf,Camous,rcamousfi@google.com,Account Coordinator,4068,1800,5868
28896,Melisandra,Grubb,mgrubbfj@domainmarket.com,Project Manager,6110,974,7084
28537,Schuyler,Winship,swinshipfl@twitter.com,Assistant Media Planner,6093,816,6909
28148,Georgianne,Sutty,gsuttyfm@nba.com,Help Desk Operator,9597,1676,11273
28722,Briney,Scrane,bscranefq@google.com.br,Technical Writer,8259,222,8481
28527,Donella,Blemings,dblemingsfs@chronoengine.com,Assistant Media Planner,7316,375,7691
28854,Paulette,Byllam,pbyllamft@aol.com,Media Manager II,2173,717,2890
28137,Patrick,Buxsy,pbuxsyfv@instagram.com,Accountant I,1782,1731,3513
28716,Flossie,Ganiclef,fganicleffw@pcworld.com,Dental Hygienist,6914,626,7540
28549,Wenda,Wyburn,wwyburnfy@pen.io,Civil Engineer,3967,1442,5409
28006,Marris,Toppin,mtopping0@gmpg.org,Structural Engineer,3627,400,4027
28613,Abbe,Peterffy,apeterffyg2@admin.ch,Nuclear Power Engineer,5578,1144,6722
28308,Rubina,Brassington,rbrassingtong3@sitemeter.com,Internal Auditor,5117,1851,6968
28381,Doralynne,Derks,dderksga@hexun.com,VP Accounting,1189,424,1613
28401,Keefe,Van der Kruys,kvanderkruysgb@unc.edu,Developer I,1045,1892,2937
28375,Archibald,MacCoughan,amaccoughangc@smh.com.au,Administrative Officer,2404,299,2703
28005,Anne,Venable,avenablegd@cbsnews.com,Programmer Analyst IV,6599,405,7004
28426,Row,Palatino,rpalatinogf@netscape.com,Statistician III,7165,1381,8546
28770,Delano,Pollok,dpollokgg@bbc.co.uk,Recruiting Manager,1791,344,2135
28928,Emmy,Kemmey,ekemmeygh@springer.com,Mechanical Systems Engineer,3255,1472,4727
28674,Winni,Denisard,wdenisardgl@geocities.jp,Senior Editor,9559,1763,11322
28709,Padget,Arnhold,parnholdgn@techcrunch.com,Associate Professor,6793,1808,8601
28260,Bobbe,Pays,bpaysgq@reddit.com,Paralegal,2409,304,2713
28347,Aaron,Schofield,aschofieldgr@fda.gov,Physical Therapy Assistant,9669,589,10258
28930,Celinka,Neeves,cneevesgs@amazonaws.com,Geologist IV,7718,400,8118
28397,Jdavie,Wenden,jwendengw@123-reg.co.uk,Accountant II,8689,1112,9801
28422,Celle,Ronchetti,cronchettigx@miitbeian.gov.cn,Health Coach I,1181,1140,2321
28117,Zacherie,Grayland,zgraylandgz@usnews.com,Desktop Support Technician,4242,1383,5625
28945,Barbey,Trassler,btrasslerh2@feedburner.com,Nuclear Power Engineer,4764,867,5631
28524,Elsa,Allnutt,eallnutth4@csmonitor.com,Quality Control Specialist,4945,1190,6135
28530,Binky,Edgell,bedgellh5@reverbnation.com,Professor,3339,808,4147
28030,Milty,Lindman,mlindmanh8@ed.gov,Desktop Support Technician,9437,1037,10474
28430,Poul,Siret,psirethc@people.com.cn,Legal Assistant,5160,1092,6252
28021,Fitzgerald,Lillow,flillowhd@naver.com,Environmental Specialist,3128,770,3898
28680,Giraldo,Walczak,gwalczakhe@netlog.com,Physical Therapy Assistant,3936,1680,5616
28096,Normand,Lerner,nlernerhf@nature.com,Research Assistant IV,5361,1539,6900
28325,Thayne,Brient,tbrienthg@businesswire.com,Executive Secretary,3144,519,3663
28721,Munmro,Stoffersen,mstoffersenhh@ca.gov,Professor,4921,676,5597
28339,Jennica,Pittham,jpitthamhi@princeton.edu,Help Desk Technician,3885,1625,5510
28469,Romona,Kilby,rkilbyhj@webmd.com,GIS Technical Architect,1552,811,2363
28868,Deloris,Blucher,dblucherhm@usa.gov,Geological Engineer,8460,308,8768
28115,Humfrey,Klicher,hklicherho@rambler.ru,Senior Cost Accountant,7605,1222,8827
28848,Vergil,Offill,voffillhp@oracle.com,Media Manager II,4490,1834,6324
28396,Haley,Crighton,hcrightonhr@hao123.com,Pharmacist,5996,950,6946
28406,Catlin,Hadfield,chadfieldhs@economist.com,Help Desk Technician,3376,1800,5176
28111,Hiram,Bladge,hbladgeht@sourceforge.net,Tax Accountant,6602,1676,8278
28407,Kevina,Bussey,kbusseyhu@simplemachines.org,Environmental Specialist,2945,1957,4902
28915,Loreen,Cartmael,lcartmaeli7@mozilla.org,Web Designer III,8970,324,9294
28237,Mavra,Haug,mhaugi8@spotify.com,Marketing Manager,8198,1393,9591
28197,Lenard,Jonas,ljonasid@unblog.fr,Internal Auditor,6422,1086,7508
28097,Rouvin,Henrique,rhenriqueif@utexas.edu,Programmer Analyst IV,1758,399,2157
28223,Henryetta,Loudon,hloudonih@so-net.ne.jp,VP Marketing,6897,480,7377
28483,Rosana,Gulley,rgulleyii@reuters.com,Financial Advisor,3292,215,3507
28270,Roshelle,Antill,rantillik@imageshack.us,Analog Circuit Design manager,5026,798,5824
28016,Kattie,Carlan,kcarlanil@yahoo.com,Senior Editor,8882,1659,10541
28796,Juliann,Cathcart,jcathcartir@friendfeed.com,Graphic Designer,6776,742,7518
28585,Mellie,Mowsdill,mmowsdillit@bigcartel.com,Assistant Professor,1843,1191,3034
28071,Jaclyn,Wayland,jwaylandiv@aol.com,Recruiting Manager,1286,1655,2941
28725,Morse,McConway,mmcconwayix@wired.com,VP Quality Control,1616,1734,3350
28305,Sasha,Nunn,snunnj1@dedecms.com,Web Developer III,1997,297,2294
28875,Mel,McSwan,mmcswanj4@ucoz.com,Graphic Designer,9916,1867,11783
28895,Vic,Woodrup,vwoodrupj8@usda.gov,VP Marketing,7388,857,8245
28569,Jared,Ashforth,jashforthj9@army.mil,Software Test Engineer IV,4824,925,5749
28799,Alexandro,Ould,aouldja@pcworld.com,Compensation Analyst,6775,503,7278
28571,Joanie,Medlicott,jmedlicottjg@ning.com,Environmental Specialist,1811,746,2557
28321,Carolyne,Pickavant,cpickavantjh@wordpress.com,Executive Secretary,1834,1545,3379
28195,Sigismond,Hanwright,shanwrightjj@jigsy.com,Software Consultant,2782,1630,4412
28101,Hugues,Noteyoung,hnoteyoungjl@europa.eu,Payment Adjustment Coordinator,6766,451,7217
28582,Sibbie,Deackes,sdeackesjm@cam.ac.uk,Software Engineer IV,7896,1747,9643
28632,Armstrong,Syder,asyderjn@infoseek.co.jp,Actuary,9524,1450,10974
28298,Archer,Perdue,aperduejp@t.co,Account Representative II,9458,897,10355
28797,Roseanna,Cormode,rcormodejs@wikimedia.org,Assistant Manager,8235,223,8458
28427,Janet,Godilington,jgodilingtonjx@seesaa.net,Programmer Analyst III,3967,1103,5070
28795,Kassia,Olennikov,kolennikovjz@sun.com,Food Chemist,3201,997,4198
28116,Melonie,Silverstone,msilverstonek0@newsvine.com,Senior Quality Engineer,1829,639,2468
28437,Arel,Donett,adonettk4@whitehouse.gov,VP Accounting,8617,329,8946
28914,Page,Shew,pshewk5@shutterfly.com,Programmer Analyst II,9789,547,10336
28560,Anneliese,Luquet,aluquetk7@example.com,Account Coordinator,7557,1189,8746
28105,Frederick,Farre,ffarrek8@wisc.edu,Associate Professor,9837,1078,10915
28509,Sky,Pasterfield,spasterfieldka@themeforest.net,Assistant Professor,4975,1873,6848
28029,Sander,Crowcroft,scrowcroftkb@wisc.edu,Teacher,1040,1205,2245
28201,Gweneth,Urien,gurienkc@walmart.com,Technical Writer,2134,1385,3519
28958,Arel,Trammel,atrammelkg@example.com,Engineer II,5613,1461,7074
28062,Hale,Dibling,hdiblingkh@businessweek.com,Food Chemist,3740,1853,5593
28503,Katrina,Burbidge,kburbidgekk@fema.gov,Paralegal,1426,610,2036
28695,Sibel,Welbourn,swelbournkm@mapy.cz,Operator,2840,589,3429
28929,Franciskus,Lamberts,flambertskp@marketwatch.com,Account Representative III,7130,1137,8267
28501,Natalie,Sopp,nsoppks@geocities.jp,Mechanical Systems Engineer,5734,775,6509
28176,Artie,McGarry,amcgarrykx@webeden.co.uk,Environmental Tech,9350,387,9737
28596,Deb,Marron,dmarronl3@tamu.edu,Business Systems Development Analyst,4986,1388,6374
28160,Laney,McFaul,lmcfaull6@dailymail.co.uk,Payment Adjustment Coordinator,2968,791,3759
28539,Archibold,Duggon,aduggonl8@webmd.com,Product Engineer,8007,582,8589
28035,Junina,Melland,jmellandl9@privacy.gov.au,General Manager,8449,1649,10098
28048,Wayne,Tack,wtacklb@sitemeter.com,Web Developer I,7984,1845,9829
28650,Tris,Albro,talbrole@woothemes.com,Quality Control Specialist,9054,691,9745
28993,Phaedra,Ramas,pramaslf@opensource.org,Nurse,8890,1961,10851
28697,Jdavie,Shord,jshordlh@shutterfly.com,Junior Executive,7249,1141,8390
28075,Arney,Wentworth,awentworthlj@blogger.com,Help Desk Technician,8226,1690,9916
28557,Rowland,Ducarne,rducarnelk@cdc.gov,Media Manager IV,1584,1792,3376
28372,Terrye,Rabb,trabbll@time.com,Clinical Specialist,9583,1222,10805
28409,Lauren,Bessom,lbessomlm@ox.ac.uk,Chief Design Engineer,2292,1274,3566
28482,Wat,Cranshaw,wcranshawlp@hatena.ne.jp,Executive Secretary,2847,1527,4374
28353,Kitty,Ortmann,kortmannlq@earthlink.net,Cost Accountant,3271,1359,4630
28576,Bobette,Ducarne,bducarnels@mlb.com,Software Test Engineer III,7792,1791,9583
28177,Cortie,Broster,cbrosterlu@123-reg.co.uk,Product Engineer,2975,1857,4832
28671,Wittie,Tunney,wtunneylw@google.com,Speech Pathologist,5034,267,5301
28379,Mureil,Custance,mcustancelz@goodreads.com,Electrical Engineer,1043,1317,2360
28249,Desmund,Aberhart,daberhartm0@purevolume.com,Nuclear Power Engineer,8941,278,9219
28046,Gunar,Brydson,gbrydsonm3@guardian.co.uk,Electrical Engineer,3839,473,4312
28607,Sunny,Barstock,sbarstockm4@princeton.edu,Senior Sales Associate,4181,1155,5336
28338,Madelyn,Balsellie,mbalselliem5@comsenz.com,Speech Pathologist,8376,1515,9891
28135,Pooh,Clooney,pclooneym6@bravesites.com,Safety Technician II,4200,1392,5592
28942,Mariele,Ousley,mousleym7@1688.com,Statistician III,7524,339,7863
28994,Erastus,McFater,emcfaterm9@newsvine.com,Account Coordinator,6826,1713,8539
28654,Lurline,Sargint,lsargintmb@nymag.com,Editor,6661,223,6884
28735,Orelie,Hallibone,ohallibonemd@typepad.com,Database Administrator II,6112,1438,7550
28184,Cort,Lindenfeld,clindenfeldmf@1und1.de,Dental Hygienist,2188,616,2804
28805,Corella,Sherrington,csherringtonmi@umich.edu,Accountant III,1719,556,2275
28911,Bianka,Beaver,bbeavermk@webnode.com,Actuary,6724,1743,8467
28168,Roxi,Wattingham,rwattinghammm@dailymail.co.uk,Engineer IV,6388,739,7127
28959,Veradis,Larcier,vlarciermw@163.com,Community Outreach Specialist,3289,229,3518
28302,Corena,Rees,creesmx@123-reg.co.uk,Engineer IV,7049,653,7702
28232,Brockie,Ilyinykh,bilyinykhmy@patch.com,Nurse Practicioner,3623,1333,4956
28287,Alidia,Louedey,alouedeyn0@furl.net,Quality Control Specialist,6137,286,6423
28960,Corina,Goley,cgoleyn1@oakley.com,Geologist III,2443,1193,3636
28883,Mathe,Hawkin,mhawkinn3@friendfeed.com,Desktop Support Technician,8301,1714,10015
28346,Nico,Breit,nbreitn9@pinterest.com,Sales Associate,8191,1753,9944
28327,Noble,Curnucke,ncurnuckenb@indiatimes.com,Civil Engineer,7423,1652,9075
28484,Costanza,Qualtro,cqualtrond@japanpost.jp,Programmer II,8930,516,9446
28451,Katrinka,Peaden,kpeadenne@princeton.edu,Desktop Support Technician,3629,1361,4990
28465,Aymer,Dochon,adochonnm@google.com.au,Assistant Media Planner,8922,1419,10341
28577,Opalina,Goldsmith,ogoldsmithnn@google.co.uk,Human Resources Assistant IV,2842,802,3644
28415,Ezekiel,Dallow,edallownq@github.io,Electrical Engineer,9941,1738,11679
28545,Rosalia,Simla,rsimlans@blogtalkradio.com,Editor,4793,1848,6641
28141,Brandy,Callander,bcallandernu@berkeley.edu,Civil Engineer,6633,417,7050
28037,Susan,Bradnock,sbradnocko0@slashdot.org,Operator,5903,363,6266
28856,Ginger,Southon,gsouthono2@xinhuanet.com,Product Engineer,1918,895,2813
28172,Sancho,Volett,svoletto3@tuttocitta.it,Social Worker,8145,1284,9429
28253,Jared,Derrington,jderringtono6@usgs.gov,Information Systems Manager,6783,1143,7926
28420,Kippy,Ghiotto,kghiottoo8@oakley.com,Developer III,7459,400,7859
28491,Honey,Chapellow,hchapellowod@thetimes.co.uk,Geological Engineer,9362,1998,11360
28891,Waiter,Oakden,woakdenoe@dot.gov,Web Developer I,4053,439,4492
28152,Pia,Lorrimer,plorrimerof@cocolog-nifty.com,Systems Administrator I,1088,1498,2586
28791,Dorian,Cliff,dcliffoj@usa.gov,Librarian,8890,1302,10192
28759,Faunie,MacDowall,fmacdowallol@booking.com,Environmental Tech,3603,1931,5534
28136,Ragnar,MacRinn,rmacrinnor@gov.uk,Safety Technician II,5783,1342,7125
28158,Wain,Halt,whaltow@mediafire.com,Programmer IV,9947,402,10349
28349,Bryna,Marcinkus,bmarcinkusox@eventbrite.com,Senior Financial Analyst,8469,251,8720
28354,Bank,MacTrustram,bmactrustramp1@bigcartel.com,Assistant Manager,1516,1828,3344
28231,Felita,Statefield,fstatefieldp2@google.ca,Chief Design Engineer,3533,1610,5143
28579,Fleur,Sothern,fsothernp3@devhub.com,Occupational Therapist,4739,667,5406
28235,Melina,Plumbe,mplumbep7@arstechnica.com,Systems Administrator II,6145,750,6895
28485,Tildie,Guiducci,tguiduccip8@bing.com,Staff Accountant IV,7465,1061,8526
28566,Karissa,Daughton,kdaughtonpa@rakuten.co.jp,Cost Accountant,4269,1032,5301
28889,Wilbert,Wyer,wwyerpb@blogspot.com,Chief Design Engineer,2584,312,2896
28567,Graig,Olver,golverpf@home.pl,Paralegal,9400,366,9766
28630,Lucretia,Bladesmith,lbladesmithpg@bluehost.com,Registered Nurse,1026,1434,2460
28775,Padriac,Rizzello,prizzellopi@google.com.br,Senior Editor,7339,1323,8662
28604,Felipa,Dibble,fdibblepk@usa.gov,Accounting Assistant IV,2297,718,3015
28682,Kahlil,Meriott,kmeriottpm@icio.us,Analog Circuit Design manager,8957,671,9628
28686,Noe,McKevitt,nmckevittpo@indiegogo.com,Operator,6307,1765,8072
28015,Leese,Morrison,lmorrisonpu@goodreads.com,Database Administrator II,7413,237,7650
28984,Isidoro,Avis,iavispw@homestead.com,Software Test Engineer III,3030,1675,4705
28278,Chester,Dundin,cdundinpy@blog.com,Analyst Programmer,9214,1983,11197
28077,Sybilla,Reynold,sreynoldpz@kickstarter.com,Web Developer III,2653,942,3595
28533,Thorndike,Comberbeach,tcomberbeachq0@wikimedia.org,Programmer IV,7456,1111,8567
28166,Giordano,Wylam,gwylamq5@oaic.gov.au,Director of Sales,5184,802,5986
28108,Karla,Stillmann,kstillmannq6@earthlink.net,Graphic Designer,5103,1597,6700
28742,Mel,Duke,mdukeq7@people.com.cn,Geologist IV,3171,1764,4935
28380,Candice,MacCarrick,cmaccarrickq8@wordpress.org,Marketing Assistant,2811,1193,4004
28572,Binny,Grelka,bgrelkaq9@w3.org,Senior Editor,3344,1262,4606
28227,Bertram,Biset,bbisetqa@is.gd,Actuary,2624,1805,4429
28204,Idette,Bugden,ibugdenqc@webeden.co.uk,Senior Quality Engineer,4986,947,5933
28550,Gwenore,MacGeffen,gmacgeffenqf@hatena.ne.jp,VP Accounting,5194,617,5811
28296,Dov,Honack,dhonackqh@unc.edu,Web Developer II,4339,774,5113
28731,Gene,Poad,gpoadqk@hp.com,Legal Assistant,5184,1018,6202
28729,Clotilda,Vasyunin,cvasyuninqm@prweb.com,Social Worker,2301,995,3296
28324,Bev,Bortoli,bbortoliqo@histats.com,Pharmacist,1027,1924,2951
28428,Engracia,Tilly,etillyqp@altervista.org,Food Chemist,9787,272,10059
28985,Perice,Ruperto,prupertoqw@unicef.org,VP Marketing,5124,1912,7036
28838,Elmore,Paniman,epanimanr1@over-blog.com,Recruiting Manager,6806,674,7480
28562,Goldia,Sercombe,gsercomber4@bandcamp.com,Account Representative IV,6935,1232,8167
28581,Moritz,Enders,mendersr5@aboutads.info,Graphic Designer,7304,1530,8834
28074,Yorker,McElrath,ymcelrathrh@fda.gov,Clinical Specialist,2388,1283,3671
28676,Valera,Amiable,vamiablern@marriott.com,Environmental Specialist,2706,666,3372
29650,Krystyna,Huthart,khuthart0@google.com.br,Web Developer III,3365,1439,4804
29930,Jerri,Beddo,jbeddo1@csmonitor.com,Staff Accountant I,1935,1643,3578
29438,Coraline,Feehery,cfeehery2@telegraph.co.uk,Business Systems Development Analyst,2354,1171,3525
29109,Konstantin,Greensall,kgreensall3@wordpress.com,Occupational Therapist,9731,1445,11176
29931,Moyna,Decourcy,mdecourcy4@zimbio.com,Automation Specialist II,2818,1768,4586
29851,Judas,Ventris,jventris5@networksolutions.com,Nurse,8582,1170,9752
29526,Loleta,Jakoviljevic,ljakoviljevic6@dropbox.com,Assistant Media Planner,9468,646,10114
29621,Elinor,Lacer,elacer7@rediff.com,Payment Adjustment Coordinator,2646,1890,4536
29642,Tobey,Lorentzen,tlorentzen8@google.cn,Engineer IV,9563,399,9962
29924,Giacomo,Wrighton,gwrighton9@joomla.org,Operator,8789,553,9342
29543,Lorant,Yukhtin,lyukhtina@washingtonpost.com,Clinical Specialist,7458,1750,9208
29251,Editha,Perrat,eperratb@cbslocal.com,Structural Engineer,9928,1737,11665
29722,Benito,Lembrick,blembrickd@mail.ru,VP Accounting,7360,1595,8955
29678,Judy,Stirley,jstirleye@about.com,Civil Engineer,9726,1893,11619
29996,Quinn,Dran,qdranf@kickstarter.com,Sales Representative,6543,360,6903
29478,Gilda,Bravery,gbraveryg@macromedia.com,Account Representative I,5502,989,6491
29950,Starla,Hackleton,shackletonh@wp.com,Design Engineer,4638,1594,6232
29259,Wye,Tallent,wtallenti@europa.eu,Environmental Specialist,3833,543,4376
29200,Bryon,Hicks,bhicksj@alexa.com,Graphic Designer,9701,1943,11644
29078,Nydia,Carwithen,ncarwithenk@yolasite.com,Sales Associate,1631,325,1956
29445,Milo,Copnall,mcopnalll@artisteer.com,Staff Scientist,1027,1415,2442
29897,Joanna,Orht,jorhtm@nba.com,Data Coordiator,2192,411,2603
29595,Kania,Huglin,khuglinn@amazon.co.jp,Director of Sales,2655,1522,4177
29588,Aura,Kroon,akroono@addtoany.com,Speech Pathologist,6308,1331,7639
29854,Fin,Magrannell,fmagrannellp@free.fr,Marketing Manager,3825,1981,5806
29517,Berta,Karlmann,bkarlmannq@about.me,Assistant Professor,2193,418,2611
29128,Othilie,Axel,oaxelr@posterous.com,Quality Engineer,5109,328,5437
29992,Vail,Peers,vpeerss@facebook.com,Biostatistician III,8191,1491,9682
29546,Gabe,Witherby,gwitherbyu@unblog.fr,Help Desk Technician,9113,1394,10507
29518,Maddy,Greetland,mgreetlandv@scientificamerican.com,Senior Cost Accountant,5952,877,6829
29529,Sula,Anslow,sansloww@issuu.com,Human Resources Assistant II,1419,683,2102
29921,Timothy,Verey,tvereyx@indiatimes.com,Software Consultant,3459,1474,4933
29505,Margot,Furzey,mfurzeyy@ted.com,Safety Technician III,7446,499,7945
29402,Tabbie,Cluatt,tcluattz@myspace.com,Account Representative III,4577,1749,6326
29690,Torre,Lindsay,tlindsay10@creativecommons.org,Associate Professor,9231,224,9455
29473,Geraldine,Hackelton,ghackelton11@bloglines.com,Financial Advisor,2039,700,2739
29625,Walliw,Dabbes,wdabbes12@cyberchimps.com,Human Resources Assistant II,7524,1394,8918
29847,Jessica,Maasze,jmaasze13@webmd.com,Compensation Analyst,1525,1680,3205
29508,Bobbette,Harcus,bharcus14@hc360.com,Compensation Analyst,9965,506,10471
29446,Adriaens,Stove,astove15@bizjournals.com,Senior Quality Engineer,4507,1045,5552
29391,Lorrie,Stocky,lstocky16@java.com,Office Assistant II,5826,1881,7707
29082,Maggi,Kilfeather,mkilfeather17@wix.com,Tax Accountant,4944,486,5430
29596,Olympie,O'Canavan,oocanavan18@house.gov,Dental Hygienist,7422,572,7994
29766,Rand,Stradling,rstradling19@is.gd,Associate Professor,5138,1602,6740
29798,Milli,Last,mlast1a@deliciousdays.com,Administrative Assistant II,6869,1425,8294
29901,Madelina,Woollaston,mwoollaston1c@census.gov,Structural Analysis Engineer,1207,1734,2941
29312,Jone,Mouth,jmouth1d@prlog.org,Mechanical Systems Engineer,5559,1071,6630
29100,Cliff,Whitton,cwhitton1e@drupal.org,Sales Representative,2318,992,3310
29739,Demeter,Anand,danand1f@ezinearticles.com,Occupational Therapist,2543,1153,3696
29981,Bennett,Rohfsen,brohfsen1g@oakley.com,Financial Analyst,8765,1671,10436
29805,Gabi,Stallibrass,gstallibrass1h@bluehost.com,Marketing Manager,9109,1619,10728
29877,Philippa,Charrier,pcharrier1i@usda.gov,Web Developer III,2234,492,2726
29099,Ardene,Carmo,acarmo1j@mac.com,Marketing Assistant,2640,315,2955
29068,Hortense,Sissons,hsissons1k@weibo.com,Geological Engineer,8275,1055,9330
29622,Mirabel,Wilmore,mwilmore1l@xrea.com,Programmer III,8619,1958,10577
29908,Rog,Skelhorne,rskelhorne1m@bizjournals.com,Senior Sales Associate,6689,1278,7967
29846,Urbanus,Biesinger,ubiesinger1n@ed.gov,Geological Engineer,1902,1436,3338
29945,Adela,Villa,avilla1o@msn.com,Help Desk Technician,8853,987,9840
29935,Rosetta,McPhater,rmcphater1p@taobao.com,Media Manager III,6287,732,7019
29094,Nomi,Coatman,ncoatman1q@ezinearticles.com,Design Engineer,4832,1284,6116
29290,Minda,Clarkson,mclarkson1r@php.net,Tax Accountant,7494,867,8361
29203,Teddy,Mackett,tmackett1t@washington.edu,Developer IV,9446,1173,10619
29581,Laural,Tookill,ltookill1u@fema.gov,Software Engineer III,5185,1935,7120
29183,Chad,Shegog,cshegog1v@apache.org,Marketing Manager,4659,589,5248
29340,Eolande,Hayman,ehayman1w@smugmug.com,Senior Editor,7528,241,7769
29842,Golda,Klimmek,gklimmek1x@purevolume.com,Marketing Manager,4022,1476,5498
29116,Benjie,Felstead,bfelstead1y@census.gov,Biostatistician I,7938,1741,9679
29221,Hyacinthia,Staynes,hstaynes1z@feedburner.com,Accounting Assistant I,7493,495,7988
29080,Gwen,Halewood,ghalewood21@sun.com,Business Systems Development Analyst,7743,792,8535
29460,Druci,Turn,dturn22@ucsd.edu,Nurse,6515,1860,8375
29309,Beatrisa,Castanie,bcastanie23@t-online.de,Director of Sales,3851,1591,5442
29077,Lance,Gyorgy,lgyorgy25@cnn.com,Associate Professor,5269,740,6009
29184,La verne,Midlane,lmidlane26@cnbc.com,Research Associate,3250,1515,4765
29774,Rosalinde,Samwell,rsamwell28@bizjournals.com,Electrical Engineer,7201,1834,9035
29608,Matthus,Leynagh,mleynagh29@naver.com,Tax Accountant,1572,1651,3223
29726,Phil,Syphas,psyphas2a@newyorker.com,Geological Engineer,4330,833,5163
29929,Craggy,Garthside,cgarthside2b@va.gov,Quality Engineer,7155,1435,8590
29790,Alverta,Coole,acoole2c@timesonline.co.uk,Senior Sales Associate,6658,246,6904
29097,Uriel,Kitchingman,ukitchingman2d@yolasite.com,VP Quality Control,9361,1719,11080
29018,Thayne,Romushkin,tromushkin2e@acquirethisname.com,Administrative Assistant II,4766,271,5037
29844,Duffy,Curdell,dcurdell2f@odnoklassniki.ru,Engineer I,6572,1863,8435
29190,Blaine,Pomroy,bpomroy2g@privacy.gov.au,Technical Writer,2041,1111,3152
29469,Normand,Heineking,nheineking2h@tinyurl.com,Software Consultant,1176,1695,2871
29982,Ann,Roxbee,aroxbee2j@360.cn,Help Desk Operator,1505,384,1889
29331,Jorgan,Brimilcombe,jbrimilcombe2k@netvibes.com,Product Engineer,3272,1813,5085
29323,Natalee,Martugin,nmartugin2l@omniture.com,Executive Secretary,7012,1057,8069
29471,Storm,Burkill,sburkill2m@howstuffworks.com,Research Assistant IV,4070,897,4967
29338,Sophia,Titterton,stitterton2n@twitpic.com,Project Manager,5277,1185,6462
29361,Marcia,Adnam,madnam2o@mit.edu,Automation Specialist III,4777,996,5773
29534,Dyane,MacCarlich,dmaccarlich2p@scientificamerican.com,Sales Representative,2617,746,3363
29689,Fergus,Biever,fbiever2q@usda.gov,Clinical Specialist,4998,252,5250
29482,Jesse,Schustl,jschustl2r@sphinn.com,Marketing Manager,2162,1833,3995
29076,Veronique,Hurtic,vhurtic2s@auda.org.au,Help Desk Technician,4197,1766,5963
29474,Jillie,Muffitt,jmuffitt2t@wikispaces.com,VP Accounting,8650,1778,10428
29146,Seana,Topling,stopling2u@stumbleupon.com,Financial Advisor,7251,1781,9032
29586,Benedicta,Hairs,bhairs2v@gmpg.org,Librarian,9615,1588,11203
29165,Grange,Holston,gholston2w@state.gov,Developer II,8478,517,8995
29793,Westbrook,Gaishson,wgaishson2x@reuters.com,Senior Developer,7145,805,7950
29636,Cloe,Yorath,cyorath2y@diigo.com,Paralegal,8874,548,9422
29459,Carlin,Penton,cpenton2z@51.la,Developer III,6117,379,6496
29101,Mikel,Cookes,mcookes30@biblegateway.com,Administrative Assistant II,1640,1186,2826
29573,Hanny,Feldmesser,hfeldmesser31@lulu.com,Structural Engineer,3225,1436,4661
29154,Genni,Shenfish,gshenfish32@t-online.de,Information Systems Manager,5471,1165,6636
29587,Cathrin,Harbach,charbach33@devhub.com,Marketing Assistant,8044,1802,9846
29962,Walton,Sephton,wsephton34@hostgator.com,Developer II,7804,1356,9160
29326,Mano,Hallin,mhallin36@xrea.com,Media Manager II,4260,1516,5776
29614,Alejandro,Gover,agover37@dmoz.org,VP Product Management,6365,561,6926
29855,Alida,Hacksby,ahacksby39@boston.com,Civil Engineer,4684,395,5079
29411,Glendon,Grishankov,ggrishankov3a@washington.edu,Account Coordinator,4116,1893,6009
29179,Cale,Rivard,crivard3b@spotify.com,Graphic Designer,2177,1303,3480
29028,Rachael,McGeachey,rmcgeachey3c@vkontakte.ru,Account Representative III,4022,1405,5427
29729,Malena,Huntingford,mhuntingford3d@hibu.com,Director of Sales,5734,1485,7219
29135,Sansone,Ciccetti,sciccetti3e@miibeian.gov.cn,Dental Hygienist,7288,1234,8522
29714,Sloane,Lanfranchi,slanfranchi3f@gov.uk,Quality Control Specialist,1182,1786,2968
29912,Belinda,Pien,bpien3g@sohu.com,Environmental Specialist,4060,1767,5827
29752,Gerry,Huge,ghuge3i@quantcast.com,Statistician III,6942,239,7181
29507,Cherida,MacKaig,cmackaig3k@wp.com,Administrative Assistant I,1556,673,2229
29791,Shadow,Kuhnt,skuhnt3m@skyrock.com,Actuary,7710,1517,9227
29568,Way,Horsted,whorsted3n@irs.gov,Systems Administrator II,2958,567,3525
29870,Marrissa,Santry,msantry3o@fda.gov,Chemical Engineer,2433,1960,4393
29025,Elyn,Kitt,ekitt3p@whitehouse.gov,Senior Financial Analyst,4573,921,5494
29357,Bride,Voase,bvoase3q@japanpost.jp,Senior Developer,7493,1522,9015
29006,Buddie,Durtnal,bdurtnal3r@sciencedaily.com,Physical Therapy Assistant,5824,424,6248
29837,Dore,Cartmale,dcartmale3s@google.fr,Clinical Specialist,9911,1554,11465
29274,Sharl,Reaper,sreaper3t@yale.edu,Executive Secretary,6537,802,7339
29716,Madlin,Bartels,mbartels3u@e-recht24.de,Analyst Programmer,6659,1423,8082
29755,Friedrich,Ruberry,fruberry3v@desdev.cn,Media Manager III,9434,837,10271
29254,Den,Heninghem,dheninghem3w@china.com.cn,VP Quality Control,8497,899,9396
29108,Lexie,Wonfor,lwonfor3x@bing.com,Research Associate,6731,1134,7865
29663,Felicdad,Phoenix,fphoenix3y@rambler.ru,Registered Nurse,4564,1645,6209
29669,Tomlin,Bamsey,tbamsey3z@nih.gov,Research Nurse,6218,409,6627
29884,Huberto,Week,hweek40@geocities.com,Software Consultant,3232,1354,4586
29480,Abbey,Surgood,asurgood41@dion.ne.jp,Tax Accountant,9239,1384,10623
29915,Rina,Scud,rscud42@dailymail.co.uk,Structural Engineer,3871,1343,5214
29623,Wendell,Rubenovic,wrubenovic43@howstuffworks.com,Developer I,7797,446,8243
29033,Humfried,MacMenemy,hmacmenemy44@fc2.com,Assistant Professor,5479,510,5989
29045,Mignonne,Thurman,mthurman45@state.gov,Analyst Programmer,4735,1635,6370
29941,Corine,Stuckford,cstuckford46@independent.co.uk,Assistant Manager,4292,1249,5541
29308,Lizbeth,Bahike,lbahike47@t.co,Food Chemist,9774,372,10146
29763,Theressa,Llewelyn,tllewelyn48@hhs.gov,Biostatistician IV,9847,971,10818
29990,Joyan,Doggett,jdoggett4a@ocn.ne.jp,Software Consultant,8372,1524,9896
29377,Devlin,Randle,drandle4b@apache.org,Electrical Engineer,6671,1131,7802
29584,Forester,Longson,flongson4c@cnbc.com,Software Engineer IV,4814,1874,6688
29896,Etty,Gopsill,egopsill4d@hatena.ne.jp,Structural Engineer,2946,256,3202
29612,Angy,Broad,abroad4e@dropbox.com,Marketing Assistant,1451,1708,3159
29651,Isidro,Zimmermanns,izimmermanns4f@cdc.gov,Quality Control Specialist,7077,498,7575
29316,Vlad,Litton,vlitton4g@mlb.com,Account Representative IV,4985,446,5431
29724,Kynthia,Sunock,ksunock4h@scientificamerican.com,Chief Design Engineer,8034,623,8657
29345,Olive,Bickerdike,obickerdike4i@hao123.com,Mechanical Systems Engineer,1067,1907,2974
29376,Courtnay,Ferencowicz,cferencowicz4j@google.fr,Professor,1351,896,2247
29098,Jordana,Wortley,jwortley4k@washington.edu,Tax Accountant,3756,1647,5403
29036,Shelba,Latek,slatek4l@forbes.com,Programmer Analyst III,1273,1480,2753
29750,Thedrick,Combes,tcombes4m@addthis.com,Technical Writer,7754,754,8508
29283,Toby,Leonida,tleonida4n@sogou.com,Human Resources Manager,8259,905,9164
29768,Geordie,Dalbey,gdalbey4o@cargocollective.com,GIS Technical Architect,2474,1136,3610
29823,Saxe,Cleaves,scleaves4q@prnewswire.com,Environmental Tech,9678,1412,11090
29496,Lyn,Fitton,lfitton4r@wp.com,Operator,4752,1191,5943
29393,Marj,Chastel,mchastel4s@china.com.cn,Senior Editor,3540,1476,5016
29191,Kipper,Badger,kbadger4t@sakura.ne.jp,Director of Sales,5333,1193,6526
29381,Grier,Drillingcourt,gdrillingcourt4v@cam.ac.uk,Community Outreach Specialist,9411,1821,11232
29883,Hi,Kneath,hkneath4w@yahoo.co.jp,Sales Representative,1825,387,2212
29420,Terrye,Dunston,tdunston4x@angelfire.com,Nurse,7543,1014,8557
29769,Daron,Washington,dwashington4y@google.co.uk,Database Administrator II,2285,340,2625
29898,Isadora,Doale,idoale4z@yahoo.com,General Manager,6213,290,6503
29703,Clevie,Cornels,ccornels50@umich.edu,VP Accounting,9971,1405,11376
29510,Tessi,Gore,tgore51@utexas.edu,Civil Engineer,1281,1815,3096
29885,Halley,Cherry Holme,hcherryholme52@ucoz.ru,Sales Representative,8286,909,9195
29123,Tory,Clapston,tclapston54@fc2.com,Safety Technician III,7645,1147,8792
29618,Jarid,Chapelhow,jchapelhow55@1und1.de,Legal Assistant,6415,1532,7947
29228,Kaitlynn,Happel,khappel56@odnoklassniki.ru,Chief Design Engineer,4185,1007,5192
29465,Carlyle,Preist,cpreist57@51.la,Internal Auditor,3957,1519,5476
29701,Calida,Suddock,csuddock58@weather.com,Budget/Accounting Analyst I,9920,726,10646
29759,Nell,Boyle,nboyle59@jalbum.net,Food Chemist,5906,1878,7784
29208,Andrei,Folkes,afolkes5a@mediafire.com,Health Coach I,8076,686,8762
29095,Marianna,Faircliffe,mfaircliffe5c@mapquest.com,Geological Engineer,6863,1111,7974
29576,Nilson,Ledur,nledur5d@angelfire.com,Web Developer II,1049,402,1451
29672,Jacky,Petruska,jpetruska5e@prweb.com,Internal Auditor,9162,991,10153
29495,Benjy,Simonard,bsimonard5g@constantcontact.com,Recruiting Manager,7541,1340,8881
29845,Vito,Mathy,vmathy5h@prnewswire.com,Staff Accountant III,2188,431,2619
29727,Maureene,Grabb,mgrabb5i@reverbnation.com,VP Accounting,2250,776,3026
29271,Eustace,Karpenko,ekarpenko5j@dropbox.com,Accounting Assistant II,7824,220,8044
29114,Lynea,Gower,lgower5k@fastcompany.com,Financial Advisor,2203,668,2871
29300,Ruthe,Buckam,rbuckam5l@slashdot.org,Senior Editor,2933,891,3824
29160,Cecilius,Heball,cheball5m@google.com.au,Account Coordinator,3462,1257,4719
29952,Abie,Kliemke,akliemke5n@desdev.cn,Dental Hygienist,7821,1559,9380
29985,Avrom,Hylden,ahylden5p@umn.edu,VP Quality Control,3561,666,4227
29466,Ibrahim,McGiff,imcgiff5q@webnode.com,Associate Professor,1066,910,1976
29046,Denys,Constanza,dconstanza5r@jugem.jp,Marketing Manager,4870,1712,6582
29983,Alida,Boteman,aboteman5s@ocn.ne.jp,Editor,7755,456,8211
29705,Consuelo,Clancey,cclancey5u@wiley.com,Sales Representative,5721,1419,7140
29542,Jocelin,Farre,jfarre5v@unicef.org,Geologist IV,7549,1138,8687
29958,Rozanne,Sher,rsher5y@buzzfeed.com,Recruiter,9615,1082,10697
29133,Sonnie,Warde,swarde5z@dailymail.co.uk,VP Sales,6098,351,6449
29649,Dorie,Dorton,ddorton60@addtoany.com,Dental Hygienist,1556,1093,2649
29072,Nicol,Bindley,nbindley61@t.co,Research Assistant II,8972,1598,10570
29590,Ilise,Slemmonds,islemmonds62@globo.com,Analog Circuit Design manager,6104,513,6617
29351,Violante,Bertenshaw,vbertenshaw64@ustream.tv,Web Developer II,7072,1886,8958
29712,Margaux,Binnie,mbinnie65@bloglines.com,Structural Analysis Engineer,2738,828,3566
29819,Mollie,Hitzmann,mhitzmann66@rediff.com,Research Assistant IV,8972,1385,10357
29019,Melba,Destouche,mdestouche67@psu.edu,Safety Technician I,3094,1567,4661
29491,Wilton,Skillings,wskillings68@goo.ne.jp,Nurse Practicioner,5773,979,6752
29255,Gradeigh,Lockett,glockett69@reference.com,Graphic Designer,3687,1705,5392
29061,Lib,Troucher,ltroucher6d@delicious.com,Graphic Designer,3698,1888,5586
29547,Viole,Bliven,vbliven6e@utexas.edu,Health Coach I,8621,293,8914
29039,Georgi,Griffith,ggriffith6f@hc360.com,Business Systems Development Analyst,2866,214,3080
29409,Pip,McLarens,pmclarens6g@stanford.edu,Speech Pathologist,6274,1681,7955
29626,Eartha,Maypole,emaypole6i@slate.com,Software Test Engineer I,9980,752,10732
29970,Vyky,Greenhill,vgreenhill6j@tiny.cc,Clinical Specialist,4494,1439,5933
29476,Cinnamon,Robillard,crobillard6k@artisteer.com,Environmental Tech,4465,1976,6441
29979,Viviene,Keen,vkeen6l@liveinternet.ru,Software Consultant,2063,1318,3381
29502,Hinda,Cassely,hcassely6m@google.ru,Engineer I,7573,1942,9515
29780,Paulette,Shord,pshord6n@imgur.com,Technical Writer,8670,1272,9942
29840,Bonni,Devericks,bdevericks6o@cnet.com,VP Sales,9877,1830,11707
29085,Paddie,Pavia,ppavia6p@yolasite.com,Accountant IV,1198,1966,3164
29631,Chrotoem,Borkin,cborkin6q@flavors.me,Mechanical Systems Engineer,3346,1754,5100
29292,Florry,Smout,fsmout6s@slashdot.org,Senior Developer,9105,1855,10960
29434,Randie,Brotherwood,rbrotherwood6t@discovery.com,Marketing Assistant,9936,717,10653
29038,Darda,Panons,dpanons6u@tinyurl.com,Technical Writer,7963,1425,9388
29947,Goddart,Yukhnini,gyukhnini6x@usda.gov,Analog Circuit Design manager,1512,845,2357
29809,Nickolai,Bunhill,nbunhill6y@reverbnation.com,Occupational Therapist,2260,1116,3376
29665,Meghan,Sibbs,msibbs6z@reddit.com,Nurse Practicioner,4461,713,5174
29740,Jerri,MacEnelly,jmacenelly70@addthis.com,General Manager,3842,1047,4889
29643,Tod,Gregoriou,tgregoriou71@indiegogo.com,Senior Cost Accountant,8675,803,9478
29081,Gerda,Richardes,grichardes72@liveinternet.ru,Statistician IV,6375,1805,8180
29433,Athena,Grimwad,agrimwad74@guardian.co.uk,Dental Hygienist,5825,500,6325
29629,Arly,Tosdevin,atosdevin76@tuttocitta.it,Environmental Specialist,5042,220,5262
29063,Whittaker,Dimock,wdimock77@globo.com,Software Test Engineer I,8675,1449,10124
29656,Dody,Maskell,dmaskell78@bbb.org,Design Engineer,5143,1513,6656
29942,Liliane,Stebbing,lstebbing7b@furl.net,Desktop Support Technician,3254,932,4186
29806,Kenton,Bulcock,kbulcock7d@admin.ch,Chemical Engineer,3513,423,3936
29535,Sharline,Husbands,shusbands7e@china.com.cn,Pharmacist,4852,1416,6268
29130,Augustus,Dalliston,adalliston7i@t-online.de,Librarian,7227,411,7638
29069,Bradly,Galbraeth,bgalbraeth7k@ning.com,Data Coordiator,9630,1944,11574
29589,Carolina,Raffeorty,craffeorty7l@example.com,Sales Associate,8177,1357,9534
29524,Archibold,Heskin,aheskin7m@vkontakte.ru,Analog Circuit Design manager,3374,701,4075
29666,Ragnar,Sands,rsands7n@blogspot.com,Social Worker,3286,1534,4820
29198,Steffen,Loveguard,sloveguard7q@nhs.uk,Research Nurse,6723,939,7662
29175,Korry,Heynel,kheynel7r@cargocollective.com,Web Developer I,4554,1763,6317
29719,Langston,Budgey,lbudgey7s@myspace.com,Payment Adjustment Coordinator,1875,1560,3435
29850,Sean,Daton,sdaton7t@ted.com,Desktop Support Technician,4400,1167,5567
29401,Vernen,Chamberlen,vchamberlen7u@microsoft.com,Information Systems Manager,5041,1882,6923
29771,Aleta,Effemy,aeffemy7v@exblog.jp,Programmer Analyst I,1077,200,1277
29449,Sheila,Martinolli,smartinolli7z@wired.com,Teacher,2719,934,3653
29953,Manda,Madgewick,mmadgewick81@nih.gov,Accountant II,3290,423,3713
29838,Emlyn,Yarrell,eyarrell82@simplemachines.org,Help Desk Technician,4634,676,5310
29164,Dulci,Spellard,dspellard85@last.fm,Research Assistant III,4502,352,4854
29523,Vinny,Pigford,vpigford86@bloglovin.com,Help Desk Technician,6462,1799,8261
29396,Ginger,Darwent,gdarwent88@washington.edu,Librarian,8138,1520,9658
29192,Bronson,Sacase,bsacase89@europa.eu,Graphic Designer,1984,1574,3558
29637,Susann,Flobert,sflobert8a@cyberchimps.com,Associate Professor,3335,832,4167
29461,Cathyleen,Ackery,cackery8b@un.org,Librarian,9141,1390,10531
29026,Evered,Brodbin,ebrodbin8d@wp.com,Food Chemist,5702,939,6641
29826,Vickie,Bowart,vbowart8e@google.cn,Food Chemist,4230,1503,5733
29298,Veda,Elmer,velmer8f@sohu.com,Research Associate,8378,1893,10271
29709,Shoshana,Basilotta,sbasilotta8g@over-blog.com,Administrative Assistant III,2080,1352,3432
29148,Nilson,De Bernardis,ndebernardis8i@nymag.com,Chief Design Engineer,9254,1852,11106
29350,Claybourne,Sainthill,csainthill8j@wired.com,Mechanical Systems Engineer,8405,1721,10126
29745,Blithe,Hatter,bhatter8k@reference.com,Software Engineer III,5980,1635,7615
29093,Brady,Hatt,bhatt8n@mozilla.org,Geologist II,2650,1178,3828
29188,Wilmer,Gomar,wgomar8p@mysql.com,Assistant Professor,9147,300,9447
29882,Sondra,Showte,sshowte8q@mlb.com,Quality Engineer,9363,1058,10421
29859,Lotte,Pardue,lpardue8r@istockphoto.com,Geological Engineer,6058,1366,7424
29102,Hatty,Godsmark,hgodsmark8u@economist.com,Payment Adjustment Coordinator,9572,1172,10744
29141,Yardley,Beentjes,ybeentjes8w@exblog.jp,Payment Adjustment Coordinator,4877,466,5343
29067,Marcille,Henriksson,mhenriksson8x@about.com,Health Coach III,9429,831,10260
29134,Analise,Monelli,amonelli8y@com.com,Biostatistician I,3786,809,4595
29104,Urson,Iredell,uiredell8z@macromedia.com,Software Consultant,6283,633,6916
29440,Curt,Campsall,ccampsall91@nhs.uk,Civil Engineer,2188,290,2478
29417,Taffy,Valiant,tvaliant93@si.edu,Assistant Professor,6624,304,6928
29423,Lucine,Hellcat,lhellcat94@marriott.com,Human Resources Manager,1369,369,1738
29035,Bax,Duddell,bduddell96@spiegel.de,Business Systems Development Analyst,8823,1556,10379
29673,Avery,Kinsell,akinsell97@timesonline.co.uk,Financial Analyst,4569,1820,6389
29430,Bryanty,Galia,bgalia98@techcrunch.com,GIS Technical Architect,3912,610,4522
29246,Cornelia,Jude,cjude9a@pbs.org,Technical Writer,5939,1957,7896
29262,Tome,Bointon,tbointon9c@epa.gov,Technical Writer,6941,1309,8250
29230,Vicky,Jepensen,vjepensen9d@jugem.jp,Structural Engineer,4319,1673,5992
29746,Lily,Whinray,lwhinray9e@cam.ac.uk,Sales Representative,9572,1709,11281
29560,Noam,Shallcross,nshallcross9g@so-net.ne.jp,Health Coach III,6273,520,6793
29833,Rosene,Bending,rbending9h@microsoft.com,Sales Associate,9340,249,9589
29205,Gabbi,Whitington,gwhitington9k@over-blog.com,Food Chemist,7202,541,7743
29442,Elspeth,Parsonage,eparsonage9n@rambler.ru,Research Associate,4605,1915,6520
29704,George,Yvens,gyvens9o@salon.com,Executive Secretary,1527,1178,2705
29120,Barbra,Celes,bceles9p@google.fr,Software Test Engineer II,6918,1127,8045
29335,Sonya,Cattach,scattach9q@about.com,Recruiter,9045,1069,10114
29698,Zola,Langforth,zlangforth9t@people.com.cn,Help Desk Operator,7093,1525,8618
29617,Aidan,Stower,astower9u@aboutads.info,Director of Sales,1885,1951,3836
29194,Gal,Meads,gmeads9v@goodreads.com,Software Test Engineer II,2768,1297,4065
29616,Jerrilyn,Paladini,jpaladini9w@printfriendly.com,Editor,2311,1459,3770
29486,Marchall,Garwill,mgarwill9x@goodreads.com,Product Engineer,8579,674,9253
29585,Roseline,Legat,rlegat9y@alibaba.com,Design Engineer,6484,1183,7667
29240,Pansy,Roseby,proseby9z@amazon.co.jp,Health Coach III,8128,1523,9651
29900,Jamison,Killingbeck,jkillingbecka0@opensource.org,Payment Adjustment Coordinator,6445,1628,8073
29566,Kissiah,Tanfield,ktanfielda1@microsoft.com,Research Assistant II,9147,1165,10312
29783,Holly,Verbrugghen,hverbrugghena2@wufoo.com,Electrical Engineer,3099,1532,4631
29632,Carolina,Massie,cmassiea3@wunderground.com,Teacher,4600,1302,5902
29443,Alf,Foale,afoalea4@bbb.org,Engineer II,2769,684,3453
29710,Ceciley,Routley,croutleya5@paginegialle.it,Design Engineer,7589,905,8494
29969,Tierney,Alloisi,talloisia6@whitehouse.gov,General Manager,2622,1186,3808
29593,Felix,Dog,fdoga7@pinterest.com,Web Developer II,7123,488,7611
29645,Odell,Milson,omilsona8@abc.net.au,VP Accounting,9233,1225,10458
29302,Marco,Flatte,mflattea9@51.la,Automation Specialist III,5980,1461,7441
29509,Clarabelle,Sessions,csessionsaa@mayoclinic.com,Safety Technician III,7333,411,7744
29275,Forrester,Corkitt,fcorkittab@nhs.uk,Compensation Analyst,5875,211,6086
29909,Estele,Banfill,ebanfillac@ustream.tv,Quality Engineer,3011,715,3726
29562,Bili,Schoolcroft,bschoolcroftad@eepurl.com,Engineer IV,4902,1527,6429
29661,Ashil,Karolowski,akarolowskiae@flavors.me,Pharmacist,6434,1802,8236
29297,Queenie,Yokelman,qyokelmanaf@icio.us,Assistant Manager,2945,1882,4827
29111,Sal,Stefi,sstefiag@pen.io,Marketing Manager,6398,901,7299
29644,Paddy,Simonitto,psimonittoah@php.net,Clinical Specialist,8707,1659,10366
29051,Hurlee,Jolliff,hjolliffai@miitbeian.gov.cn,Payment Adjustment Coordinator,2267,1404,3671
29214,Danella,Hunt,dhuntaj@addthis.com,Software Consultant,5761,1041,6802
29926,Iona,Glazer,iglazerak@scientificamerican.com,Research Nurse,1450,751,2201
29329,Putnam,Lukash,plukashal@imageshack.us,Physical Therapy Assistant,4161,884,5045
29528,Idell,Swift,iswiftam@furl.net,Web Developer IV,6660,1361,8021
29951,Newton,Walworche,nwalworchean@telegraph.co.uk,Senior Developer,9577,1049,10626
29020,Norry,Bramelt,nbrameltap@blog.com,Research Assistant II,3563,617,4180
29824,Dianne,Marrison,dmarrisonaq@freewebs.com,Senior Quality Engineer,8867,1893,10760
29380,Raimondo,Cluer,rcluerar@g.co,VP Product Management,2914,1878,4792
29741,Krystle,Dendle,kdendleat@creativecommons.org,Data Coordiator,2107,1854,3961
29611,Shem,Whines,swhinesau@behance.net,Executive Secretary,7170,606,7776
29721,Gusti,Lomasny,glomasnyav@gnu.org,Senior Developer,9039,738,9777
29310,Lurlene,Capeling,lcapelingaw@vistaprint.com,Graphic Designer,1545,1069,2614
29126,Gayle,Oliveras,goliverasax@apache.org,Account Representative III,8261,737,8998
29812,Brandtr,Sautter,bsautterb0@rediff.com,Dental Hygienist,7261,1095,8356
29548,Angy,Lieber,alieberb3@about.me,Assistant Media Planner,9841,1628,11469
29544,Beitris,Pauletti,bpaulettib4@amazon.co.uk,Marketing Assistant,6873,1795,8668
29346,Ettore,Poe,epoeb7@4shared.com,Actuary,5707,659,6366
29295,Lulita,Waddell,lwaddellb8@wordpress.com,Electrical Engineer,6111,879,6990
29353,Rees,Willatt,rwillattb9@storify.com,Geologist II,3582,1942,5524
29048,Bamby,Kamenar,bkamenarba@jugem.jp,Design Engineer,2432,372,2804
29659,Gonzalo,McNysche,gmcnyschebb@answers.com,Accountant II,5624,1281,6905
29853,Brooks,Wyeth,bwyethbc@msu.edu,Statistician I,8047,446,8493
29879,Pascal,Leftly,pleftlybd@purevolume.com,Geologist I,5954,800,6754
29322,Nicholle,Flowerdew,nflowerdewbe@nasa.gov,Financial Analyst,6951,1405,8356
29008,Zandra,Meeke,zmeekebf@earthlink.net,Programmer Analyst III,7984,527,8511
29818,Carley,Bamell,cbamellbh@auda.org.au,Executive Secretary,4484,1833,6317
29567,Randee,Tuttiett,rtuttiettbi@sitemeter.com,Occupational Therapist,4564,1331,5895
29169,Inez,Maude,imaudebk@usatoday.com,Payment Adjustment Coordinator,4445,1605,6050
29674,Krystyna,Dyerson,kdyersonbm@com.com,Developer I,5835,330,6165
29013,Bridget,Ghion,bghionbn@accuweather.com,Clinical Specialist,5454,489,5943
29030,Leila,Scarborough,lscarboroughbo@admin.ch,Actuary,9947,1841,11788
29138,Don,Grelka,dgrelkabp@wordpress.org,VP Sales,4145,1023,5168
29176,Rhona,Runciman,rruncimanbr@quantcast.com,Sales Representative,7965,845,8810
29905,Kevan,Eouzan,keouzanbs@usatoday.com,Civil Engineer,4451,229,4680
29628,Giana,Solly,gsollybt@blinklist.com,Pharmacist,7349,896,8245
29280,Ingemar,Bowller,ibowllerbv@slideshare.net,Chemical Engineer,1959,1397,3356
29906,Tove,Kincey,tkinceybw@goo.ne.jp,Web Developer IV,4489,1462,5951
29914,Morna,Kiraly,mkiralybx@stumbleupon.com,Physical Therapy Assistant,6215,1469,7684
29073,Georg,Wybern,gwybernby@rediff.com,Research Nurse,2064,1134,3198
29024,Domeniga,Esbrook,desbrookc1@myspace.com,Product Engineer,5856,2000,7856
29301,Port,Blanden,pblandenc3@amazon.co.jp,Research Assistant I,4194,1945,6139
29988,Konstantine,Thorouggood,kthorouggoodc4@businessinsider.com,Physical Therapy Assistant,1182,1133,2315
29848,Stavro,Morrow,smorrowc5@washingtonpost.com,Recruiting Manager,3109,879,3988
29920,Doti,Follitt,dfollittca@arstechnica.com,Nurse,6976,1104,8080
29748,Julieta,Wolford,jwolfordcc@google.nl,Nurse Practicioner,4491,295,4786
29804,Jaine,Trevaskus,jtrevaskuscd@barnesandnoble.com,Research Associate,7060,238,7298
29959,Granger,Haet,ghaetce@seesaa.net,Statistician III,5085,1657,6742
29808,Jaquenette,Growden,jgrowdencf@gov.uk,Health Coach II,6326,519,6845
29344,Gerik,Monier,gmonierch@surveymonkey.com,Health Coach II,9482,1865,11347
29054,Colby,Mugg,cmuggcj@sohu.com,Programmer I,6088,765,6853
29088,Joanie,Probbing,jprobbingck@theglobeandmail.com,Account Coordinator,4570,1580,6150
29233,Beltran,Robottom,brobottomcm@msu.edu,Software Consultant,9854,554,10408
29016,Mirna,Chidwick,mchidwickco@unicef.org,Marketing Assistant,1209,1889,3098
29168,Deanna,Heart,dheartcq@creativecommons.org,Payment Adjustment Coordinator,9349,1336,10685
29919,Porter,Gavin,pgavincs@com.com,Assistant Professor,1560,236,1796
29263,Sandor,Gallagher,sgallagherct@examiner.com,Professor,9643,561,10204
29467,Kala,Eblein,kebleincu@ftc.gov,Nurse Practicioner,4403,325,4728
29333,Meryl,Meaden,mmeadencw@newyorker.com,Librarian,7077,206,7283
29178,Yard,Lovie,yloviecx@printfriendly.com,Assistant Media Planner,6345,731,7076
29955,Berte,Swadden,bswaddencz@blogtalkradio.com,Technical Writer,1925,1190,3115
29963,Dawn,Richards,drichardsd0@shareasale.com,Food Chemist,5980,1811,7791
29227,Neale,Wing,nwingd1@instagram.com,Environmental Tech,8364,1950,10314
29696,Carolynn,Gwilym,cgwilymd2@miibeian.gov.cn,Senior Quality Engineer,6068,1231,7299
29797,Ford,Franke,ffranked4@mediafire.com,Environmental Tech,6280,657,6937
29799,Stavros,Naile,snailed5@networkadvertising.org,Editor,3215,445,3660
29675,Conni,Confait,cconfaitd6@wsj.com,Developer III,6585,1028,7613
29354,Stephenie,Arnli,sarnlid9@gov.uk,Executive Secretary,8340,331,8671
29648,Dyanne,Langstrath,dlangstrathdb@netscape.com,GIS Technical Architect,3199,1403,4602
29124,Godard,Dolden,gdoldendc@shinystat.com,Biostatistician II,5269,523,5792
29236,Kesley,Ailsbury,kailsburydd@gizmodo.com,Account Executive,8900,1034,9934
29795,Isak,O' Lone,iolonede@wikia.com,Account Coordinator,5511,1548,7059
29034,Brenda,Arckoll,barckolldg@pbs.org,Research Associate,1622,803,2425
29917,Ardine,Asmus,aasmusdh@squarespace.com,Developer III,5526,1707,7233
29865,Perice,De Stoop,pdestoopdi@microsoft.com,Office Assistant IV,4374,794,5168
29235,Olenolin,Cogar,ocogardj@godaddy.com,Staff Scientist,4719,1607,6326
29662,Edeline,Grice,egricedl@zdnet.com,Administrative Assistant III,2256,656,2912
29084,Tarrance,Cunnell,tcunnelldm@arizona.edu,Research Assistant IV,5330,1438,6768
29731,Hamnet,Ulrik,hulrikdn@google.fr,Media Manager IV,1088,662,1750
29382,Ivett,Clampett,iclampettdp@storify.com,Product Engineer,5060,1853,6913
29372,Nisse,Wyne,nwynedr@businessinsider.com,Accountant IV,7673,1028,8701
29862,Pammi,Golley,pgolleyds@dot.gov,Actuary,9698,512,10210
29341,Jessika,Cresar,jcresardu@cam.ac.uk,Cost Accountant,8787,739,9526
29856,Broddy,Hurling,bhurlingdw@walmart.com,Budget/Accounting Analyst III,1167,446,1613
29009,Padraic,Blacksell,pblackselle0@sitemeter.com,Senior Quality Engineer,5572,286,5858
29147,Ritchie,Tummond,rtummonde4@about.me,Human Resources Assistant III,2095,1945,4040
29553,Saraann,Moohan,smoohane5@buzzfeed.com,Staff Scientist,5716,900,6616
29241,Goran,Deschelle,gdeschellee7@blinklist.com,Associate Professor,8992,1037,10029
29279,Mahmud,Serrell,mserrelle9@taobao.com,Assistant Professor,1625,405,2030
29125,Gearard,Mandrake,gmandrakeeb@miitbeian.gov.cn,Senior Editor,5712,1874,7586
29453,Gretal,Keningham,gkeninghamed@newsvine.com,VP Sales,9429,874,10303
29966,Hannie,Stockdale,hstockdaleee@ehow.com,Data Coordiator,7388,285,7673
29880,Sven,Yurchishin,syurchishinef@freewebs.com,Social Worker,7573,1898,9471
29932,Abbe,Domange,adomangeeg@printfriendly.com,Staff Accountant IV,2565,1810,4375
29676,Candide,McJury,cmcjuryem@springer.com,Chemical Engineer,2488,1997,4485
29660,Gracie,Oxtiby,goxtibyep@ucla.edu,Human Resources Manager,9801,1451,11252
29129,Peadar,Laudham,plaudhamer@about.com,Occupational Therapist,7545,1169,8714
29717,Demetria,Broke,dbrokees@com.com,Office Assistant II,6408,1004,7412
29458,Garner,Saywell,gsaywellet@angelfire.com,Environmental Tech,1507,1666,3173
29122,Pate,Pestor,ppestorev@google.co.jp,Assistant Media Planner,3777,1387,5164
29315,Doralynne,Milsted,dmilstedex@deviantart.com,Analog Circuit Design manager,1735,1132,2867
29226,Winifred,Frodsham,wfrodshamey@narod.ru,Associate Professor,2750,1351,4101
29583,Camala,Binnion,cbinnionez@ustream.tv,Senior Financial Analyst,8096,1071,9167
29718,Ninnetta,Duly,ndulyf0@storify.com,Junior Executive,8947,890,9837
29736,Sherlocke,Bockmaster,sbockmasterf1@stumbleupon.com,Software Consultant,1740,1873,3613
29902,Moyra,Burrows,mburrowsf2@google.com.au,Account Executive,2897,1126,4023
29664,Lynsey,Mackerness,lmackernessf3@1und1.de,Senior Financial Analyst,3746,582,4328
29813,Nora,Henze,nhenzef4@bing.com,Physical Therapy Assistant,1421,1362,2783
29892,Cherida,Stive,cstivef5@pagesperso-orange.fr,Professor,3140,1964,5104
29152,Courtnay,Danick,cdanickf6@soundcloud.com,Occupational Therapist,7386,1820,9206
29711,Derrick,Hassan,dhassanf7@blogspot.com,Assistant Professor,7530,801,8331
29530,Daphene,Ertel,dertelf8@last.fm,Electrical Engineer,6491,699,7190
29991,Liane,Cornilleau,lcornilleaufa@princeton.edu,Staff Scientist,8740,1443,10183
29472,Marvin,Brockington,mbrockingtonfb@technorati.com,Human Resources Manager,8857,1627,10484
29103,Pasquale,McCusker,pmccuskerfc@house.gov,Computer Systems Analyst IV,3219,979,4198
29927,Donica,Nyles,dnylesfd@hao123.com,Compensation Analyst,3755,1343,5098
29995,Hewett,Swetmore,hswetmorefe@addthis.com,Staff Accountant IV,7398,1102,8500
29781,Ingram,Shires,ishiresfl@jimdo.com,VP Marketing,1350,1839,3189
29577,Hester,Pavel,hpavelfm@tamu.edu,Senior Financial Analyst,2481,750,3231
29269,Gayel,Streeting,gstreetingfn@seesaa.net,Software Consultant,3029,1066,4095
29894,Gallard,Bortolazzi,gbortolazzifr@hubpages.com,Administrative Assistant II,6508,1070,7578
29539,Laney,Dreini,ldreinift@businesswire.com,Quality Engineer,4378,738,5116
29512,Virgina,Barhems,vbarhemsfv@goo.ne.jp,Automation Specialist III,2997,498,3495
29089,Roddie,Blamires,rblamiresfy@merriam-webster.com,Dental Hygienist,4651,1607,6258
29956,Abigale,Bynert,abynertg1@google.co.uk,Senior Developer,4908,472,5380
29349,Killie,Linzee,klinzeeg3@dyndns.org,Design Engineer,5605,234,5839
29282,Tine,Begin,tbeging4@salon.com,Account Executive,7841,1663,9504
29504,Salomone,Borsnall,sborsnallg5@ibm.com,Recruiting Manager,7350,629,7979
29252,Stan,Domniney,sdomnineyg6@purevolume.com,Chief Design Engineer,5721,355,6076
29606,Maxwell,Shelper,mshelpergb@prlog.org,Librarian,2163,1291,3454
29591,Norman,Vivash,nvivashgc@geocities.com,Marketing Assistant,2114,933,3047
29421,Collen,Humpherston,chumpherstonge@altervista.org,Technical Writer,1639,1234,2873
29493,Parry,Brockley,pbrockleygf@opensource.org,Senior Financial Analyst,3438,517,3955
29112,Kalie,Fehely,kfehelygg@marketwatch.com,Research Nurse,5708,1227,6935
29513,Mikey,Semechik,msemechikgh@hubpages.com,Account Executive,7609,421,8030
29042,Wilmette,Glowach,wglowachgj@examiner.com,Safety Technician II,3273,334,3607
29592,Bartholemy,De la Zenne,bdelazennegk@bloglines.com,Biostatistician III,3665,661,4326
29782,Retha,Caller,rcallergo@disqus.com,Assistant Manager,5299,1792,7091
29499,Cale,Hawgood,chawgoodgq@slate.com,Associate Professor,6675,1357,8032
29563,Luce,Berthot,lberthotgr@bigcartel.com,Civil Engineer,3173,206,3379
29734,Pascale,Jovicic,pjovicicgs@ehow.com,Safety Technician II,8253,452,8705
29565,Kinnie,Rispin,krispingt@usatoday.com,VP Quality Control,5945,1503,7448
29206,Charline,Mathie,cmathiegu@wordpress.com,Clinical Specialist,5752,238,5990
29521,Ramon,Bittlestone,rbittlestonegz@bloglovin.com,Community Outreach Specialist,1663,1754,3417
29730,Cecilla,Calladine,ccalladineh0@lycos.com,Desktop Support Technician,1916,1154,3070
29225,Claude,Lilford,clilfordh1@engadget.com,Help Desk Operator,7457,1431,8888
29451,Yolanthe,Nyssen,ynyssenh2@amazon.co.jp,Quality Engineer,1948,777,2725
29319,Blondell,Hendriks,bhendriksh3@biblegateway.com,VP Accounting,8753,1987,10740
29552,Cyrillus,Phinnessy,cphinnessyh4@usa.gov,Research Nurse,3133,1048,4181
29187,Stafford,Juanico,sjuanicoh7@amazon.de,Teacher,3256,1052,4308
29174,Pace,Gherardini,pgherardinih8@slashdot.org,Legal Assistant,1661,1256,2917
29004,Karleen,Lanchbury,klanchburyhb@constantcontact.com,Accountant IV,2996,806,3802
29303,Trudey,Blazi,tblazihc@163.com,Health Coach II,3920,251,4171
29784,Jacquelynn,Fishburn,jfishburnhe@home.pl,Social Worker,6695,1241,7936
29506,Lenna,Cable,lcablehf@ibm.com,Paralegal,8743,1090,9833
29667,Base,Verrell,bverrellhj@1688.com,Product Engineer,7282,1538,8820
29242,Briney,Fippe,bfippehk@sogou.com,Quality Engineer,1324,903,2227
29173,Hortense,Garber,hgarberhl@ox.ac.uk,Software Test Engineer II,7583,1871,9454
29258,Roarke,Artz,rartzho@narod.ru,Financial Advisor,4093,1316,5409
29049,Kyle,Stanbury,kstanburyhp@mac.com,Programmer III,4042,1681,5723
29059,Fraser,Pellatt,fpellatthu@nbcnews.com,Accountant IV,8535,967,9502
29861,Maxy,Bustard,mbustardhw@netvibes.com,Design Engineer,8532,1625,10157
29609,Euphemia,Soule,esoulehx@kickstarter.com,Programmer Analyst III,7735,1527,9262
29231,Jill,Siene,jsienehy@nytimes.com,Electrical Engineer,3316,771,4087
29406,Nanci,Cole,ncolei0@sfgate.com,Senior Editor,7205,1394,8599
29278,Velvet,Couzens,vcouzensi1@zdnet.com,Graphic Designer,8628,1944,10572
29419,Wilfrid,South,wsouthi2@princeton.edu,Community Outreach Specialist,7361,622,7983
29533,Pippo,Shimon,pshimoni3@oracle.com,Associate Professor,3882,1118,5000
29821,Jemie,Ambrogelli,jambrogellii5@fotki.com,Cost Accountant,9085,864,9949
29753,Merwyn,Antoniat,mantoniati9@yandex.ru,Staff Accountant II,5568,1686,7254
29933,Christiane,Learned,clearnedia@symantec.com,Nurse,7706,254,7960
29456,Neila,Bickerstaff,nbickerstaffig@delicious.com,Project Manager,2044,1155,3199
29083,Toni,Cosgrive,tcosgriveij@addthis.com,Geological Engineer,7245,1447,8692
29410,Felice,Hansbury,fhansburyin@hc360.com,Geologist III,6381,1394,7775
29873,Drucy,Gresley,dgresleyio@lulu.com,Librarian,8342,1874,10216
29511,Sybilla,Christofe,schristofeip@berkeley.edu,Software Consultant,8356,1001,9357
29994,Izak,Costelow,icostelowir@ucsd.edu,Programmer Analyst II,8949,1758,10707
29257,Artus,Springford,aspringfordis@admin.ch,Junior Executive,1236,1166,2402
29106,Lanae,Mulcaster,lmulcasterit@china.com.cn,Environmental Tech,5742,1870,7612
29424,Lane,Wrotchford,lwrotchfordix@webmd.com,Assistant Manager,2077,1428,3505
29105,Fayth,Ruppele,fruppelej1@soup.io,Physical Therapy Assistant,1184,1775,2959
29785,Jone,Scutchings,jscutchingsj2@blog.com,Chemical Engineer,6315,1060,7375
29416,Judah,Reap,jreapj3@t-online.de,Mechanical Systems Engineer,3169,1557,4726
29699,Diane,Reames,dreamesj4@stumbleupon.com,Senior Cost Accountant,1991,778,2769
29336,Randie,Seaborn,rseabornj9@flickr.com,Staff Scientist,8764,238,9002
29400,Sandra,Gunthorp,sgunthorpja@abc.net.au,General Manager,5901,1049,6950
29540,Thom,Sowman,tsowmanjc@ow.ly,VP Marketing,2359,1879,4238
29488,Bobette,Reuble,breublejf@gmpg.org,Payment Adjustment Coordinator,9216,1118,10334
29836,Bryn,Snooks,bsnooksjg@japanpost.jp,Sales Representative,7142,1864,9006
29201,Junina,Annett,jannettjh@amazon.co.uk,Graphic Designer,1041,1077,2118
29475,Godard,Ghost,gghostjj@adobe.com,Computer Systems Analyst I,4813,531,5344
29634,Moira,Trimble,mtrimblejl@yahoo.com,Software Engineer III,1150,1907,3057
29758,Jerad,Osipov,josipovjm@live.com,Administrative Assistant I,1431,1372,2803
29435,Arv,Roomes,aroomesjn@cpanel.net,VP Accounting,1281,1549,2830
29332,Rici,Aggus,raggusjo@vk.com,Engineer IV,5455,963,6418
29014,Heidi,Eckery,heckeryjp@hhs.gov,Paralegal,4488,1638,6126
29454,Jacquenetta,Raynes,jraynesjq@usatoday.com,Environmental Tech,6833,1068,7901
29212,Cecil,Kembery,ckemberyjw@examiner.com,Software Test Engineer III,3888,1282,5170
29209,Pepi,Jarvie,pjarviejx@abc.net.au,Assistant Media Planner,2624,829,3453
29858,Darla,Hartford,dhartfordjz@skyrock.com,Health Coach III,3445,863,4308
29149,Philbert,Pease,ppeasek0@newsvine.com,Associate Professor,4592,1867,6459
29193,James,Samsin,jsamsink2@unblog.fr,Dental Hygienist,9099,1910,11009
29087,Kyle,McClaren,kmcclarenk4@nps.gov,Chief Design Engineer,7613,1527,9140
29893,Gregoor,Trump,gtrumpk5@google.ca,Assistant Manager,4014,1438,5452
29960,Al,Smowton,asmowtonk6@nytimes.com,Electrical Engineer,4754,1652,6406
29113,Silvie,Quarrington,squarringtonk8@google.com.br,Quality Engineer,7340,1695,9035
29086,Reina,Fordyce,rfordycek9@europa.eu,Environmental Specialist,3081,1185,4266
29683,Corliss,Oldershaw,coldershawkc@dyndns.org,Statistician II,4959,1579,6538
29756,Arvie,Lambell,alambellkg@edublogs.org,Information Systems Manager,1890,1970,3860
29218,Teodoro,Prothero,tprotherokh@netlog.com,Help Desk Operator,3901,415,4316
29987,Karlene,O'Sherrin,kosherrinkl@quantcast.com,Clinical Specialist,7574,659,8233
29944,Maegan,Kleimt,mkleimtkn@ovh.net,Technical Writer,3852,364,4216
29213,Lyell,Wiley,lwileykq@tripod.com,Internal Auditor,7539,1670,9209
29949,Thomasa,Abotson,tabotsonkt@nbcnews.com,Developer III,7005,988,7993
29999,Halie,Ardling,hardlingkv@timesonline.co.uk,Recruiting Manager,9636,1450,11086
29007,Brooks,Kittley,bkittleykw@vk.com,Director of Sales,7828,400,8228
29348,Nevile,Libby,nlibbyl0@weebly.com,Professor,9446,1261,10707
29531,Giulietta,Cagan,gcaganl2@indiatimes.com,Food Chemist,2940,333,3273
29342,Antonino,Hyder,ahyderl3@eventbrite.com,Sales Representative,1041,690,1731
29265,Dionisio,McGaugan,dmcgauganl5@google.ru,Environmental Tech,6760,1301,8061
29470,Harwilll,Pavlik,hpavlikl7@unblog.fr,Systems Administrator II,9752,587,10339
29561,Norris,Coolson,ncoolsonl8@blog.com,Computer Systems Analyst IV,8013,1209,9222
29869,Joella,Kidstoun,jkidstounl9@psu.edu,Sales Representative,5969,1071,7040
29199,Odo,Allitt,oallittla@nih.gov,Environmental Tech,1606,997,2603
29075,Minerva,Mathivet,mmathivetlc@artisteer.com,Automation Specialist II,6759,1981,8740
29787,Pia,Doyle,pdoylelf@tamu.edu,Analog Circuit Design manager,3107,1598,4705
29161,Tammy,Gunn,tgunnlh@vkontakte.ru,Quality Engineer,8614,1674,10288
29792,Silas,Daid,sdaidli@plala.or.jp,VP Quality Control,1328,1574,2902
29481,Artemas,Kelly,akellylo@de.vu,Business Systems Development Analyst,4850,979,5829
29144,Jackson,Inglesent,jinglesentlr@ucsd.edu,Financial Analyst,2254,1943,4197
29886,Gerard,Lowrie,glowrielv@macromedia.com,Associate Professor,6742,313,7055
29229,Sandy,Brownfield,sbrownfieldlw@opensource.org,Cost Accountant,5096,1834,6930
29484,Zane,Aubrey,zaubreyly@wix.com,Environmental Specialist,5309,1017,6326
29980,Oswald,Bromet,obrometm0@wisc.edu,Office Assistant I,8848,1392,10240
29695,Hanan,Rewan,hrewanm3@apple.com,Data Coordiator,8426,410,8836
29211,Seward,Sauniere,ssaunierem4@engadget.com,Associate Professor,9564,1087,10651
29448,Bearnard,Tawn,btawnm5@pinterest.com,Mechanical Systems Engineer,9946,333,10279
29264,Park,Bonicelli,pbonicellim6@geocities.jp,Help Desk Technician,2067,405,2472
29153,Griffy,Widdowson,gwiddowsonm7@sakura.ne.jp,Human Resources Manager,5305,1645,6950
29582,Roxie,Pilmore,rpilmorem8@dyndns.org,Web Developer IV,8731,1052,9783
29468,Tawsha,Ostler,tostlerm9@constantcontact.com,Electrical Engineer,1071,1340,2411
29747,Stanley,Gilkes,sgilkesmb@archive.org,Accountant I,7353,1582,8935
29463,Lanie,Lightollers,llightollersmg@jiathis.com,Environmental Tech,3645,635,4280
29603,Tana,Utterson,tuttersonmh@example.com,Registered Nurse,4142,791,4933
29243,Silva,Saipy,ssaipymi@yellowpages.com,Account Coordinator,9875,476,10351
29776,Meghan,Hansana,mhansanamj@whitehouse.gov,Environmental Tech,4965,1176,6141
29189,Ashlin,Vasquez,avasquezml@hibu.com,Engineer II,4764,1252,6016
29639,Emiline,Swale,eswalemm@phoca.cz,Statistician I,4120,1403,5523
29151,Conny,Ledwich,cledwichmr@desdev.cn,Occupational Therapist,1035,432,1467
29096,Vally,Fendt,vfendtmt@java.com,Senior Financial Analyst,4417,1901,6318
29967,Denys,Dudny,ddudnymu@people.com.cn,Safety Technician III,8494,718,9212
29031,Selby,Munehay,smunehaymw@baidu.com,Civil Engineer,4980,876,5856
29450,Reggie,Firidolfi,rfiridolfimx@xinhuanet.com,Office Assistant IV,9128,1928,11056
29395,Luelle,Blaskett,lblaskettmy@goo.ne.jp,Technical Writer,9597,1860,11457
29029,Brietta,Ortiga,bortigan0@eventbrite.com,Financial Advisor,1712,581,2293
29137,Stewart,Sauniere,ssaunieren1@utexas.edu,Web Developer II,6255,467,6722
29256,Mauricio,Gon,mgonn3@barnesandnoble.com,Chemical Engineer,7350,266,7616
29207,Cilka,Marrow,cmarrown4@topsy.com,Budget/Accounting Analyst II,6176,504,6680
29498,Brad,Poyle,bpoylen5@sciencedaily.com,Nurse Practicioner,8035,1056,9091
29738,Rodolfo,Danielsen,rdanielsennb@bigcartel.com,Design Engineer,4671,501,5172
29023,Hyacinth,Pass,hpassnc@sciencedaily.com,Nurse Practicioner,3292,1198,4490
29843,Abran,Swinnard,aswinnardne@issuu.com,Research Associate,6205,789,6994
29773,Alanna,Machen,amachennf@techcrunch.com,Environmental Tech,1774,1516,3290
29197,Hanni,Bantham,hbanthamng@blogger.com,Paralegal,9985,746,10731
29260,Ondrea,Folini,ofolinini@huffingtonpost.com,Tax Accountant,4699,1802,6501
29610,Caryl,Honnan,chonnannn@chicagotribune.com,Accounting Assistant I,8325,1876,10201
29483,Mahalia,Earle,mearleno@plala.or.jp,Administrative Officer,9091,1144,10235
29871,Camel,Peacocke,cpeacockenp@guardian.co.uk,Senior Cost Accountant,8912,1302,10214
29140,Celesta,Stapels,cstapelsnq@theatlantic.com,Design Engineer,6536,629,7165
29764,Neville,Riby,nribyns@shinystat.com,Staff Scientist,4616,1656,6272
29765,Minette,Stinton,mstintonnu@bloglovin.com,Technical Writer,8482,218,8700
29554,Betsey,Gresser,bgressero0@sakura.ne.jp,Research Assistant II,2415,1784,4199
29010,Barthel,Chatres,bchatreso2@nationalgeographic.com,Assistant Professor,7024,1167,8191
29954,Cayla,McKniely,cmcknielyo3@mac.com,Programmer Analyst III,4015,554,4569
29863,Gisele,Benge,gbengeo5@naver.com,Recruiting Manager,9926,581,10507
29681,Hana,Woodward,hwoodwardo9@jimdo.com,Accounting Assistant II,1344,1693,3037
29733,Stavro,Petherick,spetherickoc@unicef.org,Junior Executive,8875,780,9655
29015,Dyanna,Euesden,deuesdenod@ycombinator.com,Analog Circuit Design manager,8936,1736,10672
29615,Annmarie,Luetkemeyers,aluetkemeyersog@paginegialle.it,Safety Technician III,2202,572,2774
29360,Clifford,McGiven,cmcgivenoj@spotify.com,Environmental Specialist,9812,1403,11215
29384,Porty,Callender,pcallenderon@aboutads.info,Sales Associate,1877,1803,3680
29620,Willy,Urling,wurlingop@biblegateway.com,Human Resources Assistant III,6050,259,6309
29978,Harland,Bosworth,hbosworthox@huffingtonpost.com,Developer III,3629,544,4173
29653,Spenser,Buggy,sbuggyoz@themeforest.net,Assistant Professor,9277,1487,10764
29948,Basil,Labb,blabbp0@oaic.gov.au,Financial Analyst,2097,1972,4069
29064,Claudina,Carver,ccarverp1@yahoo.com,VP Accounting,8519,947,9466
29305,Cordy,Beddard,cbeddardp4@cdc.gov,Quality Control Specialist,1931,609,2540
29407,Jeanette,Easeman,jeasemanp5@thetimes.co.uk,Budget/Accounting Analyst III,2400,1438,3838
29514,Tasha,Klus,tklusp7@about.com,Account Coordinator,5154,725,5879
29825,Whitman,Grenshields,wgrenshieldspc@washington.edu,Project Manager,8668,983,9651
29293,Maryrose,Hawse,mhawsepf@phoca.cz,Nuclear Power Engineer,3960,1848,5808
29058,Fedora,Oliveira,foliveirapi@cnet.com,Senior Sales Associate,1884,1435,3319
29641,Constance,Lindgren,clindgrenpj@dedecms.com,Human Resources Manager,2401,217,2618
29934,Ev,Milburne,emilburnepk@noaa.gov,Human Resources Manager,2225,946,3171
29668,Megan,Calley,mcalleypl@jimdo.com,GIS Technical Architect,6420,1405,7825
29060,Hulda,Ollarenshaw,hollarenshawpn@ebay.com,Account Coordinator,3153,548,3701
29285,Lindsy,Kuhnhardt,lkuhnhardtpo@cisco.com,Account Representative I,5111,1029,6140
29852,Sybila,Tuminini,stumininipp@bluehost.com,Data Coordiator,2170,1857,4027
29317,Briano,Mattheissen,bmattheissenps@netscape.com,Safety Technician IV,8541,558,9099
29170,Yasmin,Retchford,yretchfordpw@cnbc.com,Structural Engineer,7871,1822,9693
29868,Harlie,Swayte,hswayteq0@nhs.uk,Media Manager IV,7692,689,8381
29889,Aksel,Silversmid,asilversmidq6@google.com.hk,Senior Quality Engineer,7083,1189,8272
29572,Dion,Bontoft,dbontoftq8@cnet.com,Office Assistant III,7077,1407,8484
29492,Madelene,Rollings,mrollingsqb@geocities.com,Quality Control Specialist,9757,1896,11653
29687,Dana,Ralston,dralstonqd@timesonline.co.uk,Analog Circuit Design manager,8739,1613,10352
29679,Vaughn,Vedenisov,vvedenisovqg@umich.edu,Compensation Analyst,1072,893,1965
29090,Letty,Quernel,lquernelqp@ed.gov,VP Quality Control,3927,1616,5543
29989,Ki,Lambird,klambirdqr@senate.gov,GIS Technical Architect,3892,723,4615
29057,Catherina,Cundict,ccundictqw@parallels.com,Pharmacist,9736,538,10274
29972,Kristopher,Daggett,kdaggettqy@surveymonkey.com,VP Accounting,2808,780,3588
29452,Peggie,Matyushonok,pmatyushonokqz@admin.ch,Community Outreach Specialist,5267,1765,7032
29398,Basilius,Seedman,bseedmanr7@ucoz.ru,Nurse Practicioner,4185,640,4825
29110,Culley,Habbergham,chabberghamr9@mysql.com,Senior Editor,4045,380,4425
29516,Patsy,Eldershaw,peldershawre@state.tx.us,Legal Assistant,1985,933,2918
29599,Travus,Horstead,thorsteadrf@yahoo.com,Food Chemist,4029,905,4934
29760,Munmro,Harraway,mharrawayri@ow.ly,Research Assistant II,4045,638,4683
29167,Estrellita,Euplate,eeuplaterk@myspace.com,Professor,8200,636,8836
29037,Suzi,Kluger,sklugerrl@cnbc.com,Chemical Engineer,5829,1087,6916
29289,Bonny,Bairnsfather,bbairnsfatherrm@123-reg.co.uk,Accountant II,3726,267,3993
29276,Quinlan,Monck,qmonckro@linkedin.com,Administrative Assistant IV,9870,1915,11785
29670,Lenci,Tampin,ltampinrp@about.me,Analyst Programmer,3411,618,4029
4142,Collette,Braim,cbraim0@si.edu,Compensation Analyst,7262,822,8084
4458,Neilla,Fleeman,nfleeman1@deviantart.com,General Manager,8822,329,9151
4463,Warde,Langforth,wlangforth2@github.com,Account Executive,5057,851,5908
4252,Aguie,Seniour,aseniour3@globo.com,Senior Sales Associate,8718,1018,9736
4898,Roarke,Cornels,rcornels4@icio.us,Paralegal,9391,492,9883
4150,Leoine,Henrion,lhenrion5@joomla.org,Automation Specialist III,4054,1893,5947
4880,Nathanil,Pettyfar,npettyfar6@home.pl,Teacher,4247,1569,5816
4499,Darsey,Castagnaro,dcastagnaro7@printfriendly.com,Physical Therapy Assistant,9218,1131,10349
4169,Pat,Bortolazzi,pbortolazzi8@ameblo.jp,Human Resources Assistant III,1943,1132,3075
4350,Creigh,Egdal,cegdal9@theguardian.com,Software Test Engineer II,5998,1326,7324
4578,Arnie,Semiraz,asemiraza@prweb.com,Research Nurse,2943,1827,4770
4798,Riannon,Durnan,rdurnanb@chicagotribune.com,Quality Engineer,9289,578,9867
4072,Royce,Skittrall,rskittrallc@1und1.de,Payment Adjustment Coordinator,3031,959,3990
4661,Gerrie,Bernadot,gbernadotd@chron.com,General Manager,4624,1509,6133
4585,Brucie,Goodhay,bgoodhaye@etsy.com,Technical Writer,1905,757,2662
4406,Hagan,Kloisner,hkloisnerf@youtu.be,Geological Engineer,3673,1166,4839
4873,Salomi,Marchetti,smarchettih@goo.gl,Tax Accountant,9919,1287,11206
4034,Marna,Blyden,mblydeni@webmd.com,Web Designer II,6882,1653,8535
4298,Lisa,Danihel,ldanihelj@wikimedia.org,Teacher,5958,344,6302
4103,Myles,Hazzard,mhazzardk@fastcompany.com,Account Representative III,8406,334,8740
4379,Joshua,Wilber,jwilberl@themeforest.net,Assistant Professor,9835,447,10282
4620,Joane,Allbones,jallbonesm@themeforest.net,Accounting Assistant IV,5908,1955,7863
4241,Adam,Imlin,aimlinn@creativecommons.org,Administrative Assistant II,2370,251,2621
4055,Devora,McGunley,dmcgunleyo@quantcast.com,Account Representative III,1562,515,2077
4911,Benni,Blenkinsopp,bblenkinsoppp@symantec.com,VP Product Management,5934,402,6336
4023,Berky,Tolputt,btolputtq@auda.org.au,Assistant Manager,8341,1331,9672
4859,Lexine,Velasquez,lvelasquezr@biglobe.ne.jp,Chemical Engineer,7107,498,7605
4246,Al,Pierrepoint,apierrepoints@wordpress.com,Director of Sales,9415,1657,11072
4029,Agnella,Regnard,aregnardt@nyu.edu,Account Representative II,5495,1299,6794
4528,Salomon,Corbally,scorballyu@woothemes.com,Assistant Media Planner,2752,406,3158
4858,Stearne,Duckels,sduckelsv@sakura.ne.jp,Tax Accountant,6343,1217,7560
4147,Judah,Jindracek,jjindracekw@businesswire.com,Chief Design Engineer,7087,1194,8281
4671,Gerick,Doeg,gdoegx@wix.com,Administrative Officer,7953,768,8721
4561,Mair,Nickoll,mnickolly@t-online.de,Account Coordinator,6330,363,6693
4308,Evelin,Trude,etrudez@vkontakte.ru,Graphic Designer,4539,1410,5949
4107,Prentiss,Dutt,pdutt10@furl.net,Data Coordiator,9009,969,9978
4461,Cherie,MacAiline,cmacailine11@linkedin.com,Occupational Therapist,8918,773,9691
4455,Rose,Mityakov,rmityakov12@taobao.com,Internal Auditor,3122,1135,4257
4265,Lesly,Jupe,ljupe13@fda.gov,Assistant Media Planner,8138,414,8552
4253,Angel,Disbrey,adisbrey14@nba.com,Financial Advisor,3562,644,4206
4445,Felipa,Lapwood,flapwood15@umn.edu,VP Quality Control,3526,417,3943
4133,Babette,Grew,bgrew16@state.gov,Assistant Manager,6708,1939,8647
4951,Wendye,Jerosch,wjerosch17@sogou.com,Programmer Analyst II,5270,1475,6745
4291,Caprice,Axcel,caxcel18@t.co,Senior Sales Associate,7524,305,7829
4756,Garald,Eagell,geagell19@facebook.com,Executive Secretary,8470,1577,10047
4417,Gale,Bastick,gbastick1a@utexas.edu,Analyst Programmer,4978,447,5425
4475,Pierce,Giacopelo,pgiacopelo1b@springer.com,Project Manager,4369,784,5153
4775,Lucille,Bleeze,lbleeze1c@eepurl.com,Assistant Media Planner,8109,1326,9435
4358,Susanna,Lusk,slusk1d@engadget.com,Research Associate,6982,774,7756
4067,Shannen,Wellan,swellan1e@google.ca,Quality Control Specialist,6898,1847,8745
4404,Arabel,Povall,apovall1f@java.com,VP Accounting,5791,508,6299
4141,Minta,Deakes,mdeakes1g@purevolume.com,Staff Scientist,3758,1238,4996
4594,Dall,Frayne,dfrayne1h@weebly.com,Compensation Analyst,5024,1546,6570
4238,Rockwell,Longfellow,rlongfellow1j@opera.com,Design Engineer,4790,1036,5826
4175,Gretna,McVicar,gmcvicar1k@opera.com,Technical Writer,6400,662,7062
4314,Zabrina,McKennan,zmckennan1l@state.gov,Environmental Specialist,3344,1986,5330
4304,Staffard,Grimsdith,sgrimsdith1m@themeforest.net,Senior Quality Engineer,5232,1417,6649
4777,Jenilee,Miles,jmiles1o@wikimedia.org,Senior Quality Engineer,4233,418,4651
4398,Luis,Harbin,lharbin1p@netlog.com,Research Associate,8591,1074,9665
4274,Kasper,Goodwin,kgoodwin1q@amazon.co.jp,Social Worker,8484,1939,10423
4017,Weber,Harses,wharses1r@newsvine.com,Teacher,9290,1197,10487
4895,Delly,Pickerell,dpickerell1s@netvibes.com,Administrative Officer,7481,1487,8968
4744,Dominica,Chilver,dchilver1t@mtv.com,Junior Executive,9483,1035,10518
4363,Boy,Olivie,bolivie1u@fastcompany.com,Teacher,6127,1003,7130
4192,Grant,Ewbach,gewbach1v@cdc.gov,Professor,2688,1433,4121
4470,Jaquith,Ivett,jivett1w@uiuc.edu,Financial Advisor,8123,580,8703
4115,Minda,Grigoryov,mgrigoryov1x@deviantart.com,Staff Scientist,6199,1939,8138
4426,Roselia,Klaus,rklaus1y@opera.com,Engineer III,2079,1612,3691
4297,Catha,Gregr,cgregr1z@gizmodo.com,Statistician III,9430,1584,11014
4378,Rayshell,Kingsmill,rkingsmill20@washington.edu,General Manager,8525,1989,10514
4184,Jere,Ward,jward21@ca.gov,VP Sales,2228,1440,3668
4760,Giuseppe,Lippo,glippo22@harvard.edu,Teacher,2233,373,2606
4975,Richmond,Moorcraft,rmoorcraft24@intel.com,Assistant Professor,7201,1680,8881
4566,Evvie,Garnham,egarnham25@miitbeian.gov.cn,VP Marketing,1614,1003,2617
4267,Chiarra,Epp,cepp26@sakura.ne.jp,Senior Cost Accountant,8061,1742,9803
4013,Georas,Jephson,gjephson27@cam.ac.uk,VP Accounting,6341,1221,7562
4264,Ham,Gowanlock,hgowanlock28@skype.com,Health Coach III,4884,248,5132
4994,Sal,Botler,sbotler29@wix.com,Assistant Manager,7183,342,7525
4569,Nevin,Baber,nbaber2a@tripod.com,Help Desk Operator,6763,926,7689
4154,Jewelle,Cristofanini,jcristofanini2b@buzzfeed.com,Pharmacist,6715,856,7571
4830,Phaedra,Hinken,phinken2c@wsj.com,Software Consultant,1543,1491,3034
4545,Nickola,Bleue,nbleue2d@globo.com,Web Developer I,4328,1264,5592
4905,Corie,Haward,chaward2e@domainmarket.com,Senior Financial Analyst,3202,708,3910
4930,Abbie,Mac Giolla Pheadair,amacgiollapheadair2f@php.net,Financial Analyst,4407,799,5206
4646,Crystie,Whartonby,cwhartonby2g@woothemes.com,VP Sales,2436,599,3035
4536,Daryl,Antoniades,dantoniades2h@amazon.co.uk,Biostatistician III,7706,1208,8914
4787,Antony,Leighfield,aleighfield2i@myspace.com,Developer III,6720,1420,8140
4242,Hewet,Nutter,hnutter2j@weibo.com,Automation Specialist I,9388,1298,10686
4862,Yoshiko,Salandino,ysalandino2k@thetimes.co.uk,Automation Specialist III,7681,213,7894
4940,Agna,Glowacki,aglowacki2m@rambler.ru,Editor,1415,1946,3361
4518,Brianna,Tyzack,btyzack2n@jiathis.com,Actuary,7433,1843,9276
4690,Vittoria,Prebble,vprebble2p@webnode.com,Assistant Professor,9102,894,9996
4172,Lauren,Grayland,lgrayland2q@youku.com,Operator,4334,644,4978
4423,Theodoric,Shivlin,tshivlin2s@list-manage.com,Librarian,2227,1994,4221
4542,Claiborn,Damiral,cdamiral2t@columbia.edu,Professor,7235,1523,8758
4313,Austin,Goudy,agoudy2u@apple.com,Nurse,4537,760,5297
4926,Allan,Woolam,awoolam2v@va.gov,Software Consultant,7563,654,8217
4595,Robby,Renvoise,rrenvoise2w@myspace.com,Analyst Programmer,7875,648,8523
4915,Rufe,Handslip,rhandslip2x@admin.ch,Administrative Assistant III,4738,1216,5954
4697,Ailene,Morfell,amorfell2y@mapy.cz,Automation Specialist IV,9554,924,10478
4442,Derrick,Renackowna,drenackowna2z@ow.ly,Recruiting Manager,9419,1879,11298
4977,De witt,Spellsworth,dspellsworth31@fotki.com,VP Quality Control,6021,1857,7878
4155,Kristin,Elkington,kelkington34@comcast.net,General Manager,3596,606,4202
4564,Cate,Leftbridge,cleftbridge35@scribd.com,Clinical Specialist,5540,877,6417
4440,Row,Utton,rutton36@yahoo.co.jp,Occupational Therapist,3050,709,3759
4487,Ame,Lello,alello38@umich.edu,Chemical Engineer,6499,1314,7813
4985,Mariya,Boldock,mboldock39@reverbnation.com,Desktop Support Technician,6670,1506,8176
4968,Zebulen,Deards,zdeards3a@theglobeandmail.com,Help Desk Technician,4514,1999,6513
4028,Audy,Lowes,alowes3b@arizona.edu,Structural Analysis Engineer,9940,455,10395
4570,Viva,Rawsthorne,vrawsthorne3c@webs.com,Staff Scientist,6481,1171,7652
4330,Iseabal,Wagg,iwagg3d@uiuc.edu,Programmer IV,8404,373,8777
4824,Chaddie,Gashion,cgashion3e@stanford.edu,Quality Engineer,6100,842,6942
4054,Shelba,Grevatt,sgrevatt3f@google.co.jp,Research Nurse,8723,1277,10000
4743,Hedwiga,Arnfield,harnfield3g@bloglines.com,Budget/Accounting Analyst III,5416,1087,6503
4132,Moselle,Canaan,mcanaan3h@google.pl,Compensation Analyst,2441,914,3355
4492,Corilla,Barthot,cbarthot3i@tmall.com,Actuary,1379,537,1916
4093,Verna,D'eath,vdeath3j@scientificamerican.com,Compensation Analyst,9790,754,10544
4530,Granville,Willbraham,gwillbraham3k@alexa.com,Professor,4084,1034,5118
4517,Lisetta,Oleksiak,loleksiak3l@dropbox.com,Nurse Practicioner,2796,372,3168
4451,Ignace,Ortner,iortner3m@google.cn,Technical Writer,5944,1581,7525
4684,Gilda,Vanlint,gvanlint3n@europa.eu,General Manager,4060,1716,5776
4452,Philly,Messier,pmessier3p@google.fr,Environmental Specialist,5993,402,6395
4395,Melisa,Moggie,mmoggie3r@chron.com,Environmental Specialist,6251,1525,7776
4439,Gae,Harlow,gharlow3s@mtv.com,Operator,8721,1578,10299
4340,Doe,Colwill,dcolwill3u@squidoo.com,Sales Associate,5268,1305,6573
4070,Sondra,Burd,sburd3v@homestead.com,Assistant Manager,7291,966,8257
4996,Angelle,Andriuzzi,aandriuzzi3w@ovh.net,Teacher,6573,259,6832
4332,Raimundo,Buttrey,rbuttrey3x@ftc.gov,Office Assistant I,1013,414,1427
4761,Kassi,Willstrop,kwillstrop3z@washington.edu,Compensation Analyst,5477,544,6021
4501,Hale,Marzellano,hmarzellano40@list-manage.com,Computer Systems Analyst III,7704,1055,8759
4916,Lesya,Hullyer,lhullyer41@usatoday.com,Associate Professor,1659,1028,2687
4008,Ruthanne,Wasteney,rwasteney42@washington.edu,Tax Accountant,8145,900,9045
4486,Dania,Trench,dtrench44@usda.gov,GIS Technical Architect,7299,453,7752
4562,Northrup,Feehery,nfeehery45@guardian.co.uk,Sales Representative,6943,1958,8901
4616,Lyon,Saward,lsaward46@mozilla.org,Software Consultant,5199,812,6011
4094,Winona,Rizzardi,wrizzardi47@scientificamerican.com,Information Systems Manager,7343,1946,9289
4752,Sukey,Kassidy,skassidy48@myspace.com,Programmer IV,1792,350,2142
4842,Sean,Vonasek,svonasek49@people.com.cn,Senior Cost Accountant,8488,1567,10055
4849,Winfield,Gann,wgann4a@time.com,Recruiter,3668,745,4413
4652,Linus,Matokhnin,lmatokhnin4b@vkontakte.ru,Software Consultant,7550,1309,8859
4096,Elna,Beamson,ebeamson4c@alexa.com,Project Manager,1059,1404,2463
4088,Loria,Seckom,lseckom4d@github.io,Physical Therapy Assistant,9291,788,10079
4957,Holli,Kirkam,hkirkam4e@ebay.co.uk,Senior Sales Associate,4784,1776,6560
4668,Faunie,Dulanty,fdulanty4f@booking.com,Recruiting Manager,1536,733,2269
4741,Kincaid,Pattullo,kpattullo4g@microsoft.com,Account Executive,6284,309,6593
4619,Lottie,Di Ruggero,ldiruggero4h@instagram.com,GIS Technical Architect,7710,211,7921
4831,Bathsheba,Aimer,baimer4i@fda.gov,Marketing Manager,8198,468,8666
4333,Mortimer,Scothorn,mscothorn4l@blogger.com,Operator,3962,238,4200
4351,Trude,Finnemore,tfinnemore4m@usnews.com,Pharmacist,6456,1967,8423
4301,Findley,Aplin,faplin4n@examiner.com,Payment Adjustment Coordinator,6231,1236,7467
4311,Ronna,Baldetti,rbaldetti4o@ning.com,Safety Technician III,8631,474,9105
4176,Desdemona,McGarahan,dmcgarahan4p@usnews.com,Pharmacist,4626,524,5150
4773,Ashlin,Arnot,aarnot4q@answers.com,Cost Accountant,9825,1893,11718
4747,Edith,Scardifield,escardifield4s@feedburner.com,Help Desk Technician,6725,1508,8233
4489,Ann,Shutte,ashutte4t@dropbox.com,Information Systems Manager,7289,1047,8336
4617,Tybalt,Matelaitis,tmatelaitis4u@indiegogo.com,Senior Editor,3345,950,4295
4261,Enrico,Godain,egodain4v@nsw.gov.au,Analyst Programmer,5336,281,5617
4243,Jennifer,Esmonde,jesmonde4w@gnu.org,Research Assistant III,4342,683,5025
4212,Livvie,Feehan,lfeehan4x@github.com,VP Accounting,3906,1681,5587
4941,Horace,Tedridge,htedridge4z@constantcontact.com,Account Executive,9291,1945,11236
4796,Rodrigo,Leason,rleason51@usatoday.com,Systems Administrator II,1591,504,2095
4575,Muriel,Wellum,mwellum52@toplist.cz,Senior Cost Accountant,6409,348,6757
4677,Gayleen,Rammell,grammell53@howstuffworks.com,Mechanical Systems Engineer,3356,1786,5142
4513,Louie,Knowlman,lknowlman54@gizmodo.com,Office Assistant II,7325,756,8081
4389,Kayne,Ewert,kewert55@desdev.cn,VP Quality Control,4796,1984,6780
4081,Hildagarde,Fetherstan,hfetherstan56@umich.edu,Quality Engineer,8790,663,9453
4878,Rufus,Palfrie,rpalfrie57@mysql.com,Sales Representative,1569,1679,3248
4848,Jammal,Jewiss,jjewiss58@microsoft.com,Human Resources Assistant II,2269,1570,3839
4057,Rubie,Aubri,raubri59@biblegateway.com,Research Assistant II,6751,1226,7977
4755,Ekaterina,Roch,eroch5b@tumblr.com,Staff Accountant II,9395,978,10373
4299,Timothea,McClancy,tmcclancy5c@theatlantic.com,Pharmacist,1884,1315,3199
4886,Witty,Yerson,wyerson5e@cdc.gov,Clinical Specialist,2275,822,3097
4558,Lloyd,Ricciardiello,lricciardiello5f@senate.gov,Executive Secretary,9258,1081,10339
4938,Danella,Milbank,dmilbank5g@desdev.cn,Accountant II,8251,1367,9618
4581,Loni,Sirmond,lsirmond5h@paypal.com,Product Engineer,9329,838,10167
4696,Ailina,Blance,ablance5i@mozilla.org,Senior Financial Analyst,5474,642,6116
4739,Ricard,McMahon,rmcmahon5m@europa.eu,Accountant I,4005,1272,5277
4251,Valaria,Bienvenu,vbienvenu5n@addthis.com,Registered Nurse,9524,960,10484
4187,Babbette,O'Collopy,bocollopy5o@dailymail.co.uk,Structural Engineer,1026,964,1990
4745,Drucie,Moorman,dmoorman5p@theatlantic.com,Biostatistician II,3027,532,3559
4935,Melicent,Costock,mcostock5q@cnbc.com,GIS Technical Architect,1186,370,1556
4194,Flora,Schonfeld,fschonfeld5s@tuttocitta.it,Marketing Assistant,1144,731,1875
4694,Brian,Parram,bparram5t@shop-pro.jp,Social Worker,5978,1616,7594
4084,Aliza,Radeliffe,aradeliffe5v@google.de,Geological Engineer,1052,1478,2530
4813,Renato,Devons,rdevons5w@admin.ch,Clinical Specialist,1417,1162,2579
4112,Allard,Collen,acollen5x@weibo.com,Assistant Manager,8889,1248,10137
4188,Madel,Wharin,mwharin5y@auda.org.au,Chief Design Engineer,3479,1184,4663
4393,Nadya,Tierny,ntierny5z@ycombinator.com,Environmental Specialist,1701,1557,3258
4662,Mariya,Hatherell,mhatherell60@kickstarter.com,GIS Technical Architect,7502,1782,9284
4541,Ricki,McKelvie,rmckelvie61@cornell.edu,Librarian,3922,1993,5915
4372,Elton,Jarvis,ejarvis63@nymag.com,Nurse,7915,973,8888
4635,Mattias,Derill,mderill65@dailymotion.com,Environmental Specialist,1769,1771,3540
4471,Erika,Spittal,espittal66@si.edu,Human Resources Assistant I,3499,1726,5225
4923,Redd,Royden,rroyden67@hatena.ne.jp,Account Representative I,1355,429,1784
4204,Leandra,Torry,ltorry68@hc360.com,Business Systems Development Analyst,2045,849,2894
4540,Darrin,Lionel,dlionel69@mac.com,Business Systems Development Analyst,7382,1960,9342
4963,Flossy,Found,ffound6a@hubpages.com,Safety Technician III,2294,871,3165
4498,Lorelei,Scalia,lscalia6b@artisteer.com,Senior Cost Accountant,2588,1284,3872
4871,Merline,Randles,mrandles6c@blogspot.com,Physical Therapy Assistant,8208,996,9204
4991,Linnie,Breming,lbreming6d@dell.com,Director of Sales,9396,1170,10566
4180,Sybila,Vanner,svanner6f@hugedomains.com,Programmer III,2311,1787,4098
4092,Barney,McTrustram,bmctrustram6h@ebay.co.uk,Compensation Analyst,9743,400,10143
4462,Virgie,Simakov,vsimakov6i@blogspot.com,Community Outreach Specialist,5787,358,6145
4120,Parke,Hornbuckle,phornbuckle6l@jimdo.com,Developer I,4683,429,5112
4537,Damita,Baldcock,dbaldcock6m@cbslocal.com,Account Coordinator,7354,655,8009
4899,Imelda,Nunson,inunson6o@ucsd.edu,VP Product Management,5661,1201,6862
4515,Cam,Flips,cflips6p@ameblo.jp,Recruiting Manager,4423,742,5165
4113,Alvy,Whetland,awhetland6q@illinois.edu,Executive Secretary,7218,580,7798
4764,Sherye,Leworthy,sleworthy6r@bloglovin.com,Internal Auditor,1555,640,2195
4894,Rosita,Reidie,rreidie6s@tripadvisor.com,Desktop Support Technician,6041,1260,7301
4049,Freeman,Glassford,fglassford6t@networkadvertising.org,Chemical Engineer,6305,1024,7329
4036,Timmie,Jurasz,tjurasz6u@instagram.com,Food Chemist,8508,1993,10501
4216,Sonja,Coldridge,scoldridge6v@yale.edu,Associate Professor,9525,460,9985
4973,Jennie,Davenhall,jdavenhall6x@so-net.ne.jp,Environmental Specialist,7093,869,7962
4466,Giles,Jouhandeau,gjouhandeau6y@moonfruit.com,Community Outreach Specialist,1223,1856,3079
4247,Dionne,Stewart,dstewart6z@vistaprint.com,Nurse Practicioner,8039,450,8489
4281,Brigitta,Rainon,brainon70@qq.com,Analyst Programmer,6379,468,6847
4839,Marney,Albany,malbany71@who.int,Financial Analyst,2304,882,3186
4396,Mord,Mitchinson,mmitchinson72@redcross.org,Technical Writer,8207,688,8895
4591,Juieta,Sheryn,jsheryn74@usda.gov,Pharmacist,5338,1360,6698
4278,Fifi,Fraczkiewicz,ffraczkiewicz75@vkontakte.ru,Compensation Analyst,3020,431,3451
4845,Florence,McCroft,fmccroft77@vimeo.com,Senior Editor,5265,1310,6575
4675,Serge,Jordi,sjordi79@spiegel.de,VP Quality Control,5114,1224,6338
4239,Auberon,Monget,amonget7a@lycos.com,Community Outreach Specialist,7855,695,8550
4095,Caroljean,Pavolillo,cpavolillo7b@usgs.gov,Physical Therapy Assistant,1487,1812,3299
4007,Yelena,Wattam,ywattam7d@cbc.ca,Developer III,8716,946,9662
4522,Ardene,Houlson,ahoulson7e@desdev.cn,Desktop Support Technician,3315,1242,4557
4918,Bryon,Linskill,blinskill7f@whitehouse.gov,Programmer I,6308,928,7236
4730,Jelene,Kinforth,jkinforth7g@boston.com,Design Engineer,4327,1737,6064
4896,Layney,Treherne,ltreherne7h@last.fm,Payment Adjustment Coordinator,4224,571,4795
4819,Raine,Somner,rsomner7i@topsy.com,VP Accounting,3163,1792,4955
4371,Shanan,Rusling,srusling7j@omniture.com,Assistant Manager,9085,726,9811
4236,Esme,Sehorsch,esehorsch7k@unblog.fr,Quality Control Specialist,3229,1897,5126
4293,Pincus,Cuppitt,pcuppitt7l@ucoz.ru,Account Executive,5397,1495,6892
4003,Cathryn,Bagster,cbagster7m@free.fr,Chief Design Engineer,9528,1446,10974
4135,Melva,Lett,mlett7n@twitpic.com,Developer IV,9801,1706,11507
4012,Kelila,Cogdon,kcogdon7o@networkadvertising.org,Computer Systems Analyst I,2176,465,2641
4927,Chaddie,Hare,chare7p@a8.net,Environmental Specialist,4385,1224,5609
4459,Demetris,Routley,droutley7r@rakuten.co.jp,Product Engineer,3079,1444,4523
4488,Maitilde,Astupenas,mastupenas7s@bandcamp.com,Administrative Officer,4003,851,4854
4717,Emilee,Yorke,eyorke7u@psu.edu,Assistant Media Planner,9166,1509,10675
4059,Juana,Matteau,jmatteau7w@imgur.com,Data Coordiator,6400,1730,8130
4879,Sigismond,Pether,spether7x@examiner.com,Payment Adjustment Coordinator,4851,585,5436
4056,Wells,MacEnelly,wmacenelly7y@over-blog.com,Nuclear Power Engineer,6813,588,7401
4289,Freeman,Mussared,fmussared81@gmpg.org,Web Designer II,7017,1601,8618
4254,Sonni,Cayette,scayette84@cbslocal.com,VP Marketing,1593,941,2534
4162,Hall,Civitillo,hcivitillo85@elegantthemes.com,Editor,2182,918,3100
4348,Haleigh,Clapp,hclapp86@google.fr,VP Quality Control,1353,786,2139
4590,Rowney,Bleackly,rbleackly87@wikia.com,Human Resources Manager,4872,341,5213
4441,Adel,Uvedale,auvedale88@accuweather.com,Occupational Therapist,2970,1058,4028
4138,Easter,Gammage,egammage89@state.tx.us,Human Resources Manager,5742,1873,7615
4910,Jackquelin,Grummitt,jgrummitt8a@odnoklassniki.ru,Office Assistant III,7727,352,8079
4685,Lorne,Ortmann,lortmann8b@epa.gov,Marketing Assistant,1703,1000,2703
4726,Brigitte,McVicar,bmcvicar8d@imageshack.us,Help Desk Operator,4566,627,5193
4944,Giffard,Snowball,gsnowball8e@bbb.org,Assistant Professor,3162,459,3621
4011,Elora,Corness,ecorness8f@sakura.ne.jp,Research Assistant I,6771,1032,7803
4846,Marcellus,Jiles,mjiles8g@macromedia.com,VP Sales,5848,1456,7304
4209,Cos,Aleveque,caleveque8i@lycos.com,Statistician I,6689,364,7053
4356,Binky,Hayller,bhayller8j@alexa.com,Human Resources Manager,6645,1749,8394
4727,Natka,Di Biaggi,ndibiaggi8k@mit.edu,Speech Pathologist,2474,1132,3606
4086,Glenn,Abbis,gabbis8l@blogtalkradio.com,Marketing Assistant,2769,1633,4402
4230,Hedwig,Lusted,hlusted8m@eventbrite.com,Speech Pathologist,1671,1247,2918
4876,Shela,McEvon,smcevon8n@netvibes.com,Automation Specialist III,5989,737,6726
4374,Eadie,Imeson,eimeson8o@is.gd,Software Engineer I,4652,527,5179
4152,Lin,Ambrogio,lambrogio8p@theguardian.com,Analog Circuit Design manager,8553,1988,10541
4644,Iorgos,Struther,istruther8r@ted.com,Associate Professor,4778,1763,6541
4493,Oswell,Ralfe,oralfe8s@prweb.com,Marketing Assistant,2064,1057,3121
4602,Malinda,Jiricka,mjiricka8u@salon.com,Web Developer II,8872,447,9319
4186,Uta,Sackett,usackett8v@hatena.ne.jp,Registered Nurse,9913,971,10884
4852,Kleon,Crump,kcrump8x@skyrock.com,Food Chemist,3492,1448,4940
4429,Farlie,Johantges,fjohantges8y@wp.com,Actuary,4806,1038,5844
4437,Blair,Burnham,bburnham8z@4shared.com,Editor,8265,1854,10119
4074,Lynnet,Rowston,lrowston90@cyberchimps.com,Teacher,4899,1684,6583
4877,Desirae,Brailsford,dbrailsford91@vinaora.com,Analyst Programmer,9627,816,10443
4931,Karlotte,Cowdery,kcowdery92@soundcloud.com,Speech Pathologist,2434,1569,4003
4546,Stephanie,Gozney,sgozney93@irs.gov,Account Representative I,6000,585,6585
4411,Jarad,Harfoot,jharfoot95@moonfruit.com,Human Resources Manager,7812,830,8642
4584,Brannon,Currer,bcurrer96@huffingtonpost.com,Junior Executive,8511,892,9403
4496,Carter,Balcon,cbalcon98@bizjournals.com,Junior Executive,5339,1746,7085
4680,Raimund,Meric,rmeric99@youku.com,Human Resources Assistant I,2732,510,3242
4716,Stanleigh,Gatlin,sgatlin9a@princeton.edu,Account Coordinator,5748,384,6132
4762,Royall,Watkin,rwatkin9c@noaa.gov,Safety Technician I,8983,981,9964
4828,Moshe,Clother,mclother9f@artisteer.com,Automation Specialist I,4158,363,4521
4995,Bryanty,Pau,bpau9g@blog.com,VP Sales,1088,1035,2123
4349,Shae,Pretty,spretty9h@uiuc.edu,Quality Control Specialist,9045,224,9269
4576,Cori,Mattevi,cmattevi9j@livejournal.com,Recruiting Manager,4166,394,4560
4394,Deina,Gianotti,dgianotti9k@microsoft.com,Accounting Assistant III,7869,1673,9542
4145,Pate,Schlagman,pschlagman9m@tmall.com,Research Associate,4443,1800,6243
4199,Cordy,Shelper,cshelper9o@bloomberg.com,Systems Administrator II,8164,271,8435
4217,Shelia,Thomlinson,sthomlinson9p@shutterfly.com,Programmer IV,3198,1625,4823
4539,Danette,McSpirron,dmcspirron9r@samsung.com,GIS Technical Architect,6794,1937,8731
4502,Alva,Aikenhead,aaikenhead9s@mtv.com,Account Representative III,5062,696,5758
4806,Ruthanne,Blaske,rblaske9t@edublogs.org,Cost Accountant,8706,1599,10305
4066,Maia,Simoni,msimoni9u@nps.gov,Office Assistant IV,6865,1771,8636
4387,Damien,Bonnyson,dbonnyson9w@army.mil,Clinical Specialist,7596,1363,8959
4884,Nels,McClenan,nmcclenan9x@nba.com,Software Engineer IV,2525,1587,4112
4523,Solomon,Brand-Hardy,sbrandhardy9z@chron.com,GIS Technical Architect,3994,1173,5167
4960,Kath,Divill,kdivilla0@wordpress.org,Technical Writer,7139,587,7726
4401,Nanine,Pawelski,npawelskia1@apple.com,Administrative Assistant III,6247,1863,8110
4229,Allie,Endersby,aendersbya3@spiegel.de,Recruiter,2107,263,2370
4774,Christiano,Haney,chaneya4@symantec.com,Budget/Accounting Analyst III,5736,948,6684
4479,Huntington,Shipman,hshipmana5@bluehost.com,Internal Auditor,3570,1644,5214
4928,Starlin,Jakoubec,sjakoubeca6@nytimes.com,Assistant Manager,3909,1944,5853
4837,Benton,Blazek,bblazeka7@businesswire.com,Cost Accountant,8190,574,8764
4469,Almeria,Haggerstone,ahaggerstonea8@smh.com.au,Web Developer II,5941,1163,7104
4663,Georgia,Siemandl,gsiemandla9@usa.gov,Chemical Engineer,4203,1034,5237
4507,Lydie,Alliot,lalliotaa@amazon.co.uk,Environmental Tech,4916,576,5492
4580,Obie,MacCartan,omaccartanab@github.com,Project Manager,8969,889,9858
4418,Frayda,Mosedale,fmosedalead@paypal.com,Data Coordiator,6286,213,6499
4005,Dominica,Walters,dwaltersag@about.me,Software Engineer II,1047,1807,2854
4801,Dalt,Skeels,dskeelsah@arstechnica.com,Research Nurse,7156,452,7608
4131,Gayler,Chantillon,gchantillonai@umn.edu,Analyst Programmer,7131,376,7507
4041,Liva,Levay,llevayaj@bbb.org,Software Engineer II,1607,1868,3475
4110,Cort,Nairne,cnairneak@soup.io,Data Coordiator,6878,609,7487
4037,Vicky,Choldcroft,vcholdcroftal@goo.ne.jp,Food Chemist,9822,570,10392
4613,Emyle,Napoli,enapoliam@vimeo.com,Senior Editor,4449,286,4735
4121,Kele,Doiley,kdoileyan@cnn.com,Environmental Tech,5648,1292,6940
4060,Petronille,Brydon,pbrydonaq@trellian.com,Assistant Professor,8055,850,8905
4708,Halie,Cawthry,hcawthryar@cyberchimps.com,Business Systems Development Analyst,9167,759,9926
4732,Glennis,Pregel,gpregelas@bloglines.com,Environmental Specialist,9866,979,10845
4655,Tyler,Emmot,temmotav@last.fm,VP Quality Control,2564,580,3144
4256,Gareth,Doudney,gdoudneyaw@wikipedia.org,Automation Specialist I,5554,593,6147
4467,Reeba,Boulden,rbouldenax@mayoclinic.com,Environmental Tech,1202,1691,2893
4329,Niki,Semarke,nsemarkeay@wiley.com,VP Sales,8144,612,8756
4641,Carina,Keedy,ckeedyb0@cornell.edu,Graphic Designer,8419,246,8665
4109,Park,Romanski,promanskib1@fda.gov,Registered Nurse,5431,563,5994
4280,Otto,Pendered,openderedb3@usa.gov,Speech Pathologist,3057,265,3322
4630,Leonora,MacSorley,lmacsorleyb4@rakuten.co.jp,Environmental Tech,3327,1900,5227
4163,Flory,Olenikov,folenikovb8@homestead.com,Environmental Specialist,4771,1174,5945
4689,Dylan,Guillerman,dguillermanb9@ezinearticles.com,Staff Scientist,3356,1186,4542
4342,Olivero,Mehmet,omehmetba@mysql.com,Web Designer I,3980,1867,5847
4550,Erwin,Steart,esteartbb@zimbio.com,Registered Nurse,6533,856,7389
4438,Pietra,Duplan,pduplanbc@ifeng.com,Marketing Assistant,6152,1614,7766
4526,Jami,Quail,jquailbe@whitehouse.gov,Quality Control Specialist,9098,528,9626
4380,Park,Garstang,pgarstangbf@360.cn,Research Assistant III,3911,1328,5239
4712,Stace,Hodjetts,shodjettsbh@nba.com,Paralegal,5276,755,6031
4976,Mabelle,Kunert,mkunertbj@senate.gov,Senior Editor,7610,250,7860
4165,Beatrice,Reddington,breddingtonbl@mail.ru,Compensation Analyst,9373,1466,10839
4324,Gael,Kilbride,gkilbridebn@google.co.uk,Budget/Accounting Analyst III,1825,685,2510
4453,Artair,Keming,akemingbo@wiley.com,VP Accounting,8007,580,8587
4711,Clim,Constantine,cconstantinebr@nbcnews.com,Sales Associate,3844,1672,5516
4990,Farley,Luggar,fluggarbs@4shared.com,Account Executive,3787,643,4430
4178,Angelico,Albutt,aalbuttbt@ucsd.edu,Speech Pathologist,7527,987,8514
4950,Karyn,Blatchford,kblatchfordbv@ebay.co.uk,Quality Engineer,6039,1597,7636
4368,Hilliard,Lyvon,hlyvonbw@posterous.com,Chief Design Engineer,7610,1392,9002
4505,Violante,Girardey,vgirardeybx@ihg.com,Nurse Practicioner,3070,519,3589
4901,Mitchell,Charrier,mcharrierby@issuu.com,Geologist III,1919,334,2253
4071,Travis,Ogus,togusc0@statcounter.com,Account Representative II,1854,1798,3652
4053,Allyn,Jepperson,ajeppersonc2@hatena.ne.jp,Cost Accountant,7781,512,8293
4415,Tawsha,Goscar,tgoscarc3@youtu.be,Project Manager,3786,1446,5232
4420,Juditha,Gaddie,jgaddiec5@cloudflare.com,Human Resources Manager,1051,1393,2444
4087,Deane,Kerswill,dkerswillc9@linkedin.com,Statistician III,1260,1009,2269
4612,Marin,Duigan,mduiganca@ezinearticles.com,Assistant Manager,8064,778,8842
4887,Kenyon,Pates,kpatescb@unesco.org,Statistician III,3658,1787,5445
4015,Vally,Chrestien,vchrestience@microsoft.com,Structural Engineer,6656,1877,8533
4089,Augustina,Schooling,aschoolingcf@pcworld.com,Pharmacist,8358,1340,9698
4019,Blair,Rowlstone,browlstonech@imdb.com,Engineer III,3875,1695,5570
4248,Abagail,Tommasi,atommasicm@dell.com,Senior Financial Analyst,9971,666,10637
4424,Pincus,McRoberts,pmcrobertscn@oracle.com,Recruiter,5355,1026,6381
4532,Lila,Parlatt,lparlattco@yelp.com,Compensation Analyst,9216,1225,10441
4718,Harriet,Witchell,hwitchellcp@sina.com.cn,Quality Engineer,3441,1202,4643
4468,Leontine,Whinney,lwhinneycq@drupal.org,Human Resources Assistant II,6894,1394,8288
4428,Laurene,Vidineev,lvidineevcr@redcross.org,Senior Editor,7543,1358,8901
4352,Zsa zsa,Roon,zroonct@ebay.com,Biostatistician III,4947,1630,6577
4220,Dania,Mayman,dmaymancv@auda.org.au,Chief Design Engineer,8156,1260,9416
4674,Daisy,Rackstraw,drackstrawcy@utexas.edu,VP Product Management,7097,1617,8714
4814,Rickie,Flatt,rflattcz@reuters.com,Registered Nurse,2308,377,2685
4345,Wolfie,Chapelhow,wchapelhowd0@artisteer.com,Chief Design Engineer,7225,788,8013
4992,Henderson,Gilroy,hgilroyd2@feedburner.com,Research Nurse,3963,1962,5925
4705,Cherey,Brimblecombe,cbrimblecombed3@bandcamp.com,Project Manager,1655,1443,3098
4388,Sayre,Devennie,sdevennied4@ebay.com,Software Test Engineer I,8153,661,8814
4780,Justino,Peddowe,jpeddowed6@ning.com,Senior Financial Analyst,6760,1765,8525
4624,Allister,Callar,acallard9@census.gov,Paralegal,2658,754,3412
4250,Oswell,Oddboy,ooddboydc@mayoclinic.com,Staff Accountant I,9620,335,9955
4600,Aurlie,Drought,adroughtdd@about.com,Librarian,8050,544,8594
4156,Jarrett,Lackington,jlackingtonde@behance.net,Accountant II,8980,1409,10389
4543,Cord,Sylvester,csylvesterdf@bluehost.com,Account Executive,9501,593,10094
4979,Doralynne,Ladbrook,dladbrookdg@eepurl.com,Biostatistician IV,9288,1792,11080
4303,Antonia,Tatam,atatamdh@army.mil,Web Designer III,2708,1868,4576
4258,Kaitlin,Kollasch,kkollaschdi@yandex.ru,Director of Sales,6847,1412,8259
4026,Klaus,Gamlen,kgamlendj@army.mil,Administrative Officer,8919,1461,10380
4965,Amalita,Maughan,amaughandl@alexa.com,Administrative Assistant II,8849,1406,10255
4266,Brier,Erington,beringtondm@hp.com,Human Resources Manager,5928,577,6505
4797,Bink,Matiashvili,bmatiashvilido@psu.edu,Nurse Practicioner,1552,1611,3163
4414,Ginger,Brumble,gbrumbledp@slashdot.org,Sales Representative,1298,1492,2790
4068,Marcille,Crookall,mcrookalldt@hibu.com,Professor,7229,1971,9200
4497,Ellswerth,Downgate,edowngatedu@multiply.com,Paralegal,1835,736,2571
4444,Nadiya,Charlot,ncharlotdw@cloudflare.com,Software Consultant,2789,1758,4547
4381,Waylin,Vassbender,wvassbenderdx@tmall.com,Staff Accountant IV,9194,566,9760
4731,Web,Borgnol,wborgnoldy@google.ca,GIS Technical Architect,6581,1250,7831
4850,Bobby,Mansfield,bmansfielde0@statcounter.com,General Manager,3658,1159,4817
4709,Rahel,Dyson,rdysone1@baidu.com,Biostatistician I,1393,1335,2728
4615,Elisha,Rizzini,erizzinie5@tripod.com,Senior Financial Analyst,4593,984,5577
4024,Dukie,MacCosty,dmaccostye7@mozilla.com,Analog Circuit Design manager,2390,1449,3839
4407,Rhetta,Lacase,rlacasee8@oracle.com,Legal Assistant,2682,1841,4523
4336,Darill,Acomb,dacombe9@ifeng.com,Clinical Specialist,1940,1485,3425
4431,Donny,Service,dserviceed@biblegateway.com,Chemical Engineer,4929,615,5544
4062,Brittany,Sewell,bsewellee@bandcamp.com,General Manager,2473,962,3435
4474,Katrina,Dundin,kdundinef@nps.gov,Research Assistant III,5153,1875,7028
4391,Elyssa,Kivits,ekivitsei@drupal.org,VP Product Management,5940,1259,7199
4763,Malachi,Kaye,mkayeek@woothemes.com,Computer Systems Analyst III,5964,534,6498
4822,Hazel,Hamlin,hhamlineq@oaic.gov.au,Accounting Assistant I,4802,542,5344
4556,Tobi,Nazair,tnazairer@apple.com,Programmer Analyst III,2778,1116,3894
4650,Meg,Carles,mcarleseu@cam.ac.uk,Human Resources Manager,4335,668,5003
4413,Derby,Hamlin,dhamlinew@foxnews.com,Dental Hygienist,9811,1121,10932
4031,Mela,Larratt,mlarrattex@posterous.com,Director of Sales,3424,1246,4670
4592,Kimmy,McRamsey,kmcramseyey@narod.ru,Quality Control Specialist,7932,1820,9752
5000,Christyna,Lean,cleanf0@imdb.com,Environmental Specialist,1917,1296,3213
4912,Michael,Achromov,machromovf1@163.com,Physical Therapy Assistant,8463,298,8761
4890,Emanuele,Searchwell,esearchwellf3@bloglovin.com,Account Executive,1863,1164,3027
4605,Zea,Carnachen,zcarnachenf4@cyberchimps.com,Legal Assistant,2525,305,2830
4943,Amerigo,Bollans,abollansf7@icq.com,General Manager,8220,1508,9728
4723,Ronald,Tessington,rtessingtonfe@purevolume.com,Programmer Analyst I,1926,875,2801
4826,Ramon,Govier,rgovierfg@arstechnica.com,Sales Representative,5969,921,6890
4343,Seymour,Mein,smeinfh@umich.edu,Registered Nurse,5720,1047,6767
4035,Cecilio,Deboick,cdeboickfi@nytimes.com,Design Engineer,5779,307,6086
4385,Madalena,Silverlock,msilverlockfk@discuz.net,Cost Accountant,1484,1973,3457
4039,Daryn,MacTerlagh,dmacterlaghfl@nhs.uk,Administrative Assistant IV,4430,1269,5699
4551,Gerrie,Barnaby,gbarnabyfn@psu.edu,Payment Adjustment Coordinator,1629,1595,3224
4866,Lily,Coulman,lcoulmanfo@opensource.org,Internal Auditor,1091,1437,2528
4920,Maybelle,Caizley,mcaizleyfp@loc.gov,Quality Engineer,5667,1852,7519
4596,Tyrone,Edgeon,tedgeonfq@aol.com,Human Resources Assistant II,9206,737,9943
4638,Mab,Baytrop,mbaytropfr@canalblog.com,Software Engineer IV,9307,754,10061
4788,Marleah,Douty,mdoutyfs@squarespace.com,Product Engineer,9053,858,9911
4805,Nataniel,Davydychev,ndavydychevft@dedecms.com,Senior Financial Analyst,2852,828,3680
4914,Derwin,Wakenshaw,dwakenshawfx@elpais.com,Civil Engineer,9894,1111,11005
4699,Donielle,Kollas,dkollasfz@xinhuanet.com,Senior Sales Associate,6364,270,6634
4262,Nikolai,Fessier,nfessierg1@patch.com,Senior Cost Accountant,3981,1808,5789
4288,Jacquelynn,Hoovart,jhoovartg3@issuu.com,Administrative Assistant I,1584,668,2252
4318,Bartie,Tonnesen,btonneseng7@bigcartel.com,Clinical Specialist,9423,1442,10865
4683,Prentiss,Boosey,pbooseygb@hhs.gov,Junior Executive,3584,1039,4623
4097,Venus,Jossum,vjossumgc@1688.com,Community Outreach Specialist,7754,1015,8769
4719,Blancha,Bisp,bbispgf@nature.com,Senior Financial Analyst,9966,1492,11458
4259,Nero,Hallums,nhallumsgg@tinyurl.com,Physical Therapy Assistant,5710,1502,7212
4524,Noell,Josipovic,njosipovicgh@hatena.ne.jp,Project Manager,5570,1700,7270
4476,Maryanne,Filipowicz,mfilipowiczgi@tinyurl.com,Chief Design Engineer,4737,1755,6492
4902,Marge,Sprigings,msprigingsgl@addthis.com,Web Developer I,5107,538,5645
4139,Anselm,Alleyne,aalleynegr@elpais.com,Librarian,6482,517,6999
4478,Neila,Bellini,nbellinigw@fc2.com,General Manager,2778,741,3519
4817,Olvan,Maunton,omauntongx@psu.edu,Social Worker,3437,1708,5145
4043,Lissa,Kelle,lkellegy@networksolutions.com,Database Administrator II,6884,252,7136
4275,Adriane,Bultitude,abultitudegz@canalblog.com,Compensation Analyst,2608,1132,3740
4667,Reggy,Dobrowolny,rdobrowolnyh0@ning.com,Dental Hygienist,1101,1676,2777
4779,Dare,Lowy,dlowyh1@columbia.edu,Quality Engineer,3508,1880,5388
4316,Timoteo,Samart,tsamarth3@alexa.com,Environmental Specialist,9192,1137,10329
4234,Cherri,Brahm,cbrahmh4@geocities.jp,Software Consultant,9092,1859,10951
4909,Aimil,Ekkel,aekkelh9@bigcartel.com,Speech Pathologist,3788,1059,4847
4922,Sutton,Stockings,sstockingshf@mediafire.com,Safety Technician IV,8967,988,9955
4295,Guenna,Laughren,glaughrenhh@canalblog.com,Executive Secretary,4673,471,5144
4022,Caresa,Gibb,cgibbhj@mac.com,Environmental Tech,1532,1685,3217
4257,Gerda,Brasener,gbrasenerhm@cocolog-nifty.com,Data Coordiator,7945,1453,9398
4947,Lief,Khosa,lkhosaho@salon.com,Senior Financial Analyst,6339,478,6817
4701,Tatum,Crippill,tcrippillhp@biblegateway.com,Software Engineer IV,7093,814,7907
4593,Wolf,Danelet,wdanelethq@nationalgeographic.com,Nuclear Power Engineer,7698,760,8458
4237,Lucia,Iacopini,liacopinihr@qq.com,Accountant IV,6845,896,7741
4108,Bambie,Nemchinov,bnemchinovhs@mail.ru,Help Desk Operator,4034,829,4863
4292,Griffin,Hanse,ghansehv@is.gd,Registered Nurse,9269,1549,10818
4559,Olive,Dugmore,odugmorehw@oracle.com,Compensation Analyst,7696,1409,9105
4160,Ewell,Burry,eburryhx@infoseek.co.jp,Account Representative III,7882,1614,9496
4198,Lynne,Loveless,llovelesshz@nhs.uk,Senior Developer,8336,1654,9990
4768,Ives,Dowdeswell,idowdeswelli0@seattletimes.com,GIS Technical Architect,2130,834,2964
4565,Zedekiah,Banck,zbancki1@dedecms.com,Junior Executive,8562,453,9015
4742,Odelle,Storms,ostormsi2@blogspot.com,Sales Representative,2841,1827,4668
4514,Sybil,Chalkly,schalklyi3@ovh.net,Staff Scientist,4271,1920,6191
4586,Lyda,McLelland,lmclellandi4@goo.gl,Recruiting Manager,3441,443,3884
4682,Rosemaria,Daal,rdaali5@elegantthemes.com,Developer I,8296,392,8688
4341,Erhart,Ruane,eruanei6@51.la,Nurse,6289,1407,7696
4218,Liana,Haynesford,lhaynesfordi7@shinystat.com,Registered Nurse,5394,982,6376
4534,Melly,Aynscombe,maynscombei8@amazon.com,Geological Engineer,8081,1913,9994
4286,Dunstan,McCloid,dmccloidia@go.com,Business Systems Development Analyst,4129,394,4523
4885,Claiborne,Cranson,ccransonib@mac.com,Software Engineer II,6599,1621,8220
4077,Giorgia,Brattan,gbrattanif@answers.com,Financial Advisor,7730,533,8263
4868,La verne,Plowell,lplowellil@a8.net,Community Outreach Specialist,9861,1492,11353
4882,Amalia,Farr,afarrim@dailymail.co.uk,Budget/Accounting Analyst IV,7235,847,8082
4810,Roshelle,Ladbury,rladburyin@meetup.com,Assistant Media Planner,5943,1166,7109
4640,Marne,Beaney,mbeaneyio@cornell.edu,Environmental Specialist,6125,1145,7270
4331,Corny,Abramski,cabramskiiq@cnet.com,Financial Analyst,3953,811,4764
4346,Ardyce,Hazel,ahazelir@fc2.com,Accounting Assistant I,6714,1366,8080
4782,Alexis,Stoneley,astoneleyiu@ezinearticles.com,Automation Specialist IV,5169,1562,6731
4480,Aurelie,Lenahan,alenahaniv@barnesandnoble.com,Database Administrator II,6301,678,6979
4481,Sollie,Shier,sshieriw@independent.co.uk,Account Executive,1666,956,2622
4948,Saxe,Loache,sloacheix@123-reg.co.uk,Analog Circuit Design manager,3433,202,3635
4807,Jenilee,Galvan,jgalvaniy@geocities.jp,Account Representative III,9329,1534,10863
4166,Casey,Whittick,cwhittickj0@imgur.com,Staff Accountant III,9129,630,9759
4006,Benedicta,Syratt,bsyrattj1@cisco.com,Sales Associate,7374,1857,9231
4269,Jillane,O'Grada,jogradaj2@merriam-webster.com,Marketing Manager,3008,345,3353
4195,Phillipe,Kisbee,pkisbeej3@about.com,Senior Financial Analyst,7729,222,7951
4637,Zaneta,Tesyro,ztesyroj4@pagesperso-orange.fr,Analyst Programmer,9843,1746,11589
4484,Rollo,Duding,rdudingj6@hp.com,Editor,7195,1879,9074
4626,Chicky,Jakoub,cjakoubj7@ezinearticles.com,Structural Analysis Engineer,6603,206,6809
4477,Evaleen,Jenckes,ejenckesja@diigo.com,Accountant IV,1368,1847,3215
4085,Georgette,Ivashechkin,givashechkinjc@jugem.jp,Structural Analysis Engineer,4063,1979,6042
4750,Ashlie,Aizikowitz,aaizikowitzjd@tripadvisor.com,Web Designer IV,7342,1881,9223
4201,Kari,Le Gall,klegalljh@blog.com,Occupational Therapist,5979,1947,7926
4808,Dione,Spens,dspensjl@facebook.com,Associate Professor,9372,351,9723
4765,Mayer,Vasichev,mvasichevjn@salon.com,Automation Specialist III,9953,1254,11207
4510,Hedwiga,Milleton,hmilletonjo@exblog.jp,Internal Auditor,6285,1916,8201
4658,Dorie,Hearne,dhearnejq@1und1.de,Dental Hygienist,7177,1161,8338
4222,Oran,Christer,ochristerjr@wisc.edu,Research Assistant II,2819,1435,4254
4634,Sig,Denslow,sdenslowjs@edublogs.org,Assistant Media Planner,2600,1508,4108
4161,Georgianne,Denslow,gdenslowjt@pen.io,Engineer II,3568,838,4406
4872,Henry,Gooke,hgookejv@prweb.com,Senior Developer,8227,1777,10004
4516,Cherin,Wadley,cwadleyjw@unc.edu,Budget/Accounting Analyst I,6544,1233,7777
4446,Allix,Walcher,awalcherjx@businesswire.com,Senior Quality Engineer,9557,1580,11137
4464,Nancy,Lovelace,nlovelacejy@a8.net,Programmer Analyst I,2789,1339,4128
4359,Auberon,Colkett,acolkettjz@edublogs.org,Database Administrator II,9884,631,10515
4224,Doralyn,Chazette,dchazettek2@bloglovin.com,Administrative Officer,6137,848,6985
4190,Lori,Crowcombe,lcrowcombek5@g.co,Computer Systems Analyst II,8294,356,8650
4607,Layla,Woodhouse,lwoodhousek7@salon.com,Structural Analysis Engineer,8076,819,8895
4134,Thurstan,McGriele,tmcgrielek8@samsung.com,Electrical Engineer,8411,341,8752
4117,Jessi,Matteacci,jmatteaccik9@aol.com,Payment Adjustment Coordinator,3869,1097,4966
4038,Martainn,Danielian,mdanielianke@nih.gov,Sales Associate,7254,1819,9073
4754,Julianna,Greville,jgrevillekh@tinypic.com,Structural Analysis Engineer,8363,1996,10359
4964,Liam,Filippozzi,lfilippozzikj@opensource.org,Speech Pathologist,8565,1464,10029
4984,Frederique,Farrall,ffarrallkn@comcast.net,Social Worker,2822,515,3337
4710,Mercedes,Greystock,mgreystockko@illinois.edu,Occupational Therapist,3478,1002,4480
4210,Raychel,Tomaskunas,rtomaskunaskw@amazonaws.com,Electrical Engineer,8678,202,8880
4714,Othilia,Sheber,osheberl1@rediff.com,Compensation Analyst,9631,501,10132
4670,Louisette,Moncrieffe,lmoncrieffel2@sitemeter.com,Staff Scientist,9809,614,10423
4021,Raff,Bock,rbockl6@guardian.co.uk,Software Test Engineer III,8493,1666,10159
4553,Emmi,Abelson,eabelsonl7@icq.com,Geological Engineer,1588,1951,3539
4260,Artur,McElroy,amcelroyla@bigcartel.com,Automation Specialist I,1575,1691,3266
4048,Hymie,Larn,hlarnlb@shinystat.com,Staff Scientist,6788,577,7365
4227,Etienne,Foskew,efoskewlc@fda.gov,Senior Sales Associate,8214,1151,9365
4841,Myrtie,Scutter,mscutterle@ebay.com,Web Developer IV,5375,813,6188
4954,Shanda,Parish,sparishlj@dyndns.org,Assistant Media Planner,2014,525,2539
4335,Wat,Derisly,wderislylm@twitpic.com,Food Chemist,2924,536,3460
4494,Aylmar,Benning,abenninglq@joomla.org,Environmental Tech,6322,903,7225
4434,Wallace,Jellybrand,wjellybrandlr@discuz.net,Research Associate,3505,860,4365
4521,Dorie,Siddall,dsiddalllt@smh.com.au,Civil Engineer,1734,1985,3719
4268,Mirella,Gyngyll,mgyngylllv@google.co.jp,Librarian,3868,1779,5647
4933,Ryan,Pittendreigh,rpittendreighlx@is.gd,Statistician I,5228,1508,6736
4360,Jonathan,Fritschel,jfritschellz@netscape.com,Database Administrator IV,7913,228,8141
4410,Pandora,Ayling,paylingm0@ifeng.com,Programmer III,9083,1849,10932
4737,Allan,Arons,aaronsm4@tinyurl.com,Operator,1864,1013,2877
4698,Corny,Rosel,croselm6@canalblog.com,Compensation Analyst,1836,1862,3698
4707,Leroy,Sango,lsangoma@un.org,Paralegal,5390,580,5970
4004,Lauritz,Spinnace,lspinnacemh@prnewswire.com,Software Consultant,7900,1229,9129
4226,Merralee,Hallifax,mhallifaxmi@baidu.com,Help Desk Technician,4661,212,4873
4447,Kelsey,Heardman,kheardmanmp@disqus.com,Administrative Officer,5152,423,5575
4843,Pamelina,Cruft,pcruftmr@miibeian.gov.cn,Account Coordinator,7696,1134,8830
4552,Vinni,Janus,vjanusmt@issuu.com,Director of Sales,3777,1946,5723
4069,Dorice,Mordey,dmordeymv@columbia.edu,Help Desk Operator,9843,450,10293
4325,Rahal,McQuirk,rmcquirkn0@baidu.com,Programmer III,5174,882,6056
4889,Brigitta,Gilligan,bgilligann3@timesonline.co.uk,Quality Control Specialist,7038,345,7383
4302,Gun,Elce,gelcen4@wikipedia.org,VP Sales,3672,1551,5223
4610,Sanford,Melesk,smeleskn7@google.com.hk,Executive Secretary,5020,634,5654
4548,Lucina,Frean,lfreann9@mit.edu,Web Developer III,2303,1488,3791
4151,Henry,Birrel,hbirrelnc@discuz.net,Payment Adjustment Coordinator,1602,1719,3321
4294,Biddy,Fairpool,bfairpoolnd@clickbank.net,Financial Advisor,5347,1293,6640
4284,Andree,Tigwell,atigwellng@admin.ch,Senior Quality Engineer,7460,634,8094
4623,Robenia,Hugonneau,rhugonneauno@mediafire.com,Junior Executive,3406,481,3887
4228,Jasen,Heselwood,jheselwoodnp@blog.com,Help Desk Operator,6176,565,6741
4978,Layney,Simionescu,lsimionescunq@ifeng.com,Assistant Professor,6409,1523,7932
4421,Inigo,Southcomb,isouthcombnr@fotki.com,Accountant III,6558,1597,8155
4767,Odey,Malecky,omaleckynt@blogger.com,Nuclear Power Engineer,6898,217,7115
4929,Ranice,Eslemont,reslemontnu@bluehost.com,Technical Writer,7922,1901,9823
4893,Ali,McMickan,amcmickannv@weebly.com,Product Engineer,4499,1683,6182
4863,Jarrid,Rozea,jrozeao4@opera.com,VP Product Management,5357,1916,7273
4271,Hewet,Tayspell,htayspello5@ibm.com,Financial Advisor,4381,291,4672
4900,Eward,Nelles,enelleso6@sun.com,Human Resources Assistant III,8641,1412,10053
4572,Jarret,Dales,jdaleso7@google.ca,Senior Editor,4288,1216,5504
4757,Enriqueta,Kennicott,ekennicotto8@squarespace.com,Quality Control Specialist,3540,1463,5003
4181,Julia,Bloore,jblooreoc@cloudflare.com,Professor,2409,375,2784
4203,Dorelle,Mordacai,dmordacaioe@bbb.org,Sales Associate,6297,819,7116
4312,Bethena,January 1st,bjanuarystog@tmall.com,Senior Quality Engineer,5857,1855,7712
4649,Gaultiero,Antony,gantonyoi@infoseek.co.jp,Tax Accountant,2932,236,3168
4296,Marita,Rusk,mruskok@dropbox.com,Project Manager,7936,1529,9465
4114,Bethina,Manifould,bmanifouldol@wikipedia.org,Occupational Therapist,6021,1994,8015
4855,Petronella,McSharry,pmcsharryom@dailymail.co.uk,Accounting Assistant II,8947,1249,10196
4853,Bethena,Ashbe,bashbeon@state.gov,Recruiter,8509,1210,9719
4182,Fanya,Lemerle,flemerleoo@smugmug.com,Structural Analysis Engineer,7919,1275,9194
4608,Tynan,Lamport,tlamportop@google.de,Social Worker,1554,905,2459
4174,Dasha,Byles,dbylesoq@google.cn,Design Engineer,7403,1786,9189
4361,Reade,McKmurrie,rmckmurrieot@cpanel.net,Marketing Manager,8478,698,9176
4435,Hedvige,Gallehawk,hgallehawkou@china.com.cn,Help Desk Operator,6286,721,7007
4917,Romonda,Andrey,randreyov@mysql.com,Nurse,1010,861,1871
4338,Nanni,Purry,npurryow@businesswire.com,Social Worker,3304,1842,5146
4173,Noland,Sterricks,nsterricksox@networkadvertising.org,Staff Accountant IV,1050,1176,2226
4273,Tana,Blackeby,tblackebyoy@shutterfly.com,Community Outreach Specialist,4895,1329,6224
4789,Zelda,Scurrah,zscurrahoz@intel.com,Safety Technician IV,5278,281,5559
4334,Raf,Glasman,rglasmanp1@edublogs.org,Senior Editor,8340,856,9196
4874,Janis,Siene,jsienep3@unicef.org,Senior Developer,8998,1923,10921
4300,Daphna,Skeermer,dskeermerp9@blogs.com,Software Engineer I,3064,1162,4226
4681,Camala,Dugue,cduguepa@buzzfeed.com,Assistant Professor,3536,502,4038
4483,Brenna,MacMeekan,bmacmeekanpe@xrea.com,Speech Pathologist,4826,1136,5962
4164,Claudianus,Lyburn,clyburnpg@nature.com,Structural Engineer,1694,1473,3167
4980,Kellsie,Banfill,kbanfillpl@blogger.com,Community Outreach Specialist,6882,421,7303
4082,Hussein,Fateley,hfateleypm@lycos.com,Environmental Tech,1810,1820,3630
4183,Drucie,Pockett,dpockettpp@vistaprint.com,Graphic Designer,9354,893,10247
4725,Crystie,Lording,clordingpq@ycombinator.com,Senior Editor,3242,594,3836
4870,Davidde,De Gowe,ddegowepv@jigsy.com,VP Quality Control,3928,1500,5428
4829,Bethena,Puve,bpuvepw@mapy.cz,Information Systems Manager,1680,352,2032
4939,Earle,Luetkemeyer,eluetkemeyerpx@weibo.com,Electrical Engineer,9695,986,10681
4105,Thaddeus,Smallman,tsmallmanq0@weebly.com,Operator,1933,1496,3429
4604,Kleon,Pavlik,kpavlikq1@google.es,Director of Sales,1064,557,1621
4720,Edan,Croutear,ecroutearq2@cnet.com,Recruiting Manager,8551,930,9481
4883,Rich,Rabb,rrabbq3@shutterfly.com,Analog Circuit Design manager,4442,1169,5611
4778,Arie,Ghelerdini,aghelerdiniq9@berkeley.edu,Senior Developer,8466,1052,9518
4706,Erma,Prinett,eprinettqc@answers.com,Product Engineer,8354,1698,10052
4666,Mikel,Lyttle,mlyttleqd@webnode.com,Biostatistician IV,8873,1559,10432
4803,Claribel,Hart,chartqg@microsoft.com,Information Systems Manager,8343,329,8672
4642,Fara,Dickon,fdickonqh@goodreads.com,Research Associate,3576,214,3790
4020,Bibby,Chomiszewski,bchomiszewskiqk@barnesandnoble.com,Operator,7702,267,7969
4724,Nickola,Hubbock,nhubbockqn@ameblo.jp,Human Resources Manager,4389,1588,5977
4833,Adelina,Brogan,abroganqo@meetup.com,Sales Associate,6668,1407,8075
4153,Karyn,Baswall,kbaswallqp@tripod.com,Budget/Accounting Analyst II,3176,1496,4672
4913,Corrine,Santos,csantosqs@google.com,Geologist IV,6229,1499,7728
4129,Babb,Skouling,bskoulingqu@chron.com,Editor,5927,1290,7217
4014,Ninetta,De Filippi,ndefilippiqz@twitter.com,Recruiting Manager,2933,1907,4840
4339,Tony,Stert,tstertr0@illinois.edu,Help Desk Operator,8647,956,9603
4018,Donnie,Magnar,dmagnarr3@slate.com,Pharmacist,2640,947,3587
4734,Darb,Rainton,draintonr5@ibm.com,Accounting Assistant I,8852,671,9523
4589,Berrie,McGrey,bmcgreyr6@icio.us,Community Outreach Specialist,8563,921,9484
4823,Anatola,Adess,aadessr7@umn.edu,VP Marketing,3393,1759,5152
4310,Vittoria,Rentelll,vrentelllrc@amazonaws.com,Structural Engineer,9441,863,10304
4416,Gan,Maddick,gmaddickrd@tinypic.com,Staff Accountant I,8080,356,8436
4577,Franchot,Allchorn,fallchornrg@t.co,Geological Engineer,1776,742,2518
4323,Aliza,Burdett,aburdettro@angelfire.com,Quality Engineer,7497,1899,9396
4403,Fanchon,Newham,fnewhamrp@gnu.org,Actuary,8591,1999,10590
4168,Hortensia,Blasi,hblasirq@twitpic.com,Web Developer III,1235,1293,2528
5320,Robbyn,Farfull,rfarfull0@economist.com,Dental Hygienist,4017,1755,5772
5437,Olympie,Bettanay,obettanay1@tumblr.com,Administrative Officer,8691,288,8979
5358,Sonia,Swires,sswires2@yellowpages.com,Teacher,6663,1967,8630
5606,Lewiss,Mayze,lmayze3@oaic.gov.au,Senior Editor,4217,695,4912
5624,Rey,Uc,ruc4@domainmarket.com,Chief Design Engineer,7601,839,8440
5715,Vi,Strooband,vstrooband5@example.com,Geologist III,3553,1160,4713
5757,Terrel,Hedworth,thedworth6@trellian.com,Engineer I,1728,1834,3562
5899,Shelbi,Rangell,srangell7@independent.co.uk,Senior Developer,1052,1608,2660
5224,Emanuel,Lamcken,elamcken8@behance.net,VP Marketing,7293,1803,9096
5190,Annnora,Dury,adury9@cafepress.com,Physical Therapy Assistant,6884,833,7717
5467,Devinne,Lyffe,dlyffea@cisco.com,Help Desk Operator,7111,1855,8966
5804,Josefina,Pincked,jpinckedb@cafepress.com,Administrative Assistant II,5167,771,5938
5356,Gilles,Cocksedge,gcocksedgec@ucsd.edu,Senior Quality Engineer,8490,1603,10093
5821,Edita,Kenewell,ekenewelld@mayoclinic.com,Community Outreach Specialist,6705,499,7204
5762,Harp,Baraclough,hbaracloughe@cbsnews.com,Biostatistician I,4582,1351,5933
5781,Madelene,Peedell,mpeedellf@jalbum.net,Administrative Officer,7133,989,8122
5475,Mandel,Camsey,mcamseyg@archive.org,Engineer III,1159,1844,3003
5199,Hanan,Edgler,hedglerh@yahoo.com,Data Coordiator,4274,1671,5945
5593,Berta,Domoni,bdomonii@illinois.edu,Database Administrator I,3323,967,4290
5119,Clarette,Jasper,cjasperj@addthis.com,Operator,9869,1549,11418
5019,Pierre,Sturney,psturneyk@etsy.com,Compensation Analyst,7999,984,8983
5471,Wanda,Poolton,wpooltonl@sun.com,Recruiter,7228,1654,8882
5318,Madelaine,MacGibbon,mmacgibbonm@slate.com,Account Executive,6237,933,7170
5279,Neysa,Hundal,nhundaln@booking.com,Web Designer II,5167,1650,6817
5073,Consalve,MacDermott,cmacdermotto@businessweek.com,Executive Secretary,4095,548,4643
5769,Hedvig,Gipp,hgippp@omniture.com,Computer Systems Analyst II,4121,1293,5414
5687,Liesa,Rumbellow,lrumbellowq@digg.com,Quality Engineer,7420,666,8086
5335,Sasha,Scardifield,sscardifieldr@geocities.com,Cost Accountant,5399,787,6186
5853,Nathanil,Greated,ngreateds@google.cn,Senior Editor,8774,1055,9829
5314,Ceciley,Ravilus,cravilust@dagondesign.com,Software Test Engineer II,1196,1196,2392
5816,Jarid,Gentile,jgentileu@phpbb.com,General Manager,7717,968,8685
5647,Gui,Neads,gneadsv@blogtalkradio.com,Statistician III,5403,1028,6431
5830,Barby,Benedikt,bbenediktw@google.ru,Tax Accountant,7427,1753,9180
5634,Pepita,Stamp,pstampx@eepurl.com,Biostatistician IV,3540,1875,5415
5691,Aurora,Mattedi,amattediy@pagesperso-orange.fr,Financial Advisor,9028,878,9906
5171,Tedie,Scotfurth,tscotfurthz@jugem.jp,Help Desk Operator,5300,1550,6850
5612,Sid,Brennenstuhl,sbrennenstuhl10@purevolume.com,Data Coordiator,4354,1606,5960
5207,Farrah,Hundley,fhundley11@amazon.de,VP Quality Control,3699,1094,4793
5873,Koral,Jancik,kjancik12@illinois.edu,VP Marketing,3016,314,3330
5087,Julian,Taylorson,jtaylorson13@xrea.com,Desktop Support Technician,4378,719,5097
5078,Aymer,Garces,agarces14@google.com,Analyst Programmer,6984,1433,8417
5987,Clemmie,Boykett,cboykett15@deviantart.com,Nuclear Power Engineer,7374,1572,8946
5344,Aurelia,Sertin,asertin16@disqus.com,Social Worker,6655,1906,8561
5894,Garfield,Chesshire,gchesshire17@paypal.com,Assistant Professor,2960,784,3744
5012,Olivette,Kunrad,okunrad18@ox.ac.uk,Business Systems Development Analyst,4696,891,5587
5661,Brenna,Armstrong,barmstrong19@scientificamerican.com,Recruiting Manager,6109,1332,7441
5789,Karisa,Burt,kburt1a@addtoany.com,Recruiter,1821,1980,3801
5828,Noll,Pickburn,npickburn1b@patch.com,VP Marketing,9704,1177,10881
5678,Thorstein,Donaghie,tdonaghie1c@sourceforge.net,Structural Analysis Engineer,2193,1688,3881
5607,Mariana,MacCard,mmaccard1d@upenn.edu,Database Administrator III,8478,1985,10463
5407,Gordie,Wethers,gwethers1e@posterous.com,Computer Systems Analyst III,7975,985,8960
5293,Meredithe,Paddefield,mpaddefield1f@wikia.com,Project Manager,4390,1881,6271
5736,Guinevere,Ashwin,gashwin1g@dion.ne.jp,Geological Engineer,2216,358,2574
5636,Ingeberg,Ivanov,iivanov1h@toplist.cz,Account Representative III,1825,1168,2993
5081,Nicolette,Dalziel,ndalziel1i@dot.gov,Tax Accountant,2254,1284,3538
5609,Josh,Kinzel,jkinzel1j@google.ca,Nuclear Power Engineer,6055,938,6993
5144,Zak,Dunnion,zdunnion1k@ted.com,Technical Writer,3600,517,4117
5431,Mikol,Pennigar,mpennigar1l@sina.com.cn,Senior Developer,7368,1922,9290
5725,Lory,Stucke,lstucke1m@fema.gov,Electrical Engineer,5274,421,5695
5083,Shanon,Delamere,sdelamere1n@storify.com,Legal Assistant,4057,661,4718
5426,Rhody,Mullally,rmullally1o@histats.com,Project Manager,4268,622,4890
5024,Cammy,Walkey,cwalkey1p@goodreads.com,Mechanical Systems Engineer,5246,1207,6453
5734,Pace,Andreuzzi,pandreuzzi1q@google.co.uk,Help Desk Technician,6502,1349,7851
5660,Powell,Keat,pkeat1s@ed.gov,Programmer I,4754,1851,6605
5252,Stacee,Degenhardt,sdegenhardt1t@apache.org,Geologist III,4866,713,5579
5296,Peta,Warmisham,pwarmisham1u@comsenz.com,Computer Systems Analyst II,6147,1464,7611
5896,Elysha,Bullene,ebullene1v@de.vu,Recruiter,9026,546,9572
5897,Karia,Moyse,kmoyse1w@cbsnews.com,Quality Engineer,3262,1658,4920
5265,Bonni,Isakowicz,bisakowicz1x@oracle.com,Senior Financial Analyst,2202,1489,3691
5626,Clementia,Banasevich,cbanasevich1y@psu.edu,VP Product Management,4815,1036,5851
5777,Rudolph,Merrifield,rmerrifield1z@usatoday.com,Senior Financial Analyst,6124,876,7000
5969,Eran,Schrir,eschrir20@printfriendly.com,Financial Analyst,3535,1741,5276
5507,Abigale,Fowley,afowley21@prweb.com,Administrative Officer,2339,1042,3381
5514,Gretal,Stendell,gstendell22@wikipedia.org,Payment Adjustment Coordinator,3894,638,4532
5997,Bryan,Bradden,bbradden23@princeton.edu,Software Engineer IV,7273,1576,8849
5525,Alexandrina,Bradock,abradock24@ftc.gov,VP Accounting,1529,414,1943
5139,Amargo,Reims,areims26@craigslist.org,Senior Sales Associate,7414,636,8050
5787,Elvina,Cantopher,ecantopher27@cpanel.net,Senior Quality Engineer,4298,612,4910
5380,Lorettalorna,Edgerley,ledgerley28@dell.com,Actuary,8793,376,9169
5045,Rhett,Fallanche,rfallanche29@nytimes.com,Safety Technician IV,4975,1040,6015
5724,Walther,Harkin,wharkin2a@home.pl,Tax Accountant,2063,1160,3223
5735,Allyce,Norsworthy,anorsworthy2b@wsj.com,Nuclear Power Engineer,2864,1425,4289
5870,Nata,Bawcock,nbawcock2c@youtu.be,Analog Circuit Design manager,4178,435,4613
5298,Mackenzie,Tow,mtow2e@myspace.com,Financial Analyst,5642,1337,6979
5696,Shelly,Flintuff,sflintuff2f@is.gd,Legal Assistant,3790,1603,5393
5551,Thaddeus,Heaps,theaps2g@redcross.org,Community Outreach Specialist,8183,1881,10064
5506,Leif,Cummins,lcummins2h@icio.us,Actuary,9365,647,10012
5306,Shell,Attwooll,sattwooll2i@yellowbook.com,Social Worker,8184,1831,10015
5255,Sonia,Welden,swelden2j@cornell.edu,Information Systems Manager,6059,772,6831
5825,Nerta,Wavell,nwavell2k@about.me,Staff Accountant III,4647,1454,6101
5926,Mae,Doody,mdoody2l@psu.edu,Junior Executive,3689,241,3930
5565,Armin,Oldroyd,aoldroyd2m@squidoo.com,Civil Engineer,5665,314,5979
5309,Hasty,Di Giacomo,hdigiacomo2n@skyrock.com,Quality Control Specialist,4803,648,5451
5608,Gray,Darrach,gdarrach2o@theatlantic.com,Social Worker,4272,286,4558
5879,Cazzie,Colter,ccolter2p@g.co,Project Manager,1155,1980,3135
5835,Mohandis,Antonikov,mantonikov2q@google.de,Account Executive,8110,894,9004
5193,Ring,Bresson,rbresson2r@ucoz.ru,Pharmacist,8244,678,8922
5783,Angel,Tringham,atringham2s@chronoengine.com,Senior Cost Accountant,3640,1802,5442
5018,Malanie,Goschalk,mgoschalk2t@meetup.com,Structural Analysis Engineer,1228,1214,2442
5905,Ruthy,Jockle,rjockle2v@flavors.me,Nurse,8472,682,9154
5752,Annissa,Edinburgh,aedinburgh2w@bloglines.com,Account Executive,8684,972,9656
5273,Stormie,Tiler,stiler2x@engadget.com,Administrative Officer,8278,263,8541
5580,Smitty,Stickel,sstickel2y@free.fr,Information Systems Manager,2062,953,3015
5618,Amalie,Kembrey,akembrey2z@surveymonkey.com,Legal Assistant,5796,782,6578
5353,Delila,Nutting,dnutting30@shareasale.com,Structural Analysis Engineer,4412,1419,5831
5553,Pren,Brewer,pbrewer31@amazon.com,Professor,3127,1207,4334
5385,Barby,Raven,braven32@senate.gov,Media Manager IV,8319,1134,9453
5509,Shoshanna,Einchcombe,seinchcombe33@usatoday.com,Staff Scientist,4324,1545,5869
5137,Valery,Nowakowski,vnowakowski34@nature.com,Help Desk Technician,2519,1206,3725
5968,Sylvan,Birks,sbirks35@skyrock.com,Media Manager IV,2850,1907,4757
5566,Hans,Rabb,hrabb36@china.com.cn,Account Representative III,1412,1379,2791
5904,Amanda,Matzl,amatzl37@senate.gov,Software Consultant,6686,1744,8430
5191,Anabal,Emanuelov,aemanuelov38@usgs.gov,Quality Control Specialist,5311,202,5513
5060,Alfreda,Geal,ageal39@dion.ne.jp,Physical Therapy Assistant,8491,918,9409
5587,Nikolia,Cardo,ncardo3a@uol.com.br,Administrative Officer,8655,388,9043
5741,Aurelie,Bernhart,abernhart3b@abc.net.au,Food Chemist,1177,390,1567
5116,Erena,Stiggers,estiggers3d@google.com.hk,Payment Adjustment Coordinator,9222,481,9703
5961,Sioux,Featherby,sfeatherby3e@engadget.com,VP Marketing,8116,331,8447
5665,Layton,Nelthorp,lnelthorp3f@ft.com,Structural Analysis Engineer,8700,1081,9781
5834,Nelly,Yare,nyare3g@guardian.co.uk,Actuary,1677,564,2241
5262,Mathilde,Skillman,mskillman3h@dagondesign.com,Environmental Tech,9899,936,10835
5221,Ade,Neligan,aneligan3j@amazon.co.uk,Business Systems Development Analyst,3169,712,3881
5855,Carl,Calleja,ccalleja3k@nydailynews.com,Professor,4374,1193,5567
5585,Sofia,Jacketts,sjacketts3l@home.pl,Graphic Designer,5280,248,5528
5131,Samson,Styles,sstyles3m@jiathis.com,Senior Financial Analyst,5960,1322,7282
5418,Darrell,Whittock,dwhittock3n@pen.io,Electrical Engineer,8461,636,9097
5188,Lee,Tabner,ltabner3o@g.co,Programmer Analyst I,6252,1954,8206
5536,Katheryn,Sandiland,ksandiland3p@weibo.com,Legal Assistant,4450,1884,6334
5109,Andres,Aylmore,aaylmore3q@51.la,Occupational Therapist,7812,1726,9538
5947,Chauncey,Breeds,cbreeds3r@dell.com,Analog Circuit Design manager,4160,1519,5679
5435,Bettina,Bromige,bbromige3t@ted.com,Budget/Accounting Analyst IV,7341,1476,8817
5198,Emiline,Banasiak,ebanasiak3u@ebay.com,Teacher,1024,1034,2058
5072,Salaidh,Mayger,smayger3v@taobao.com,Software Test Engineer I,5697,1126,6823
5371,Huntington,Mannock,hmannock3w@census.gov,Quality Engineer,7456,850,8306
5954,Elisa,Northage,enorthage3x@ibm.com,Biostatistician IV,8499,1140,9639
5670,Cherilyn,McGuckin,cmcguckin3y@rediff.com,Account Executive,6938,1373,8311
5773,Owen,Ferran,oferran3z@biglobe.ne.jp,Design Engineer,6651,253,6904
5843,Nonie,Gumn,ngumn40@freewebs.com,Assistant Media Planner,3446,730,4176
5226,Red,Le Strange,rlestrange41@psu.edu,Information Systems Manager,2805,670,3475
5658,Weidar,Bartell,wbartell42@liveinternet.ru,Chemical Engineer,4048,1892,5940
5253,Wait,Binyon,wbinyon43@msu.edu,Occupational Therapist,2010,775,2785
5960,Alix,Gribbins,agribbins44@prweb.com,Cost Accountant,1307,1821,3128
5128,Siana,Wallentin,swallentin45@com.com,Database Administrator III,7760,1136,8896
5887,Emelen,Siderfin,esiderfin46@blinklist.com,Financial Advisor,9317,1525,10842
5075,Katuscha,Van der Hoeven,kvanderhoeven47@nydailynews.com,Computer Systems Analyst III,5669,962,6631
5877,Maurine,Guillon,mguillon48@foxnews.com,Structural Engineer,9474,291,9765
5709,Joaquin,De Paoli,jdepaoli49@foxnews.com,Nuclear Power Engineer,7689,1125,8814
5244,Maible,Newbatt,mnewbatt4a@is.gd,Senior Financial Analyst,4701,1651,6352
5103,Marchall,Oulett,moulett4b@usda.gov,Assistant Manager,9208,386,9594
5974,Leonerd,Kitto,lkitto4c@ycombinator.com,Product Engineer,3461,1751,5212
5967,Carlye,Leaf,cleaf4d@barnesandnoble.com,Administrative Officer,3249,491,3740
5419,Aubrie,Skelington,askelington4e@tinyurl.com,Software Test Engineer III,9009,1084,10093
5014,Dietrich,Giffkins,dgiffkins4f@kickstarter.com,Librarian,2758,1934,4692
5544,Lucine,Hackney,lhackney4h@kickstarter.com,Social Worker,3052,1038,4090
5893,Mal,Artrick,martrick4i@netlog.com,Environmental Tech,7773,1301,9074
5272,Carola,Farman,cfarman4j@is.gd,Assistant Manager,2170,1530,3700
5090,Amelina,Goncaves,agoncaves4k@wikimedia.org,Design Engineer,7995,518,8513
5685,Giulio,Peye,gpeye4l@live.com,Media Manager I,2748,1394,4142
5802,Elihu,Farrand,efarrand4m@istockphoto.com,Human Resources Manager,1464,1045,2509
5521,Carlie,Djuricic,cdjuricic4n@cbslocal.com,Quality Engineer,3379,1664,5043
5466,Mommy,Wash,mwash4o@gnu.org,Marketing Assistant,6146,647,6793
5733,Konstanze,Mawman,kmawman4p@alibaba.com,Staff Accountant IV,1026,250,1276
5163,Kent,Dust,kdust4r@stanford.edu,Cost Accountant,7951,740,8691
5117,Pepillo,Shearer,pshearer4t@sitemeter.com,Senior Developer,1817,1407,3224
5339,Maxwell,Jarrard,mjarrard4u@tripadvisor.com,Structural Engineer,4314,1310,5624
5346,Nell,Shimoni,nshimoni4v@ftc.gov,Graphic Designer,2272,711,2983
5582,Sky,Kegan,skegan4w@youtu.be,Financial Advisor,6948,1455,8403
5611,Griffy,Smerdon,gsmerdon4x@shop-pro.jp,VP Marketing,9153,1707,10860
5157,Jesse,Ferrieres,jferrieres4y@multiply.com,Accounting Assistant III,6775,1216,7991
5889,Kimble,Ramsbotham,kramsbotham4z@godaddy.com,Sales Associate,5068,983,6051
5136,Evania,Shakesby,eshakesby50@mapy.cz,Administrative Assistant IV,7808,1328,9136
5924,Berkeley,Matzl,bmatzl51@spotify.com,Physical Therapy Assistant,3874,1391,5265
5278,Flory,Gillbard,fgillbard52@google.com.br,Office Assistant III,1862,251,2113
5249,Niccolo,Dinnage,ndinnage53@illinois.edu,Teacher,7532,1450,8982
5702,Karena,Charville,kcharville54@wix.com,Human Resources Assistant IV,5590,849,6439
5728,Riley,Scheffel,rscheffel55@umn.edu,Nurse Practicioner,4888,705,5593
5907,Clyve,Chopy,cchopy56@intel.com,VP Quality Control,3095,1557,4652
5523,Wheeler,Tomkins,wtomkins57@pinterest.com,Recruiting Manager,7113,1806,8919
5927,Edik,Spragg,espragg58@arstechnica.com,Environmental Specialist,6274,1787,8061
5020,Rosalinde,D'Errico,rderrico5a@uol.com.br,Geological Engineer,7960,1014,8974
5850,Tito,Feldberger,tfeldberger5b@wsj.com,Assistant Manager,2987,539,3526
5880,Ezmeralda,Gemlbett,egemlbett5c@guardian.co.uk,Media Manager I,4357,1345,5702
5334,Ede,Coade,ecoade5d@squidoo.com,Senior Cost Accountant,9341,1910,11251
5341,Hunfredo,Clutterbuck,hclutterbuck5g@comsenz.com,Senior Quality Engineer,2457,372,2829
5455,Godiva,Banford,gbanford5h@shutterfly.com,Web Designer II,6591,1363,7954
5663,Shanda,Batho,sbatho5i@liveinternet.ru,VP Product Management,2044,1448,3492
5491,Corrie,Jarville,cjarville5j@creativecommons.org,Engineer IV,9965,1274,11239
5118,Calv,Alforde,calforde5l@123-reg.co.uk,Environmental Specialist,1754,540,2294
5178,Michel,Wyles,mwyles5m@deviantart.com,Budget/Accounting Analyst I,6920,688,7608
5674,Peta,Whellans,pwhellans5o@nytimes.com,Office Assistant IV,9788,832,10620
5415,Larry,Bootell,lbootell5p@furl.net,Payment Adjustment Coordinator,5030,771,5801
5528,Gunther,Benham,gbenham5q@github.io,Account Executive,1607,1246,2853
5545,Anthiathia,Fildes,afildes5t@epa.gov,Administrative Assistant I,9434,1933,11367
5838,Bertram,Daingerfield,bdaingerfield5u@miitbeian.gov.cn,Senior Cost Accountant,4761,1072,5833
5669,Michal,Maguire,mmaguire5w@diigo.com,Graphic Designer,8835,385,9220
5823,Annis,Jakubski,ajakubski5x@yale.edu,Assistant Manager,2997,1105,4102
5069,Fernando,Witnall,fwitnall5y@google.ca,Recruiter,9784,955,10739
5172,Moselle,Howard - Gater,mhowardgater5z@angelfire.com,Accountant I,6262,1441,7703
5009,Brand,Speake,bspeake61@princeton.edu,Data Coordiator,6097,443,6540
5998,Charmine,Conrart,cconrart63@hud.gov,VP Quality Control,9069,889,9958
5132,Saraann,Greep,sgreep64@blogspot.com,Staff Accountant IV,3519,933,4452
5558,Franzen,Baynard,fbaynard65@gizmodo.com,Technical Writer,6838,1156,7994
5705,Mead,Drury,mdrury66@oakley.com,Assistant Manager,7729,972,8701
5856,Tamera,Kyngdon,tkyngdon67@si.edu,Research Associate,8861,510,9371
5576,Camey,Bansal,cbansal68@youku.com,Senior Developer,4004,1853,5857
5217,Trumaine,Fillis,tfillis69@psu.edu,Geological Engineer,5188,656,5844
5569,Nathan,Mungane,nmungane6b@vimeo.com,VP Sales,1159,1914,3073
5788,Wheeler,Bagwell,wbagwell6c@soup.io,Research Nurse,5106,1851,6957
5082,Marlow,Lutman,mlutman6d@blinklist.com,Technical Writer,2062,687,2749
5489,Clayborn,Beisley,cbeisley6f@merriam-webster.com,Dental Hygienist,2830,1338,4168
5596,Rikki,Dake,rdake6g@dedecms.com,Analyst Programmer,1936,594,2530
5541,Johna,Lung,jlung6h@forbes.com,Human Resources Assistant IV,3250,1471,4721
5460,Beale,Keyson,bkeyson6i@hhs.gov,Information Systems Manager,1641,1638,3279
5257,Ulla,MacDwyer,umacdwyer6k@timesonline.co.uk,Web Developer II,2336,569,2905
5955,Kristos,Karle,kkarle6m@nps.gov,VP Quality Control,5448,383,5831
5399,Orelie,Greneham,ogreneham6n@aol.com,Dental Hygienist,1480,577,2057
5280,Marilee,Stenner,mstenner6o@imdb.com,Geologist IV,3759,694,4453
5218,Katti,Jancso,kjancso6p@pinterest.com,Registered Nurse,8311,1115,9426
5067,Herby,Rodda,hrodda6q@ocn.ne.jp,Web Developer IV,3669,1711,5380
5653,Garner,Laybourne,glaybourne6s@xing.com,Community Outreach Specialist,9521,1653,11174
5300,Idalia,Lowdwell,ilowdwell6t@wired.com,Operator,3825,1043,4868
5360,Hestia,MacGillespie,hmacgillespie6u@time.com,VP Product Management,4854,1731,6585
5201,Dominique,Dosdale,ddosdale6v@slashdot.org,Senior Developer,2780,1307,4087
5061,Dorena,Paolozzi,dpaolozzi6x@goodreads.com,Help Desk Technician,7681,712,8393
5398,Hannie,Gresswood,hgresswood6z@jalbum.net,Legal Assistant,5705,1132,6837
5586,Barthel,Trulock,btrulock71@multiply.com,Product Engineer,9417,1687,11104
5778,Lesya,Mayman,lmayman72@ovh.net,Assistant Manager,4278,1771,6049
5251,Margaretta,Mallall,mmallall75@instagram.com,Statistician III,9284,1499,10783
5351,Reeva,Heymann,rheymann76@wisc.edu,VP Sales,8560,825,9385
5184,Abel,Okenden,aokenden77@hatena.ne.jp,Editor,7017,1993,9010
5340,Matty,Gillott,mgillott78@cpanel.net,Statistician II,6496,523,7019
5872,Lyndell,Perrin,lperrin7b@oakley.com,Internal Auditor,8501,1946,10447
5978,Nora,Taylerson,ntaylerson7d@tripadvisor.com,Web Designer IV,2095,1972,4067
5542,Dur,Canceller,dcanceller7e@mapy.cz,Recruiting Manager,9353,1894,11247
5800,Merna,Gayther,mgayther7f@vkontakte.ru,Technical Writer,5343,1181,6524
5203,Ringo,Barneville,rbarneville7g@sun.com,Sales Associate,5601,964,6565
5812,Jamison,Pozzo,jpozzo7h@yale.edu,Recruiting Manager,5202,861,6063
5490,Eberto,Oppie,eoppie7i@themeforest.net,VP Accounting,3276,1647,4923
5259,Ursula,Leap,uleap7j@netlog.com,Desktop Support Technician,2629,1690,4319
5698,Dory,Batistelli,dbatistelli7k@typepad.com,Business Systems Development Analyst,1809,1286,3095
5595,Chris,Potes,cpotes7l@salon.com,Internal Auditor,4742,979,5721
5331,Aurea,Larrett,alarrett7m@tumblr.com,Help Desk Technician,1450,1895,3345
5779,Arlie,Donaghie,adonaghie7n@theglobeandmail.com,Senior Quality Engineer,2084,1362,3446
5433,Marna,Varfolomeev,mvarfolomeev7o@imageshack.us,Research Assistant III,5756,206,5962
5604,Thadeus,Moring,tmoring7p@usatoday.com,Structural Analysis Engineer,9768,218,9986
5210,Hastings,Trigwell,htrigwell7q@sfgate.com,Research Nurse,4029,501,4530
5625,Cully,Spoors,cspoors7r@irs.gov,Nurse Practicioner,9466,1351,10817
5508,Cad,Burg,cburg7s@columbia.edu,Geological Engineer,2679,1996,4675
5456,Preston,Bockler,pbockler7t@wikipedia.org,Research Assistant IV,9267,343,9610
5350,Cross,Bealing,cbealing7v@weibo.com,Senior Developer,8249,956,9205
5600,Sigismond,Ferreri,sferreri7x@cnbc.com,Geological Engineer,1368,653,2021
5597,Chelsae,Chewter,cchewter7y@sbwire.com,Assistant Manager,3157,810,3967
5784,Patricio,Lamas,plamas82@newyorker.com,Desktop Support Technician,5576,529,6105
5352,Melvin,Duinkerk,mduinkerk83@sogou.com,Executive Secretary,4498,1399,5897
5639,Iormina,Eyles,ieyles84@miitbeian.gov.cn,Account Representative III,2030,1500,3530
5992,Jarib,Northam,jnortham86@wunderground.com,Structural Analysis Engineer,1623,594,2217
5143,Christye,Derle,cderle87@reuters.com,Senior Financial Analyst,9642,596,10238
5980,Arv,Northcote,anorthcote8a@livejournal.com,Dental Hygienist,5448,1554,7002
5985,Ritchie,Hawkeswood,rhawkeswood8b@de.vu,Dental Hygienist,1871,1173,3044
5448,Allister,Scoble,ascoble8c@examiner.com,Help Desk Technician,3780,547,4327
5302,Laurice,Cruden,lcruden8d@sogou.com,Civil Engineer,4853,1163,6016
5389,Kassandra,Waryk,kwaryk8e@meetup.com,Electrical Engineer,2161,268,2429
5522,Reinold,Lyddiatt,rlyddiatt8f@fc2.com,Safety Technician IV,7130,1453,8583
5886,Nevsa,Leathlay,nleathlay8h@fotki.com,Accounting Assistant IV,7944,1016,8960
5483,Imelda,Cases,icases8j@businessweek.com,Payment Adjustment Coordinator,9365,671,10036
5492,Ros,Morl,rmorl8k@163.com,Media Manager II,8449,400,8849
5258,Moore,MacNeil,mmacneil8l@people.com.cn,Accounting Assistant II,8124,780,8904
5042,Davidson,Izakov,dizakov8m@pen.io,Software Engineer I,5465,1551,7016
5984,Nettle,Proback,nproback8o@bandcamp.com,Actuary,1169,830,1999
5598,Stanly,Barnsdall,sbarnsdall8p@spotify.com,Paralegal,1371,664,2035
5833,Vachel,Finn,vfinn8q@aol.com,Environmental Tech,6478,606,7084
5099,Anders,Ghelerdini,aghelerdini8r@yahoo.co.jp,General Manager,3972,548,4520
5096,Dehlia,Trendle,dtrendle8s@hud.gov,Design Engineer,4240,1509,5749
5577,Reid,Smuth,rsmuth8u@hugedomains.com,Account Executive,5257,440,5697
5023,Catherin,Houlston,choulston8w@admin.ch,Programmer Analyst II,8671,1175,9846
5738,Yolanthe,Alejandre,yalejandre8x@taobao.com,Librarian,7605,1087,8692
5841,Ambrosi,Aylwin,aaylwin8y@fotki.com,Structural Analysis Engineer,5211,509,5720
5410,Cindee,Watts,cwatts8z@multiply.com,Food Chemist,7320,487,7807
5392,Riva,Bewsey,rbewsey90@hubpages.com,Web Designer I,4440,1998,6438
5605,Alvin,Rao,arao92@theguardian.com,Structural Engineer,9205,1532,10737
5216,Mollee,Tadd,mtadd93@github.io,Programmer II,9360,436,9796
5481,Ronni,Readwing,rreadwing94@mtv.com,Programmer Analyst IV,8214,1278,9492
5133,Ramon,Bosdet,rbosdet96@yelp.com,Desktop Support Technician,6423,679,7102
5382,Finlay,Piddington,fpiddington97@yahoo.co.jp,Account Representative III,5458,1627,7085
5159,Khalil,Oxnam,koxnam98@google.co.uk,Desktop Support Technician,3454,396,3850
5284,Phil,O'Hoolahan,pohoolahan9a@fc2.com,Health Coach IV,1810,1221,3031
5510,Cyril,Killelea,ckillelea9c@archive.org,Health Coach I,7393,1087,8480
5088,Camile,Bissex,cbissex9d@un.org,VP Product Management,6264,580,6844
5343,Madlin,Duckering,mduckering9g@lycos.com,Safety Technician IV,8983,836,9819
5499,Caritta,Zuppa,czuppa9h@scientificamerican.com,Operator,3729,458,4187
5294,Erroll,Eastlake,eeastlake9j@yahoo.co.jp,Business Systems Development Analyst,6655,790,7445
5822,Wheeler,Bidewel,wbidewel9k@youtube.com,Administrative Officer,3554,1263,4817
5921,Ambrose,Culy,aculy9l@pbs.org,Chief Design Engineer,9968,319,10287
5368,Shelby,Oloman,soloman9m@dagondesign.com,Budget/Accounting Analyst III,8314,1938,10252
5423,Wat,Aspinwall,waspinwall9n@wikia.com,Mechanical Systems Engineer,3387,757,4144
5503,Beulah,Gervaise,bgervaise9p@redcross.org,Librarian,6262,1359,7621
5770,Sid,Petre,spetre9q@linkedin.com,Tax Accountant,1117,1999,3116
5796,Laurie,Laborda,llaborda9r@ucoz.ru,Help Desk Technician,3056,1493,4549
5289,Tandi,Renn,trenn9t@furl.net,Senior Editor,7913,1051,8964
5079,Giralda,Beedom,gbeedom9u@mapquest.com,Cost Accountant,4667,243,4910
5498,Hildagarde,Dourin,hdourin9v@usatoday.com,Chief Design Engineer,3314,736,4050
5268,Brit,McVeagh,bmcveagh9w@nps.gov,Chief Design Engineer,1588,1503,3091
5158,Maddie,Bartolacci,mbartolacci9x@comsenz.com,Senior Developer,1068,790,1858
5220,Debra,Imlaw,dimlaw9z@irs.gov,Senior Sales Associate,5874,601,6475
5146,Belva,Warters,bwartersa1@istockphoto.com,Health Coach II,4868,1470,6338
5664,Maximilien,Skoate,mskoatea2@ezinearticles.com,Computer Systems Analyst III,5069,1375,6444
5235,Brendan,Klazenga,bklazengaa3@dyndns.org,Database Administrator II,8074,1802,9876
5820,Dore,Burt,dburta4@cbsnews.com,Engineer IV,2545,1412,3957
5684,Karoly,Badland,kbadlanda5@redcross.org,Quality Engineer,3172,1803,4975
5469,Shirleen,Lodden,sloddena7@instagram.com,Web Designer IV,7453,892,8345
5910,Estel,Rawsthorne,erawsthornea8@elpais.com,Civil Engineer,5541,1667,7208
5054,Eberhard,Cutriss,ecutrissa9@google.com.br,Office Assistant III,8905,1369,10274
5957,Arabele,Danniel,adannielaa@mail.ru,Registered Nurse,5606,369,5975
5032,Quincy,Hurd,qhurdac@mozilla.com,Payment Adjustment Coordinator,9108,524,9632
5447,Sally,Lakey,slakeyad@sakura.ne.jp,Cost Accountant,2166,780,2946
5089,Xerxes,Poultney,xpoultneyae@home.pl,Assistant Manager,4815,1135,5950
5264,Dudley,Rasmus,drasmusaf@nymag.com,VP Product Management,5656,1917,7573
5179,Zacharia,Santos,zsantosag@reddit.com,Software Consultant,2104,1265,3369
5033,Fernando,Savile,fsavileah@networkadvertising.org,Environmental Tech,1849,422,2271
5271,Wilt,Ritmeier,writmeieraj@pen.io,Engineer II,9733,1235,10968
5747,Marika,Stanion,mstanionak@ocn.ne.jp,Biostatistician I,5547,1866,7413
5248,Gan,Bosch,gboscham@4shared.com,Research Associate,2782,383,3165
5247,Olly,Colliver,ocolliveran@ox.ac.uk,Statistician I,9274,952,10226
5932,Lidia,Swadden,lswaddenao@e-recht24.de,Senior Developer,7536,1261,8797
5436,Suzette,Glassborow,sglassborowaq@smh.com.au,Legal Assistant,8375,304,8679
5288,Winifred,Gherardesci,wgherardescias@joomla.org,Financial Advisor,5692,1954,7646
5230,Savina,Richter,srichterat@examiner.com,Geologist I,8824,731,9555
5411,Othilia,Bankes,obankesau@usa.gov,Senior Editor,4937,1928,6865
5405,Tommy,Ottosen,tottosenav@google.es,Technical Writer,1689,1269,2958
5640,Frannie,Jaggard,fjaggardaw@exblog.jp,Speech Pathologist,7463,341,7804
5753,Johnna,Kleszinski,jkleszinskiax@sourceforge.net,Automation Specialist IV,9777,998,10775
5379,Cairistiona,Camplejohn,ccamplejohnb2@census.gov,Executive Secretary,2058,1693,3751
5703,Rafi,Clover,rcloverb3@desdev.cn,Media Manager IV,3562,754,4316
5965,Zelda,Saunton,zsauntonb5@constantcontact.com,Speech Pathologist,5463,379,5842
5547,Vinita,Haet,vhaetb6@smh.com.au,Safety Technician III,2778,1761,4539
5148,Marielle,Lightwing,mlightwingb7@ox.ac.uk,Professor,4444,641,5085
5395,Durward,Allday,dalldayb9@shutterfly.com,Structural Engineer,9596,825,10421
5531,Natalya,Stuckey,nstuckeyba@zimbio.com,Social Worker,7706,1996,9702
5908,Leena,Yakubov,lyakubovbd@g.co,Marketing Manager,7850,1138,8988
5826,Lilas,Bauduccio,lbauducciobe@freewebs.com,Software Test Engineer III,2150,1478,3628
5707,Stesha,Babbidge,sbabbidgebf@google.com,Junior Executive,6402,1089,7491
5638,Nil,Shawyers,nshawyersbg@vinaora.com,VP Accounting,3767,494,4261
5401,Ginger,Swait,gswaitbj@usnews.com,Staff Scientist,3338,1750,5088
5114,Goddart,Strood,gstroodbp@barnesandnoble.com,Nurse Practicioner,3033,272,3305
5681,Dosi,Sherwill,dsherwillbq@360.cn,VP Marketing,4717,1798,6515
5328,Cairistiona,Ruslin,cruslinbr@dyndns.org,Account Executive,1092,1200,2292
5108,Gibb,Laxston,glaxstonbs@java.com,Assistant Media Planner,4289,483,4772
5005,Eada,Gook,egookbu@posterous.com,Programmer Analyst II,4035,1076,5111
5555,Byran,Chadwen,bchadwenbv@google.com,Payment Adjustment Coordinator,2909,1716,4625
5668,Yoshi,Cummine,ycumminebw@nps.gov,Research Associate,2550,354,2904
5336,Skippie,Percifer,sperciferbx@amazonaws.com,Programmer II,3021,592,3613
5275,Avis,Spickett,aspickettby@zdnet.com,Health Coach III,5184,1740,6924
5793,Jae,Castillou,jcastillouc0@microsoft.com,Account Representative IV,3468,1795,5263
5028,Kizzie,Gascone,kgasconec3@printfriendly.com,Junior Executive,5409,780,6189
5122,Hewitt,Alleburton,halleburtonc4@taobao.com,Staff Accountant I,7644,1215,8859
5053,Hewie,Pettifer,hpettiferc6@nhs.uk,Professor,1956,1057,3013
5308,Haven,Bridgewater,hbridgewaterc8@imdb.com,Research Nurse,8894,747,9641
5529,Nathalia,Kumaar,nkumaarc9@jugem.jp,Information Systems Manager,7323,1338,8661
5301,Cort,Mushawe,cmushaweca@unicef.org,Clinical Specialist,6167,1273,7440
5269,Edie,Osban,eosbancc@ox.ac.uk,Tax Accountant,4370,1617,5987
5097,Christiana,Caesmans,ccaesmanscg@washington.edu,Sales Representative,7366,875,8241
5659,Jervis,Maben,jmabench@time.com,Programmer I,6424,1642,8066
5091,Janeczka,Shapland,jshaplandci@sohu.com,Project Manager,8520,688,9208
5617,Darb,Scambler,dscamblercj@ycombinator.com,Account Coordinator,9334,832,10166
5039,Cora,Toten,ctotenck@abc.net.au,Actuary,9131,1564,10695
5129,Stanislaus,Reignould,sreignouldcl@flickr.com,Software Engineer IV,6861,1811,8672
5862,Amara,Stollmeyer,astollmeyercm@arstechnica.com,Tax Accountant,8672,1238,9910
5557,Maisey,Fulle,mfullecn@marketwatch.com,Electrical Engineer,7480,1970,9450
5214,Lacey,Sandall,lsandallco@cornell.edu,VP Marketing,8184,631,8815
5631,Nicol,Crossby,ncrossbycp@yelp.com,Recruiter,9221,965,10186
5391,Brooke,Hendrickson,bhendricksoncq@wikispaces.com,Budget/Accounting Analyst I,2460,1752,4212
5824,Elena,Pawlett,epawlettcs@unc.edu,Electrical Engineer,5088,1688,6776
5772,Edin,Maddie,emaddiect@google.com,Administrative Assistant III,7984,670,8654
5056,Blane,Mockler,bmocklercv@bizjournals.com,Nurse,9714,282,9996
5434,Cyril,Haward,chawardcw@google.es,Community Outreach Specialist,6134,309,6443
5374,Lucilia,Pidgen,lpidgency@github.io,Teacher,8032,808,8840
5465,Karry,Vyse,kvysecz@usatoday.com,Engineer IV,7939,1852,9791
5701,Gareth,Challiner,gchallinerd0@mit.edu,Account Executive,9418,1980,11398
5333,Alfi,McVie,amcvied2@plala.or.jp,Registered Nurse,6923,1735,8658
5420,Cinda,Aloigi,caloigid3@hao123.com,Design Engineer,2031,1958,3989
5480,Jourdain,Roney,jroneyd4@house.gov,Pharmacist,5445,279,5724
5706,Hayden,Teather,hteatherd5@google.co.jp,Health Coach I,9081,1660,10741
5160,Gunner,Somes,gsomesd6@barnesandnoble.com,Legal Assistant,6663,1936,8599
5518,Jake,Waldram,jwaldramd8@google.co.uk,Internal Auditor,2641,1008,3649
5716,Wakefield,Oxlade,woxladeda@google.fr,Staff Scientist,9318,1111,10429
5140,Tim,Bernardelli,tbernardellidd@shinystat.com,Speech Pathologist,5378,1307,6685
5110,Huntington,Lewsam,hlewsamde@globo.com,Automation Specialist III,2551,916,3467
5888,Ailbert,Girvan,agirvandf@slideshare.net,Registered Nurse,4645,1257,5902
5866,Angil,MacCart,amaccartdg@nps.gov,Accountant I,5461,1189,6650
5232,Inge,Lince,ilincedj@cnet.com,Editor,5726,1587,7313
5900,Jaquelyn,Warrier,jwarrierdk@barnesandnoble.com,Professor,8550,406,8956
5015,Miquela,Bogey,mbogeydl@sina.com.cn,Analog Circuit Design manager,9936,560,10496
5234,Lukas,Rivaland,lrivalanddo@home.pl,Editor,3348,1975,5323
5138,Abner,Babidge,ababidgedp@cafepress.com,Developer I,1747,642,2389
5934,Alf,Runchman,arunchmandq@ed.gov,Internal Auditor,4088,349,4437
5996,Sula,Fansy,sfansydt@ebay.com,Chemical Engineer,6978,877,7855
5063,Syd,Hinnerk,shinnerkdu@tumblr.com,Teacher,9245,806,10051
5564,Editha,Capel,ecapeldv@desdev.cn,Software Consultant,6492,436,6928
5803,Kerri,Hymans,khymansdw@fda.gov,Occupational Therapist,8050,306,8356
5445,Peterus,Phillcock,pphillcockdy@nba.com,Community Outreach Specialist,4362,1735,6097
5721,Gunther,MacArthur,gmacarthurdz@studiopress.com,Cost Accountant,5098,590,5688
5731,Maje,Feldon,mfeldone0@behance.net,Information Systems Manager,5788,666,6454
5065,Candide,Crosswaite,ccrosswaitee1@shareasale.com,Software Test Engineer III,5950,1738,7688
5345,Winn,Guppy,wguppye2@blogspot.com,Web Developer IV,9736,1464,11200
5943,Donna,Skone,dskonee4@statcounter.com,Sales Representative,6330,1703,8033
5449,Charlie,Hughs,chughse5@dailymotion.com,Analog Circuit Design manager,7833,1051,8884
5025,Thebault,Kinchlea,tkinchleae7@buzzfeed.com,Human Resources Manager,9459,1740,11199
5123,Marnie,Mokes,mmokesea@earthlink.net,Business Systems Development Analyst,3918,864,4782
5692,Sarah,Schonfelder,sschonfeldereb@booking.com,Biostatistician IV,9653,1759,11412
5603,Hagan,Urian,hurianec@domainmarket.com,Administrative Assistant II,4012,1133,5145
5034,Paige,Lightbody,plightbodyed@state.gov,Account Coordinator,2226,1714,3940
5168,Morena,Richter,mrichteree@theguardian.com,Geologist III,4633,1310,5943
5369,Ralph,Kench,rkenchef@columbia.edu,Database Administrator III,1064,599,1663
5732,Florina,Canfield,fcanfieldeh@netvibes.com,VP Sales,9663,1125,10788
5442,Lori,Mercer,lmercerej@plala.or.jp,Database Administrator II,5665,1168,6833
5630,Brien,Camillo,bcamilloek@hexun.com,Accountant II,4030,569,4599
5613,Bev,Cherry,bcherryem@ox.ac.uk,Occupational Therapist,8806,1624,10430
5859,Kelley,Pym,kpymen@alexa.com,Help Desk Operator,5953,308,6261
5860,Freedman,Bruyntjes,fbruyntjeseo@etsy.com,Health Coach IV,6286,1173,7459
5243,Jacquette,Rumbold,jrumboldep@shareasale.com,Accountant IV,5015,911,5926
5413,Mason,Munning,mmunninger@twitpic.com,Biostatistician II,7997,928,8925
5064,Vitia,Pfaff,vpfaffes@mediafire.com,Biostatistician I,5052,1630,6682
5573,Yolane,Dunlap,ydunlapet@shutterfly.com,Accountant I,8370,1858,10228
5543,Flint,Livezey,flivezeyeu@intel.com,Automation Specialist IV,6414,635,7049
5720,Tiena,Trevaskiss,ttrevaskissev@hugedomains.com,Web Developer III,8140,1667,9807
5115,Maggee,Dmitrovic,mdmitrovicew@posterous.com,Engineer III,7031,1728,8759
5852,Xerxes,Sibbert,xsibbertex@jugem.jp,Human Resources Assistant IV,8343,1835,10178
5464,Othelia,Karmel,okarmeley@cnbc.com,Administrative Officer,3442,979,4421
5679,Tanner,Orth,torthf0@etsy.com,Environmental Tech,1279,1476,2755
5076,Claudell,Brooker,cbrookerf1@desdev.cn,Graphic Designer,4778,343,5121
5043,Kimberli,Cokely,kcokelyf2@kickstarter.com,Nuclear Power Engineer,7742,1663,9405
5228,Steward,Valti,svaltif3@adobe.com,Nurse Practicioner,8957,995,9952
5574,Alisa,Rowdell,arowdellf5@joomla.org,Chemical Engineer,8729,1109,9838
5246,Carling,Weymont,cweymontf9@newsvine.com,Associate Professor,3816,1073,4889
5864,Gabbi,Brigshaw,gbrigshawfe@163.com,General Manager,6654,1440,8094
5615,George,Clemot,gclemotfj@jiathis.com,Nurse,6257,1203,7460
5756,Belicia,Woehler,bwoehlerfk@ezinearticles.com,Cost Accountant,3046,566,3612
5330,Rasla,Lockery,rlockeryfl@arstechnica.com,Technical Writer,5657,955,6612
5840,Verna,Dobbing,vdobbingfn@census.gov,Design Engineer,7440,522,7962
5548,Maxy,Kirgan,mkirganfo@usgs.gov,Director of Sales,7829,1796,9625
5487,Normy,Kernley,nkernleyfx@sogou.com,Operator,5949,620,6569
5204,Ame,Strettell,astrettellfy@hubpages.com,Chief Design Engineer,9533,263,9796
5951,Duffie,Babidge,dbabidgeg0@prnewswire.com,Accounting Assistant IV,3870,1625,5495
5169,Saundra,Kitteman,skittemang1@vistaprint.com,Paralegal,6025,1969,7994
5059,Bat,Saterweyte,bsaterweyteg3@lycos.com,Quality Control Specialist,6564,1466,8030
5532,Wynn,Kment,wkmentg6@4shared.com,Recruiting Manager,4385,1576,5961
5535,Vladimir,Wolters,vwoltersg7@topsy.com,Systems Administrator I,3134,551,3685
5229,Cortie,Jopson,cjopsonga@sina.com.cn,Assistant Professor,2457,1561,4018
5112,Gwendolin,Rucklidge,grucklidgegb@theatlantic.com,VP Accounting,1048,881,1929
5844,Dani,Mabb,dmabbgc@amazonaws.com,Geologist II,6884,1829,8713
5964,Bari,Crombleholme,bcrombleholmegd@goo.gl,Safety Technician III,5788,461,6249
5245,Gert,Stackbridge,gstackbridgege@barnesandnoble.com,Account Representative II,5839,1145,6984
5362,Daisy,Parell,dparellgf@globo.com,Mechanical Systems Engineer,6779,620,7399
5030,Ardisj,Nicolls,anicollsgm@ycombinator.com,Administrative Assistant IV,8450,950,9400
5686,Almire,Joanaud,ajoanaudgn@e-recht24.de,Paralegal,6716,1833,8549
5563,Gusti,Ide,gidegq@google.co.uk,Librarian,7470,950,8420
5633,Demetre,Reightley,dreightleygr@discuz.net,Structural Analysis Engineer,7527,1513,9040
5092,Candi,Barbier,cbarbiergs@virginia.edu,Paralegal,8957,1651,10608
5459,Artair,Yelyashev,ayelyashevgt@cyberchimps.com,Clinical Specialist,8899,974,9873
5871,Sibilla,Tingly,stinglygu@ted.com,Speech Pathologist,7254,927,8181
5267,Petronella,Widdop,pwiddopgv@ebay.com,Business Systems Development Analyst,3357,1811,5168
5601,Jay,Tilne,jtilnegx@census.gov,Director of Sales,7170,1767,8937
5381,Tabitha,McKaile,tmckailegy@microsoft.com,Food Chemist,7732,519,8251
5017,Dolley,Willcock,dwillcockh3@hc360.com,Mechanical Systems Engineer,8913,1860,10773
5682,Abigail,Zanre,azanreh4@google.com,Automation Specialist I,3873,1165,5038
5212,Wilhelmine,Johansson,wjohanssonh6@ning.com,Structural Engineer,5188,1359,6547
5599,Raynell,Pidcock,rpidcockh8@addtoany.com,Media Manager II,3922,1134,5056
5937,Brita,Gillions,bgillionsha@liveinternet.ru,Tax Accountant,3308,1659,4967
5891,Leela,Zeale,lzealehc@umn.edu,Safety Technician IV,5195,1486,6681
5141,Payton,York,pyorkhe@simplemachines.org,Social Worker,3436,771,4207
5058,Antonio,Graham,agrahamhh@constantcontact.com,Software Consultant,6864,204,7068
5085,Rachel,Kennady,rkennadyhj@1688.com,Accountant III,4282,1275,5557
5316,Edith,Pallent,epallenthk@homestead.com,Information Systems Manager,2624,1145,3769
5036,Danni,Titcomb,dtitcombhm@wix.com,Research Nurse,6361,226,6587
5874,Ange,Kingett,akingetthn@google.com,Design Engineer,5830,1895,7725
5051,Alleyn,Gomez,agomezhp@google.ca,Nurse Practicioner,8490,1342,9832
5111,Maryjo,Rushworth,mrushworthhr@nhs.uk,Information Systems Manager,1003,1362,2365
5167,Abra,Hrycek,ahrycekhw@cafepress.com,Safety Technician III,6651,1904,8555
5881,Winny,Arends,warendshz@usnews.com,VP Quality Control,3209,987,4196
5581,Egor,Reymers,ereymersi0@ehow.com,Teacher,2873,517,3390
5281,Kelvin,Satyford,ksatyfordi1@desdev.cn,Food Chemist,8737,474,9211
5768,Idell,Solomonides,isolomonidesi2@nih.gov,Senior Financial Analyst,2981,592,3573
5922,Dulcie,Lebell,dlebelli4@kickstarter.com,Dental Hygienist,2053,1245,3298
5317,Bernadina,Dupree,bdupreei6@e-recht24.de,Senior Financial Analyst,5258,816,6074
5174,Gerry,Gudgion,ggudgioni7@umn.edu,Human Resources Assistant I,6942,1766,8708
5765,Glendon,Ellicock,gellicockia@wikia.com,Junior Executive,5942,1579,7521
5049,Burlie,Hebborn,bhebbornib@xrea.com,VP Sales,7071,1343,8414
5827,Sylas,Spracklin,sspracklinic@ucoz.ru,Occupational Therapist,2755,243,2998
5912,Mindy,Gouinlock,mgouinlockie@nbcnews.com,Software Consultant,9187,1441,10628
5575,Bobbette,Sherman,bshermanif@google.de,Nuclear Power Engineer,7747,1709,9456
5496,Laney,Ringham,lringhamii@imgur.com,Software Engineer III,7138,1869,9007
5690,Cass,Opdenorth,copdenorthim@livejournal.com,Automation Specialist III,7262,1283,8545
5031,Rosabella,Eddowis,reddowisin@cnet.com,Associate Professor,8151,1686,9837
5181,Lyn,Levin,llevinip@infoseek.co.jp,Engineer I,9081,1131,10212
5809,Shaw,Limbert,slimbertiq@amazon.de,Tax Accountant,9134,869,10003
5446,Merill,Heephy,mheephyit@a8.net,Paralegal,1369,1656,3025
5654,Tybalt,Finlater,tfinlateriu@google.es,Recruiter,1869,1554,3423
5583,Jerrie,Morefield,jmorefieldiw@pagesperso-orange.fr,Actuary,8944,1699,10643
5914,Jinny,Canon,jcanonj3@miitbeian.gov.cn,Web Developer I,5789,930,6719
5950,Jillana,Kopf,jkopfj5@bravesites.com,Analyst Programmer,8356,810,9166
5552,Hermina,Di Batista,hdibatistaj7@desdev.cn,Systems Administrator III,8494,330,8824
5759,Milena,Scatchar,mscatcharj8@pinterest.com,VP Marketing,9315,1088,10403
5749,Jean,Caps,jcapsj9@imdb.com,VP Marketing,4755,1206,5961
5370,Amil,Schimonek,aschimonekjh@hhs.gov,Technical Writer,1910,1567,3477
5933,Ashien,Kumaar,akumaarjj@ning.com,Assistant Media Planner,1055,1069,2124
5993,Rinaldo,Thornhill,rthornhilljk@merriam-webster.com,Research Assistant III,9013,1787,10800
5858,Ichabod,Gravet,igravetjl@dailymail.co.uk,Geological Engineer,3599,595,4194
5869,Sophia,Geard,sgeardjm@myspace.com,Graphic Designer,2581,292,2873
5197,Trevor,Furlonge,tfurlongejo@is.gd,Web Designer I,1935,613,2548
5592,Sol,Geram,sgeramjp@privacy.gov.au,Editor,1273,1292,2565
5972,Guglielmo,Rens,grensjr@last.fm,Accountant III,5578,702,6280
5342,Aldo,Broszkiewicz,abroszkiewiczjs@ucoz.ru,Software Engineer III,8732,880,9612
5797,Sharron,Rivlin,srivlinju@privacy.gov.au,VP Quality Control,4179,1214,5393
5953,Zacharias,Dinsmore,zdinsmorejx@dailymotion.com,Social Worker,1921,902,2823
5153,Dona,Orsi,dorsijz@myspace.com,Software Consultant,9014,1838,10852
5632,Gideon,Skey,gskeyk1@techcrunch.com,Compensation Analyst,2379,1013,3392
5667,Lurlene,Haskew,lhaskewk2@sphinn.com,Software Engineer I,6883,300,7183
5209,Rip,McGray,rmcgrayk4@narod.ru,Account Representative IV,5761,1789,7550
5903,Nert,Edgington,nedgingtonk5@techcrunch.com,Civil Engineer,3400,588,3988
5766,Tymon,Fanton,tfantonk7@wired.com,Data Coordiator,6761,853,7614
5312,Meggy,Brundill,mbrundillk8@google.it,Geologist IV,3219,1572,4791
5915,Kirstyn,Perdue,kperdueka@myspace.com,Accountant II,3525,914,4439
5194,Beverie,Vaux,bvauxkd@usnews.com,Health Coach III,5332,550,5882
5093,Ketty,Lavin,klavinke@netvibes.com,VP Sales,4918,783,5701
5550,Janet,Quarles,jquarleskf@wunderground.com,Administrative Officer,8358,708,9066
5400,Bell,Occleshaw,boccleshawkg@wix.com,Compensation Analyst,1887,1912,3799
5205,Carolina,Fryman,cfrymankh@stumbleupon.com,Tax Accountant,4416,1060,5476
5048,Stavro,Miere,smierekj@drupal.org,Research Assistant I,8701,522,9223
5673,Raynor,Affuso,raffusokp@yahoo.co.jp,Sales Associate,3348,339,3687
5154,Ninnetta,Scorthorne,nscorthornekq@globo.com,Programmer III,6691,487,7178
5274,Griffie,Stutter,gstutterks@meetup.com,GIS Technical Architect,3841,1753,5594
5406,Heywood,Counihan,hcounihanky@java.com,Quality Control Specialist,9366,1411,10777
5885,Allie,Frisch,afrischkz@scientificamerican.com,Financial Analyst,3333,1989,5322
5794,Carma,Grills,cgrillsl2@bbb.org,Internal Auditor,1382,862,2244
5185,Lind,Chifney,lchifneyl3@1688.com,Senior Sales Associate,9710,1261,10971
5254,Wright,Folshom,wfolshoml4@elegantthemes.com,Junior Executive,5366,1378,6744
5041,Clayborn,Tinan,ctinanl6@squarespace.com,Electrical Engineer,3672,1687,5359
5730,Gay,Pudden,gpuddenl8@arstechnica.com,Accounting Assistant IV,9115,1085,10200
5156,Eddie,Howel,ehowell9@myspace.com,Database Administrator III,3714,752,4466
5486,Sandro,Clixby,sclixbylb@flavors.me,Paralegal,6089,1148,7237
5326,Corbett,Mulrooney,cmulrooneyld@pen.io,Senior Cost Accountant,7467,476,7943
5402,Allys,Martijn,amartijnlh@wix.com,Compensation Analyst,3503,1944,5447
5949,Cristal,Connichie,cconnichiell@telegraph.co.uk,Mechanical Systems Engineer,2042,957,2999
5021,Barth,Pocock,bpococklr@theatlantic.com,Pharmacist,2728,720,3448
5534,Sascha,Megarry,smegarrylt@devhub.com,Business Systems Development Analyst,1486,844,2330
5383,Arlana,Brobeck,abrobecklv@seattletimes.com,Associate Professor,1832,1618,3450
5744,Llewellyn,Pinkie,lpinkielw@home.pl,GIS Technical Architect,4037,899,4936
5801,Lotta,Jakubiak,ljakubiaklx@bloomberg.com,Structural Engineer,2778,1988,4766
5683,Audry,Gladebeck,agladebeckly@github.com,Safety Technician I,7140,456,7596
5183,Fairfax,Kanwell,fkanwellm1@state.tx.us,GIS Technical Architect,5467,413,5880
5567,Lynde,Synder,lsynderm6@google.de,Biostatistician IV,2122,1155,3277
5050,Giulia,Jellicorse,gjellicorsem8@booking.com,Senior Editor,8114,650,8764
5805,Alexa,Tremeer,atremeerm9@cbc.ca,Safety Technician III,9055,1673,10728
5623,Kacey,Oldnall,koldnallma@weather.com,Human Resources Assistant II,7082,512,7594
5622,Amalita,Portwaine,aportwainemb@hp.com,Environmental Tech,5823,1840,7663
5642,Dyann,Potten,dpottenmg@infoseek.co.jp,Account Coordinator,8675,306,8981
5422,Andrej,Squelch,asquelchmj@accuweather.com,Legal Assistant,6248,1413,7661
5457,Rebekah,Kynastone,rkynastonemp@wordpress.com,Senior Quality Engineer,6478,1272,7750
5537,Adair,Hizir,ahizirmq@latimes.com,Senior Quality Engineer,2833,971,3804
5589,Tisha,Konerding,tkonerdingmt@skype.com,Computer Systems Analyst II,9425,430,9855
5662,Margalit,Niesegen,mniesegenmv@zdnet.com,Database Administrator I,1445,311,1756
5742,Ches,Polini,cpolinimy@msn.com,Senior Developer,6845,1033,7878
5714,Phil,Ritmeier,pritmeiern3@twitpic.com,Staff Accountant II,8695,546,9241
5102,Shandeigh,Bridat,sbridatn5@elpais.com,Chief Design Engineer,6353,1787,8140
5077,Harmonia,Cloy,hcloyn6@ycombinator.com,Dental Hygienist,8764,1357,10121
5094,Audra,Ewestace,aewestacenb@ifeng.com,Chief Design Engineer,4313,1294,5607
5120,Lamond,Duham,lduhamnd@indiegogo.com,GIS Technical Architect,4299,378,4677
5995,Holt,Camlin,hcamlinne@google.com,Automation Specialist III,3184,623,3807
5313,Andrus,Pfeffer,apfefferng@buzzfeed.com,Registered Nurse,8773,1883,10656
5372,Viva,Attew,vattewnh@hugedomains.com,Structural Engineer,9713,240,9953
5365,Annora,Orae,aoraenj@ycombinator.com,Office Assistant II,9593,750,10343
5628,Gil,Clurow,gclurownk@wikispaces.com,Senior Editor,1882,500,2382
5524,Mason,Whiteland,mwhitelandnm@nps.gov,Chemical Engineer,5773,1779,7552
5472,Sacha,Skule,sskulenr@omniture.com,Dental Hygienist,1612,415,2027
5393,Hubie,Batts,hbattsnt@google.com.au,Assistant Media Planner,5991,1820,7811
5935,Kevon,Gloster,kglosternx@latimes.com,Chief Design Engineer,7056,600,7656
5315,Drucy,Fery,dferyny@toplist.cz,Design Engineer,5481,761,6242
5297,Mead,Franz,mfranznz@scribd.com,Assistant Manager,6309,972,7281
5152,Ransell,MacVaugh,rmacvaugho0@nps.gov,Safety Technician III,5488,1370,6858
5002,Worden,Lumox,wlumoxo3@hatena.ne.jp,Senior Sales Associate,8165,1039,9204
5807,Blithe,Wrigglesworth,bwriggleswortho4@clickbank.net,Geologist III,4885,1569,6454
5746,Laurie,Rampling,lramplingo6@xinhuanet.com,Systems Administrator IV,2902,415,3317
5546,Perkin,Lysaght,plysaghto9@constantcontact.com,VP Accounting,8767,1070,9837
5533,Adolpho,Gerlts,agerltsob@fastcompany.com,Speech Pathologist,1795,1907,3702
5396,Cristal,Shirrell,cshirrellod@rambler.ru,Quality Engineer,5447,1774,7221
5384,Mommy,Donat,mdonatoi@abc.net.au,Senior Editor,9057,650,9707
5511,Dacie,Behling,dbehlingok@bing.com,Environmental Tech,1960,371,2331
5641,Janeta,Hayhoe,jhayhoeom@google.ru,Senior Editor,7431,1354,8785
5439,Seline,Hew,shewor@trellian.com,Programmer Analyst IV,4321,1370,5691
5299,Nona,Daft,ndaftov@wordpress.com,Information Systems Manager,8919,1329,10248
5931,Ame,Romain,aromainow@yelp.com,Assistant Professor,4614,322,4936
5147,Aylmer,McCarver,amccarveroy@wikipedia.org,Research Associate,2004,1005,3009
5799,Syd,Ryde,srydeoz@cafepress.com,VP Product Management,9688,1395,11083
5588,Alex,Gaucher,agaucherp0@bloglovin.com,VP Quality Control,5527,1296,6823
5970,Dredi,Pinder,dpinderp2@surveymonkey.com,Software Test Engineer I,2376,1381,3757
5441,Tallie,Churchin,tchurchinpb@studiopress.com,Account Executive,4187,1578,5765
5717,Gui,Di Pietro,gdipietropf@sbwire.com,VP Accounting,4541,690,5231
5494,Eirena,Bowller,ebowllerpg@cisco.com,Product Engineer,8334,1117,9451
5898,Robin,Kitchin,rkitchinph@php.net,Occupational Therapist,6494,1304,7798
5727,Mose,Barke,mbarkepj@macromedia.com,VP Quality Control,5320,1661,6981
5233,Kim,Govern,kgovernpk@google.com.br,Associate Professor,3231,347,3578
5694,Killie,Chandlar,kchandlarpo@newsvine.com,Community Outreach Specialist,8495,632,9127
5044,Liva,Antonin,lantoninpp@icio.us,Data Coordiator,4213,1417,5630
5458,Brigg,Bratcher,bbratcherpq@alexa.com,Associate Professor,6631,511,7142
5263,Arman,Gaiter,agaiterpy@skype.com,Business Systems Development Analyst,3271,1545,4816
5307,Ahmed,Youles,ayoulesq1@spiegel.de,Cost Accountant,3852,1619,5471
5999,Joel,Toppin,jtoppinq2@arstechnica.com,Assistant Media Planner,8762,1095,9857
5977,Emma,Ellul,eellulq5@nationalgeographic.com,Staff Accountant III,3117,444,3561
5530,Titos,Cleeves,tcleevesq8@phpbb.com,Quality Control Specialist,5354,348,5702
5473,Rora,Hynam,rhynamq9@guardian.co.uk,VP Accounting,6947,1810,8757
5359,Priscella,Kerrigan,pkerriganqd@cmu.edu,Human Resources Assistant II,7693,734,8427
5425,Obie,Titley,otitleyqf@nbcnews.com,Chief Design Engineer,7339,836,8175
5165,Ty,Gheeorghie,tgheeorghieqi@lycos.com,VP Quality Control,1389,1244,2633
5304,Abramo,Furmston,afurmstonqo@boston.com,Research Nurse,7078,512,7590
5754,Van,Lamdin,vlamdinqs@twitter.com,VP Product Management,4629,1973,6602
5846,Concordia,Mallya,cmallyaqx@gnu.org,Biostatistician II,6225,378,6603
5986,Vittoria,Goghin,vgoghinqz@ihg.com,Payment Adjustment Coordinator,3853,320,4173
5590,Brendan,Sunnucks,bsunnucksr1@marriott.com,Software Consultant,2848,1477,4325
5648,Karie,Gillon,kgillonr2@themeforest.net,Financial Analyst,8440,1530,9970
5740,Andra,Bertin,abertinr3@miibeian.gov.cn,Chemical Engineer,8275,1925,10200
5760,Marcellina,Durnford,mdurnfordr4@berkeley.edu,Biostatistician IV,6037,1667,7704
5882,Wendye,Tybalt,wtybaltrh@bloglines.com,Paralegal,5833,1309,7142
5655,Zaneta,Goodswen,zgoodswenri@nifty.com,Associate Professor,1950,1707,3657
5430,Georgetta,Elles,gellesrj@artisteer.com,Accountant IV,7523,1134,8657
6000,Monte,Gapp,mgapprl@instagram.com,Teacher,2023,832,2855
5052,Dennis,De Cleen,ddecleenro@topsy.com,Assistant Professor,2330,1938,4268
5124,Scot,Gian,sgianrp@livejournal.com,Financial Advisor,1809,1578,3387
6961,Avigdor,Frier,afrier0@furl.net,Human Resources Manager,9671,839,10510
6480,Brigitte,Goulston,bgoulston1@vinaora.com,Electrical Engineer,6683,1515,8198
6803,Reta,Tezure,rtezure2@blog.com,Software Test Engineer I,5489,454,5943
6990,Dorey,Nazair,dnazair3@cbc.ca,Registered Nurse,6035,1344,7379
6602,Abey,Aseef,aaseef4@wikimedia.org,VP Accounting,1508,535,2043
6202,Anson,Urwen,aurwen5@cafepress.com,Chemical Engineer,5885,832,6717
6232,Chelsey,Gregorowicz,cgregorowicz6@nasa.gov,Structural Engineer,5448,1167,6615
6061,Sharl,Pranger,spranger7@china.com.cn,Speech Pathologist,5817,1279,7096
6313,Dion,Simonian,dsimonian8@ft.com,Administrative Assistant II,4501,1866,6367
6780,Robin,Pettinger,rpettinger9@parallels.com,Research Nurse,7408,1072,8480
6419,Adella,Pidgeon,apidgeona@feedburner.com,Tax Accountant,2261,1342,3603
6447,Baxie,Muller,bmullerb@ca.gov,Database Administrator IV,9444,1362,10806
6434,Carie,Bence,cbencec@parallels.com,Software Consultant,7387,1312,8699
6879,Lindsay,Shegog,lshegogd@ibm.com,Human Resources Assistant I,9799,461,10260
6534,Auguste,Martinolli,amartinollie@gmpg.org,Nuclear Power Engineer,2038,323,2361
6029,Cherin,McAvaddy,cmcavaddyf@pcworld.com,Research Nurse,7402,475,7877
6002,Biddie,Dysert,bdysertg@globo.com,Computer Systems Analyst II,9276,1034,10310
6784,Perren,Lauderdale,plauderdaleh@twitter.com,Structural Engineer,3724,1296,5020
6573,Odetta,Elmhirst,oelmhirsti@cornell.edu,Media Manager II,1009,1432,2441
6427,Claudette,Crown,ccrownj@apache.org,Statistician II,6101,1015,7116
6141,Agustin,Spelling,aspellingk@technorati.com,GIS Technical Architect,5853,1105,6958
6767,Anya,Nortunen,anortunenl@cocolog-nifty.com,Technical Writer,5906,1141,7047
6289,Juli,Batisse,jbatissem@unicef.org,Budget/Accounting Analyst IV,9686,677,10363
6025,Blakeley,Aspinal,baspinaln@tripod.com,Project Manager,7973,1778,9751
6087,Malva,Doers,mdoerso@a8.net,Safety Technician IV,9526,672,10198
6400,Dorolisa,Schaffel,dschaffelp@princeton.edu,Account Executive,9593,1693,11286
6429,Hew,Firpi,hfirpiq@mail.ru,Recruiting Manager,4511,842,5353
6860,Alfy,Sedgeworth,asedgeworthr@usa.gov,Occupational Therapist,8775,1441,10216
6177,Calida,Nickels,cnickelss@mozilla.com,VP Product Management,4159,1605,5764
6766,Analiese,Rhubottom,arhubottomt@pen.io,Senior Financial Analyst,1363,1878,3241
6361,Wilbert,Tittershill,wtittershillu@webeden.co.uk,Senior Financial Analyst,7732,1702,9434
6880,Christi,Gatfield,cgatfieldv@icio.us,VP Accounting,8495,1780,10275
6258,Gunner,De Vaux,gdevauxw@indiatimes.com,Assistant Media Planner,1005,1689,2694
6574,Lonnard,Stive,lstivex@virginia.edu,Analyst Programmer,9424,1175,10599
6728,Stephie,Lymer,slymery@dmoz.org,Executive Secretary,8540,1327,9867
6347,Kacie,Filkov,kfilkovz@bizjournals.com,General Manager,1172,1297,2469
6256,Maynard,Seabrooke,mseabrooke10@ask.com,Senior Financial Analyst,6600,806,7406
6824,Brunhilda,Peirson,bpeirson11@archive.org,Quality Control Specialist,5506,1656,7162
6470,Howey,Goforth,hgoforth12@wunderground.com,Environmental Tech,4815,1169,5984
6369,Hewie,Gauson,hgauson13@wp.com,Technical Writer,9525,1176,10701
6253,Korrie,Novello,knovello14@storify.com,Research Assistant I,3453,1416,4869
6681,Malanie,Emmert,memmert15@youku.com,Accountant IV,2956,1424,4380
6588,Dulce,Mityashev,dmityashev16@census.gov,Environmental Specialist,7632,1762,9394
6524,Bobbee,Shellsheere,bshellsheere17@google.fr,Programmer Analyst IV,7460,1320,8780
6987,Lexy,Hiseman,lhiseman18@tamu.edu,Geological Engineer,6511,1407,7918
6929,Brose,Welford,bwelford19@about.me,VP Product Management,7959,297,8256
6416,Faunie,Jochens,fjochens1a@fema.gov,Media Manager III,1326,363,1689
6066,Jaime,Aston,jaston1b@icio.us,Software Consultant,2024,623,2647
6034,Ansell,Sivewright,asivewright1c@usgs.gov,Administrative Assistant III,2894,817,3711
6295,Nancee,Chatelet,nchatelet1d@google.com.au,Actuary,4329,1644,5973
6651,Evanne,Degan,edegan1e@taobao.com,Assistant Media Planner,1158,306,1464
6770,Worthy,Polycote,wpolycote1f@pagesperso-orange.fr,Graphic Designer,5886,866,6752
6663,Amitie,Pond-Jones,apondjones1g@cbc.ca,Chemical Engineer,5708,640,6348
6628,Jenda,Bootman,jbootman1h@berkeley.edu,Associate Professor,3440,1685,5125
6217,Thacher,Scothorne,tscothorne1i@rediff.com,Staff Accountant IV,7482,1688,9170
6356,Lilly,Plumb,lplumb1j@apple.com,Graphic Designer,1853,1271,3124
6436,Tyson,Mundell,tmundell1k@senate.gov,Web Designer IV,8544,1077,9621
6848,Filberto,Edmondson,fedmondson1l@addthis.com,Legal Assistant,8876,1032,9908
6599,Timi,Joan,tjoan1m@icq.com,VP Accounting,8384,999,9383
6877,Dorthy,Samarth,dsamarth1n@narod.ru,Librarian,4266,760,5026
6300,Dale,Lymbourne,dlymbourne1o@xrea.com,Physical Therapy Assistant,1333,1758,3091
6230,Colver,McNeill,cmcneill1p@themeforest.net,Mechanical Systems Engineer,3223,843,4066
6986,Marcellus,Poulson,mpoulson1q@utexas.edu,Graphic Designer,3809,392,4201
6686,Dorise,Kahane,dkahane1r@miibeian.gov.cn,Analyst Programmer,2023,1198,3221
6068,Petronia,Hambatch,phambatch1s@ucsd.edu,Product Engineer,9000,1079,10079
6910,Michell,Kleimt,mkleimt1t@elpais.com,Structural Engineer,6754,891,7645
6819,Hebert,Nancekivell,hnancekivell1u@scientificamerican.com,Statistician II,8694,1606,10300
6621,Merline,Burnep,mburnep1v@epa.gov,Occupational Therapist,6604,1431,8035
6611,Liana,Abramino,labramino1w@forbes.com,Biostatistician II,5883,1098,6981
6111,Clementina,Dubs,cdubs1x@squidoo.com,Research Associate,5606,931,6537
6821,Casey,Rochelle,crochelle1y@squarespace.com,Speech Pathologist,9048,237,9285
6497,Melesa,Allbrook,mallbrook1z@cam.ac.uk,VP Accounting,6662,1155,7817
6999,Archer,Von Hindenburg,avonhindenburg21@arizona.edu,Payment Adjustment Coordinator,3316,1739,5055
6609,Daffie,Tockell,dtockell22@admin.ch,Research Nurse,4620,565,5185
6891,Kirbee,Collcutt,kcollcutt23@usa.gov,Financial Analyst,3705,333,4038
6807,Gabbie,Riddock,griddock24@dion.ne.jp,Desktop Support Technician,5911,1239,7150
6374,Dominique,Noad,dnoad25@google.nl,Electrical Engineer,1608,218,1826
6077,Inness,Iveans,iiveans26@si.edu,Accountant IV,8019,1015,9034
6655,Oralee,Harcombe,oharcombe27@indiatimes.com,Technical Writer,1674,724,2398
6893,Holden,Tidman,htidman28@dagondesign.com,Cost Accountant,4525,1748,6273
6205,Cammi,Kilalea,ckilalea29@instagram.com,Staff Scientist,1999,1738,3737
6572,Molly,Lafrentz,mlafrentz2a@godaddy.com,Pharmacist,4827,487,5314
6688,Ingaberg,Ceaser,iceaser2b@skype.com,General Manager,3679,1565,5244
6079,Katharine,McCully,kmccully2c@devhub.com,VP Accounting,7174,1226,8400
6008,Marwin,Possel,mpossel2d@elegantthemes.com,Health Coach IV,3978,1737,5715
6563,Lorianna,Dellow,ldellow2e@europa.eu,Food Chemist,1322,643,1965
6080,Adelind,Alasdair,aalasdair2f@icio.us,Graphic Designer,5879,1950,7829
6039,Nikita,O' Mullan,nomullan2g@hugedomains.com,Financial Advisor,5080,426,5506
6383,Birgit,Ludlem,bludlem2h@indiegogo.com,Quality Control Specialist,5946,214,6160
6503,Lind,Schiell,lschiell2i@dagondesign.com,Human Resources Manager,6452,1580,8032
6614,Prescott,Scoggins,pscoggins2j@smh.com.au,Data Coordiator,2159,1743,3902
6725,Francine,Bruhke,fbruhke2k@who.int,Sales Associate,8295,669,8964
6057,Worthy,Dumper,wdumper2l@list-manage.com,Dental Hygienist,3725,661,4386
6477,Jehanna,Leupold,jleupold2m@zdnet.com,Civil Engineer,8061,1946,10007
6204,Rriocard,Tomaszczyk,rtomaszczyk2n@domainmarket.com,Computer Systems Analyst II,2423,1808,4231
6991,Malvin,Jeannot,mjeannot2o@jalbum.net,Registered Nurse,6250,1363,7613
6088,Brooks,Townby,btownby2p@uol.com.br,Systems Administrator III,6772,1052,7824
6382,Heywood,Robb,hrobb2s@npr.org,Payment Adjustment Coordinator,5606,689,6295
6626,Kelcy,Poulsom,kpoulsom2t@alexa.com,Safety Technician II,6335,1289,7624
6952,Jacquenetta,Delahunt,jdelahunt2u@si.edu,Safety Technician IV,2441,1956,4397
6754,Rosabel,Yelland,ryelland2w@baidu.com,Teacher,9582,1958,11540
6341,Alyda,Sepey,asepey2x@dailymail.co.uk,Teacher,5923,1194,7117
6140,Nathanial,Rosingdall,nrosingdall2y@prlog.org,Analyst Programmer,3696,1852,5548
6329,Leela,Soreau,lsoreau2z@discuz.net,Research Nurse,5370,504,5874
6871,Eugine,Evill,eevill30@indiatimes.com,Information Systems Manager,8910,1593,10503
6487,Dionysus,Ida,dida31@vistaprint.com,Health Coach I,6722,1063,7785
6736,Justina,Cobbing,jcobbing32@sfgate.com,Professor,2517,276,2793
6090,Sherill,Torritti,storritti33@ezinearticles.com,Professor,6878,460,7338
6749,Ronnie,Kaasman,rkaasman34@theatlantic.com,Design Engineer,7566,1156,8722
6895,Zita,Kinze,zkinze35@over-blog.com,Programmer Analyst IV,7813,865,8678
6364,Ameline,Staresmeare,astaresmeare36@technorati.com,Registered Nurse,2253,458,2711
6678,Karoly,Thomason,kthomason37@nbcnews.com,Actuary,6828,428,7256
6521,Westleigh,Chaudret,wchaudret38@epa.gov,Programmer Analyst II,8938,371,9309
6782,Aretha,Sabbatier,asabbatier39@bluehost.com,Developer III,8914,1394,10308
6385,Dawna,Ivanshintsev,divanshintsev3a@state.gov,General Manager,9219,722,9941
6760,Barron,Spilsburie,bspilsburie3b@devhub.com,Dental Hygienist,1926,1064,2990
6380,Courtnay,Pencott,cpencott3c@irs.gov,Professor,3067,395,3462
6216,Mart,Beedie,mbeedie3d@weebly.com,Staff Scientist,2618,1869,4487
6162,Guendolen,Wollacott,gwollacott3f@mtv.com,Social Worker,5012,1141,6153
6738,Glenn,Forward,gforward3g@bloglovin.com,Electrical Engineer,7163,1129,8292
6802,Teena,Toll,ttoll3h@people.com.cn,Administrative Officer,5546,1919,7465
6399,Barry,Yurenin,byurenin3i@exblog.jp,Product Engineer,6311,1095,7406
6398,Lauralee,Hackwell,lhackwell3j@github.com,Paralegal,7991,251,8242
6262,Gerta,Conibeer,gconibeer3k@storify.com,Administrative Officer,7916,1382,9298
6856,Audrie,Etchingham,aetchingham3l@dropbox.com,Health Coach I,3613,1859,5472
6122,Ronny,Foad,rfoad3m@prweb.com,Registered Nurse,9452,1940,11392
6653,Wyndham,Nestle,wnestle3n@quantcast.com,Occupational Therapist,9473,511,9984
6665,Josephine,Smitham,jsmitham3o@i2i.jp,Health Coach II,9358,1755,11113
6544,Glen,Stede,gstede3p@cpanel.net,General Manager,4187,1618,5805
6894,Early,De Fraine,edefraine3q@posterous.com,Senior Developer,1525,1204,2729
6606,Skippie,Lightoller,slightoller3s@engadget.com,Technical Writer,5696,1559,7255
6379,Jeromy,Tressler,jtressler3u@google.co.jp,Graphic Designer,7593,1639,9232
6930,Lazar,Abad,labad3v@com.com,Actuary,1069,781,1850
6786,Sari,Inman,sinman3w@chronoengine.com,Assistant Manager,4481,1203,5684
6409,Jaquelyn,Tabour,jtabour3x@craigslist.org,Statistician I,4184,1198,5382
6648,Leo,Seckom,lseckom3y@scribd.com,Chemical Engineer,9640,239,9879
6293,Augustina,Pargiter,apargiter3z@naver.com,Product Engineer,8125,1428,9553
6528,Lucy,Benning,lbenning40@globo.com,Director of Sales,6823,1017,7840
6310,Lynnelle,Bauduccio,lbauduccio41@squidoo.com,Administrative Assistant III,3746,1379,5125
6136,Vinson,Foxley,vfoxley44@is.gd,Health Coach I,9917,390,10307
6909,Berrie,Pakeman,bpakeman45@cornell.edu,Operator,5127,1255,6382
6761,Garner,Alder,galder46@freewebs.com,Marketing Assistant,6540,408,6948
6478,Rodd,Wathall,rwathall47@deviantart.com,Accountant III,2535,606,3141
6078,Kimberlyn,Minshall,kminshall48@over-blog.com,Structural Analysis Engineer,8523,853,9376
6886,Dalis,Blackhurst,dblackhurst49@studiopress.com,Technical Writer,7515,1071,8586
6432,Cathi,Pizer,cpizer4b@simplemachines.org,Senior Cost Accountant,2252,1554,3806
6946,Fawne,Bartomieu,fbartomieu4c@tamu.edu,Office Assistant I,3718,1155,4873
6185,Kirsten,Elnor,kelnor4d@blog.com,Internal Auditor,4425,615,5040
6842,Francklin,Campsall,fcampsall4e@nasa.gov,Tax Accountant,5309,563,5872
6601,Elfrieda,Walworche,ewalworche4g@reverbnation.com,Cost Accountant,9731,1831,11562
6625,Maris,Coddington,mcoddington4h@ucoz.ru,Senior Financial Analyst,2600,458,3058
6135,Dale,Spary,dspary4i@amazonaws.com,Developer IV,7012,1821,8833
6600,Kendal,Joselevitz,kjoselevitz4j@devhub.com,Senior Cost Accountant,5796,1052,6848
6985,Hadleigh,Bonder,hbonder4k@wikimedia.org,Financial Advisor,1465,1279,2744
6716,Ag,Offord,aofford4l@shareasale.com,Staff Accountant IV,7794,1610,9404
6948,Justina,Juppe,jjuppe4m@sun.com,Compensation Analyst,8124,1107,9231
6897,Augustine,Hamlington,ahamlington4n@utexas.edu,Information Systems Manager,9719,1568,11287
6624,Kipp,Allwell,kallwell4o@sohu.com,Dental Hygienist,8588,621,9209
6758,Claudianus,Casacchia,ccasacchia4p@a8.net,Health Coach III,5040,470,5510
6817,Porter,Hovie,phovie4q@typepad.com,Office Assistant IV,2920,1566,4486
6529,Kamillah,Beirne,kbeirne4r@plala.or.jp,Analog Circuit Design manager,5269,1913,7182
6100,Quintina,Coushe,qcoushe4u@discovery.com,Human Resources Assistant IV,9883,1209,11092
6902,Robers,Southard,rsouthard4v@netscape.com,Senior Cost Accountant,2322,958,3280
6850,Silvester,Deakins,sdeakins4x@canalblog.com,Programmer III,2022,293,2315
6684,Annabelle,Bossingham,abossingham4y@wiley.com,Electrical Engineer,3878,1353,5231
6953,Michal,Pendle,mpendle4z@usnews.com,Account Coordinator,4066,925,4991
6616,Sella,Reijmers,sreijmers50@weebly.com,Assistant Professor,8184,666,8850
6349,Penelopa,Turl,pturl51@dyndns.org,Electrical Engineer,1269,1889,3158
6420,Ruttger,Palethorpe,rpalethorpe52@wisc.edu,Nuclear Power Engineer,9806,1620,11426
6292,Nicola,Gurdon,ngurdon53@nytimes.com,Chief Design Engineer,7180,462,7642
6403,Craggy,Showalter,cshowalter54@berkeley.edu,Systems Administrator III,2655,1923,4578
6214,Trudi,Cabral,tcabral55@qq.com,VP Marketing,1687,564,2251
6286,Jeni,Vella,jvella56@diigo.com,Paralegal,5892,566,6458
6026,Munroe,Tafani,mtafani57@businessweek.com,Biostatistician III,9657,213,9870
6923,Ettie,Meatcher,emeatcher58@microsoft.com,Project Manager,8504,469,8973
6137,Nathalia,Creeber,ncreeber59@nhs.uk,Marketing Manager,5440,1196,6636
6845,Lin,Collop,lcollop5a@naver.com,Physical Therapy Assistant,8477,1991,10468
6128,Devlin,Ipsley,dipsley5b@ucla.edu,Web Developer IV,6472,1627,8099
6516,Tris,Korbmaker,tkorbmaker5c@nbcnews.com,Systems Administrator IV,3152,1813,4965
6882,Ruby,Phlippi,rphlippi5e@deviantart.com,Analyst Programmer,9633,728,10361
6309,Kristos,Chastel,kchastel5f@google.com.br,Junior Executive,7241,984,8225
6644,Lolita,Jerwood,ljerwood5h@addthis.com,Research Assistant II,3008,468,3476
6019,Claudine,Sallings,csallings5i@uol.com.br,Analog Circuit Design manager,6605,1711,8316
6251,Carlita,Thomke,cthomke5k@mayoclinic.com,Safety Technician I,9265,997,10262
6063,Levey,Boughtwood,lboughtwood5l@youtube.com,Marketing Manager,3020,1201,4221
6747,Celestyn,Quantrill,cquantrill5m@foxnews.com,Database Administrator I,8278,664,8942
6954,Deloria,Orrett,dorrett5n@amazonaws.com,Assistant Media Planner,2903,1845,4748
6170,Karen,Pow,kpow5o@nationalgeographic.com,Structural Analysis Engineer,6515,1285,7800
6947,Ingelbert,Colleford,icolleford5q@mayoclinic.com,Product Engineer,2931,337,3268
6772,Trudy,Cracker,tcracker5s@cornell.edu,Cost Accountant,8789,888,9677
6828,Glory,Kezor,gkezor5u@berkeley.edu,Software Engineer III,7997,1881,9878
6187,Delilah,Kilmister,dkilmister5v@wufoo.com,Assistant Professor,4538,920,5458
6192,Chloris,Spanton,cspanton5w@ucoz.ru,Software Engineer IV,5825,1356,7181
6915,Javier,Maffey,jmaffey5y@sohu.com,Dental Hygienist,9629,1728,11357
6225,Devin,Calladine,dcalladine60@irs.gov,Legal Assistant,4120,906,5026
7000,Dianemarie,Georgeot,dgeorgeot61@fc2.com,Systems Administrator III,5439,1686,7125
6676,Augustus,Ebbutt,aebbutt62@oracle.com,Web Designer IV,4199,411,4610
6542,Will,Janouch,wjanouch63@latimes.com,Systems Administrator III,8623,456,9079
6670,Elli,Tackle,etackle65@spotify.com,Director of Sales,8732,690,9422
6861,Phylys,Ilchuk,pilchuk66@youtube.com,Paralegal,1835,611,2446
6223,Bill,Chadd,bchadd67@deliciousdays.com,Senior Developer,2105,585,2690
6343,Aubine,McCloch,amccloch68@theguardian.com,VP Marketing,5265,1993,7258
6873,Rebecka,Handsheart,rhandsheart69@google.ca,VP Accounting,7128,452,7580
6914,Ilysa,Colum,icolum6a@quantcast.com,Senior Editor,8767,1383,10150
6165,Blithe,Osborne,bosborne6b@weebly.com,Safety Technician II,1101,1462,2563
6365,Noelyn,MacGillavery,nmacgillavery6c@tumblr.com,VP Quality Control,4628,1538,6166
6244,Dorri,Grosvener,dgrosvener6d@netvibes.com,Business Systems Development Analyst,6331,271,6602
6841,Charisse,Dunmore,cdunmore6e@i2i.jp,Recruiting Manager,2066,818,2884
6608,Byrann,Sanger,bsanger6f@tinyurl.com,Software Engineer IV,7075,1696,8771
6937,Philippe,Aberkirder,paberkirder6h@oakley.com,Product Engineer,4524,493,5017
6278,Waylen,Klosser,wklosser6i@engadget.com,Developer III,5829,917,6746
6550,Lilas,Dallinder,ldallinder6j@gravatar.com,Media Manager I,1223,425,1648
6801,Jayme,Spilsburie,jspilsburie6k@gov.uk,Editor,3909,1446,5355
6669,Salome,Nozzolii,snozzolii6l@github.io,Research Assistant III,6734,1533,8267
6336,Zebulon,Russam,zrussam6m@furl.net,Environmental Tech,4591,402,4993
6321,Lindsay,Collinge,lcollinge6n@homestead.com,Librarian,1968,1204,3172
6179,Lianne,Mont,lmont6q@dropbox.com,Professor,2797,1268,4065
6098,Carola,Leney,cleney6r@columbia.edu,Project Manager,6684,1547,8231
6637,Tristan,Donwell,tdonwell6s@nationalgeographic.com,Desktop Support Technician,2671,729,3400
6269,Cordell,Bowfin,cbowfin6v@stanford.edu,VP Sales,9948,427,10375
6504,Alexi,Butte,abutte6w@netlog.com,Software Engineer IV,6786,1608,8394
6134,Joella,Gunston,jgunston6y@altervista.org,VP Sales,6317,866,7183
6138,Dionis,Mouatt,dmouatt6z@cmu.edu,Chief Design Engineer,1506,567,2073
6082,Timofei,Rilston,trilston71@cam.ac.uk,VP Marketing,4132,394,4526
6623,Clare,Lowden,clowden72@blogtalkradio.com,Statistician IV,2088,1052,3140
6846,Jessalyn,Plampeyn,jplampeyn73@eventbrite.com,General Manager,1918,1948,3866
6104,Nicolai,Brame,nbrame74@businesswire.com,Associate Professor,1753,428,2181
6270,Welsh,Joutapaitis,wjoutapaitis75@dagondesign.com,Desktop Support Technician,1520,1790,3310
6995,Stan,Crossan,scrossan77@engadget.com,Associate Professor,8603,623,9226
6682,Fremont,Gueste,fgueste78@digg.com,Account Executive,3753,759,4512
6067,Menard,Veregan,mveregan7b@gnu.org,General Manager,5912,1996,7908
6092,Thorsten,Burlingham,tburlingham7d@businessweek.com,Analog Circuit Design manager,9474,1639,11113
6694,Tybalt,Dincke,tdincke7e@fc2.com,VP Quality Control,9708,1639,11347
6972,Pavia,Kleinbaum,pkleinbaum7g@java.com,Marketing Manager,8052,1734,9786
6452,Arvin,Grimbleby,agrimbleby7h@pcworld.com,Electrical Engineer,2035,211,2246
6183,Norina,Gillyatt,ngillyatt7j@meetup.com,Financial Advisor,5518,255,5773
6977,Ulla,Rowly,urowly7k@furl.net,Administrative Assistant IV,8373,622,8995
6017,Deeyn,Ebbitt,debbitt7l@jalbum.net,Civil Engineer,9710,401,10111
6422,Alyse,Sofe,asofe7m@jigsy.com,Senior Financial Analyst,4202,1659,5861
6117,Justis,Wisniowski,jwisniowski7n@simplemachines.org,Programmer Analyst I,5897,1932,7829
6464,Wittie,Kupke,wkupke7o@disqus.com,Research Assistant III,8159,1409,9568
6800,Lesya,Gladdolph,lgladdolph7p@google.it,Senior Developer,6916,1652,8568
6647,Marcelline,Whifen,mwhifen7q@si.edu,Chief Design Engineer,7650,1006,8656
6796,Alfred,Ratie,aratie7r@utexas.edu,Structural Engineer,2478,506,2984
6505,Pamella,McCurdy,pmccurdy7s@hibu.com,Graphic Designer,8741,1762,10503
6864,Wilfred,Acosta,wacosta7t@biglobe.ne.jp,Automation Specialist II,3970,1988,5958
6147,Blane,Stiles,bstiles7u@cnn.com,Legal Assistant,7190,1358,8548
6126,Nora,Prettejohns,nprettejohns7v@stanford.edu,Compensation Analyst,3300,779,4079
6065,Baldwin,Ogborne,bogborne7w@disqus.com,Quality Control Specialist,2948,1274,4222
6724,Sydel,Lawland,slawland7x@arstechnica.com,Dental Hygienist,8183,985,9168
6809,Sherie,Macilhench,smacilhench7z@lycos.com,VP Quality Control,8015,1127,9142
6059,Adlai,Mackneis,amackneis81@marketwatch.com,Assistant Media Planner,5345,1611,6956
6392,Krisha,Lamas,klamas82@aboutads.info,Accounting Assistant II,1684,1618,3302
6913,Aloysius,Gonneau,agonneau83@hostgator.com,Nurse,1487,447,1934
6407,Elvina,Simonyi,esimonyi84@livejournal.com,Nurse Practicioner,2814,956,3770
6775,Frederick,Ghelardi,fghelardi86@t-online.de,Sales Associate,3962,1407,5369
6149,Robinette,Youell,ryouell88@hao123.com,Health Coach III,9930,1825,11755
6740,Carmon,Clifford,cclifford89@nps.gov,Statistician I,6076,1888,7964
6638,Reena,Davydychev,rdavydychev8a@barnesandnoble.com,Software Consultant,5415,878,6293
6641,Mortie,Cancott,mcancott8b@google.com.hk,Pharmacist,2098,1013,3111
6571,Britta,Halladey,bhalladey8c@zdnet.com,Database Administrator II,2870,1115,3985
6868,Staci,Haucke,shaucke8d@fc2.com,Registered Nurse,3611,1621,5232
6194,Antonia,Quin,aquin8e@nydailynews.com,Structural Engineer,7860,635,8495
6250,Aarika,Farebrother,afarebrother8f@joomla.org,Speech Pathologist,6089,345,6434
6855,Petronella,Duley,pduley8g@godaddy.com,Graphic Designer,2875,1725,4600
6441,Alyosha,Cosgrave,acosgrave8i@bizjournals.com,Business Systems Development Analyst,4608,264,4872
6016,Elinor,McCree,emccree8l@netlog.com,Editor,2815,1056,3871
6200,Codi,Longmore,clongmore8m@multiply.com,GIS Technical Architect,9177,1552,10729
6643,Drucill,Leverentz,dleverentz8o@washingtonpost.com,Recruiter,7265,925,8190
6996,Caralie,Coleman,ccoleman8p@cdbaby.com,Senior Financial Analyst,8731,1123,9854
6015,Cayla,McKeag,cmckeag8q@irs.gov,Payment Adjustment Coordinator,4008,418,4426
6934,Olimpia,Cornborough,ocornborough8r@foxnews.com,Project Manager,5748,1612,7360
6245,Mickey,Harhoff,mharhoff8t@bbc.co.uk,Occupational Therapist,4745,1943,6688
6908,Barri,Marks,bmarks8w@amazon.com,VP Product Management,9432,1023,10455
6695,Ara,Lohden,alohden8x@tinyurl.com,Recruiting Manager,6109,1305,7414
6925,Ardisj,Ajsik,aajsik8y@marriott.com,Cost Accountant,5038,1019,6057
6101,Gwenora,Keaton,gkeaton8z@businessinsider.com,Dental Hygienist,4815,1528,6343
6957,Gabriele,Cholwell,gcholwell90@mac.com,VP Product Management,9792,1240,11032
6620,Feodora,Dayborne,fdayborne91@usnews.com,Research Assistant II,9428,1855,11283
6022,Cece,Siemon,csiemon93@forbes.com,Marketing Assistant,7924,1914,9838
6951,Roxana,Vasiltsov,rvasiltsov94@npr.org,Librarian,9733,1088,10821
6844,Marylynne,Point,mpoint97@imdb.com,Recruiting Manager,1134,568,1702
6112,Mortimer,Girsch,mgirsch98@nationalgeographic.com,Professor,9896,920,10816
6735,Tammie,Faulkner,tfaulkner9c@abc.net.au,Accounting Assistant IV,2496,1521,4017
6484,Lodovico,Demelt,ldemelt9d@wisc.edu,Senior Financial Analyst,1653,603,2256
6831,Sophronia,Ratke,sratke9e@nbcnews.com,Pharmacist,5423,401,5824
6211,Norah,Farndon,nfarndon9g@joomla.org,VP Quality Control,8270,238,8508
6157,Lyda,Vincent,lvincent9i@moonfruit.com,Community Outreach Specialist,1619,1191,2810
6537,Tierney,Manntschke,tmanntschke9j@yandex.ru,Environmental Tech,2363,1103,3466
6201,Sheridan,De Pietri,sdepietri9k@oaic.gov.au,Information Systems Manager,6599,530,7129
6367,Lebbie,Lindenfeld,llindenfeld9n@tmall.com,Geological Engineer,2365,354,2719
6698,Fairfax,Breakey,fbreakey9o@acquirethisname.com,Media Manager IV,4518,1991,6509
6712,Gussie,Fancy,gfancy9p@chicagotribune.com,Staff Scientist,7847,846,8693
6350,Rey,Crates,rcrates9q@t.co,Web Developer I,7175,1866,9041
6428,Arthur,Northgraves,anorthgraves9r@umn.edu,Senior Developer,4284,990,5274
6153,Sybila,Alster,salster9s@biblegateway.com,Administrative Officer,2090,1168,3258
6926,Hunter,Elacoate,helacoate9w@woothemes.com,Graphic Designer,8466,370,8836
6935,Morty,Banaszewski,mbanaszewski9x@telegraph.co.uk,Software Engineer III,4972,1043,6015
6102,Skipton,Twidle,stwidle9y@cmu.edu,Professor,5776,1411,7187
6493,Rudolf,Ferrieri,rferrieri9z@ihg.com,Assistant Media Planner,4215,1601,5816
6639,Kakalina,Clutram,kclutrama0@dropbox.com,Civil Engineer,8044,1519,9563
6099,Kenn,Burston,kburstona1@google.pl,Biostatistician I,7041,248,7289
6238,Aarika,Josifovitz,ajosifovitza3@wp.com,Engineer I,2025,1963,3988
6118,Alexandra,Attenborough,aattenborougha4@1688.com,Programmer Analyst IV,2115,1942,4057
6945,Irving,Evenett,ievenetta5@mail.ru,Structural Analysis Engineer,2461,769,3230
6959,Walt,Berthod,wberthoda6@army.mil,General Manager,1237,1680,2917
6048,Braden,Danbrook,bdanbrooka7@instagram.com,Junior Executive,1216,577,1793
6963,Ursola,Greathead,ugreatheada8@networkadvertising.org,Mechanical Systems Engineer,7617,997,8614
6486,Zena,Seton,zsetona9@creativecommons.org,Office Assistant II,1419,533,1952
6593,Zandra,Poetz,zpoetzac@youku.com,Account Coordinator,9776,1420,11196
6701,Maisie,Fyrth,mfyrthad@usgs.gov,Chemical Engineer,7715,1720,9435
6667,Susy,Gudgen,sgudgenah@sciencedirect.com,Research Nurse,3537,351,3888
6763,Hilary,Scranedge,hscranedgeai@princeton.edu,Senior Financial Analyst,4457,837,5294
6331,Laurene,Murr,lmurrak@goo.ne.jp,Statistician I,7354,1126,8480
6009,Benedikt,Shemming,bshemmingal@comsenz.com,Recruiter,5447,1187,6634
6816,Cele,Dinley,cdinleyam@netvibes.com,Junior Executive,1871,1343,3214
6630,Georgeanne,Carlisle,gcarlislean@nymag.com,Tax Accountant,4149,1628,5777
6939,Kalvin,Wardrop,kwardropao@shareasale.com,Quality Engineer,3093,1999,5092
6495,Renado,Maulden,rmauldenap@yahoo.co.jp,VP Sales,5992,1648,7640
6334,Garwin,Reditt,gredittar@example.com,Registered Nurse,3196,1154,4350
6566,Kit,Checo,kchecoas@goo.ne.jp,Senior Financial Analyst,1683,1074,2757
6657,Kimberly,Bert,kbertat@upenn.edu,Quality Engineer,9491,1771,11262
6689,Lorens,Drescher,ldrescherau@histats.com,VP Accounting,6382,1712,8094
6618,Eleonora,Onele,eoneleav@bandcamp.com,Business Systems Development Analyst,6809,1234,8043
6363,Felicity,Salla,fsallaaw@constantcontact.com,Environmental Specialist,8943,825,9768
6536,Roarke,Willoughway,rwilloughwayax@lulu.com,Assistant Manager,5608,752,6360
6532,Trumann,Dibner,tdibneray@zimbio.com,Developer IV,2345,1852,4197
6338,Pietra,McQuarter,pmcquarteraz@fema.gov,Mechanical Systems Engineer,3967,1496,5463
6411,Wilek,Ruckert,wruckertb0@flickr.com,Geologist IV,3456,468,3924
6472,Otha,Biesty,obiestyb1@sun.com,Sales Representative,8806,736,9542
6798,Stephannie,Tilby,stilbyb2@sohu.com,Data Coordiator,7660,840,8500
6973,Brit,Mingaye,bmingayeb4@va.gov,Operator,1504,1355,2859
6733,Micheline,Edling,medlingb6@nifty.com,Assistant Manager,5948,422,6370
6746,Jesus,Cogle,jcogleb9@nps.gov,Automation Specialist II,3470,1339,4809
6196,Hamlen,Woodland,hwoodlandbb@nsw.gov.au,Design Engineer,7652,791,8443
6388,Micki,Gerdes,mgerdesbc@xinhuanet.com,Accountant III,5810,1595,7405
6789,Avie,Ault,aaultbe@meetup.com,Safety Technician III,5692,744,6436
6632,Elie,Worcester,eworcesterbg@topsy.com,Social Worker,1102,1476,2578
6123,Izabel,Ensten,ienstenbh@businessweek.com,Administrative Officer,5831,1277,7108
6144,Chrystal,Belcher,cbelcherbi@surveymonkey.com,Account Coordinator,2926,331,3257
6727,Devlin,Fotitt,dfotittbj@ning.com,Community Outreach Specialist,9219,1692,10911
6358,Der,Howard - Gater,dhowardgaterbk@domainmarket.com,Tax Accountant,6387,1180,7567
6791,Lita,MacIlory,lmacilorybl@amazon.com,Product Engineer,8124,515,8639
6263,Benyamin,McAuslan,bmcauslanbm@wikipedia.org,Business Systems Development Analyst,6841,216,7057
6180,Ado,Swire,aswirebn@symantec.com,Clinical Specialist,5433,373,5806
6814,Artemas,Dakers,adakersbo@mapquest.com,Marketing Manager,3539,1614,5153
6405,Evy,Crumbleholme,ecrumbleholmebq@storify.com,Registered Nurse,2005,764,2769
6654,Johnathan,Balkwill,jbalkwillbs@nps.gov,Operator,3332,1478,4810
6704,Dell,Pudden,dpuddenbt@gnu.org,Research Assistant I,6205,1250,7455
6920,Zack,Bonnavant,zbonnavantbu@webs.com,Sales Associate,1617,214,1831
6501,Rivalee,Upchurch,rupchurchbw@telegraph.co.uk,Graphic Designer,9501,1740,11241
6105,Daryle,Erni,dernibx@prnewswire.com,Civil Engineer,1180,1200,2380
6962,Gunilla,Gley,ggleybz@istockphoto.com,Physical Therapy Assistant,9247,666,9913
6714,Russell,Farmloe,rfarmloec0@is.gd,VP Product Management,3387,1668,5055
6519,Hewet,O'Doireidh,hodoireidhc1@timesonline.co.uk,Actuary,4136,212,4348
6220,Jerry,Gleave,jgleavec3@walmart.com,Tax Accountant,3272,1611,4883
6081,Jolynn,Tuffley,jtuffleyc5@illinois.edu,Senior Developer,3758,839,4597
6839,Libbey,Eilhermann,leilhermannc7@people.com.cn,Tax Accountant,6722,1705,8427
6499,Lanie,Dawdry,ldawdryc8@i2i.jp,Desktop Support Technician,7528,1772,9300
6752,Virge,Eborn,vebornc9@purevolume.com,VP Product Management,5109,1465,6574
6266,Holli,Humbles,hhumblesca@umich.edu,Administrative Assistant II,9703,1265,10968
6442,Korney,Brithman,kbrithmancd@instagram.com,Tax Accountant,9524,1324,10848
6264,Wyatan,Boyen,wboyence@acquirethisname.com,Programmer I,2822,965,3787
6003,Cody,Arnopp,carnoppcf@vk.com,Speech Pathologist,1299,563,1862
6252,Ramona,L'argent,rlargentcg@gravatar.com,Dental Hygienist,8090,724,8814
6095,Trish,Davers,tdaversch@shinystat.com,Senior Sales Associate,9381,1577,10958
6445,Lennie,Effemy,leffemycj@arstechnica.com,Staff Scientist,4814,794,5608
6333,Herby,Hedger,hhedgercm@jimdo.com,Paralegal,6984,1856,8840
6989,Kain,Beavers,kbeaversco@cnet.com,Budget/Accounting Analyst IV,7811,774,8585
6522,Pauline,Le Noir,plenoircp@wikia.com,Recruiting Manager,6915,1729,8644
6966,Eudora,Lorain,eloraincr@mlb.com,Sales Representative,9582,353,9935
6261,Justin,Woodroof,jwoodroofcs@oakley.com,Compensation Analyst,4885,1834,6719
6887,Georgette,Barbe,gbarbect@1688.com,Social Worker,9329,915,10244
6631,Fremont,Salaman,fsalamancv@vkontakte.ru,Database Administrator IV,7556,1502,9058
6581,Leigh,Bonifazio,lbonifaziocx@sina.com.cn,Information Systems Manager,5590,1844,7434
6950,Illa,Enderle,ienderlecy@gizmodo.com,Quality Engineer,9070,1013,10083
6921,Noah,Barensen,nbarensencz@redcross.org,Data Coordiator,3906,210,4116
6189,Ranna,Winton,rwintond0@bizjournals.com,Administrative Assistant IV,9343,1998,11341
6096,Ashla,Dearnaley,adearnaleyd2@e-recht24.de,Graphic Designer,5931,641,6572
6235,Aileen,Darnborough,adarnboroughd6@usgs.gov,Administrative Assistant IV,3561,955,4516
6552,Merrick,Orcas,morcasd7@paginegialle.it,Structural Engineer,3959,1818,5777
6304,Sophie,Rimer,srimerdb@alibaba.com,Biostatistician II,9817,1306,11123
6778,Del,Abrahmson,dabrahmsondc@imgur.com,Database Administrator III,4057,975,5032
6508,Erastus,Opy,eopydf@google.ru,Senior Quality Engineer,1102,275,1377
6595,Tedi,Bergeon,tbergeondg@cisco.com,Staff Accountant II,9169,1764,10933
6773,Aggy,Kimmings,akimmingsdh@independent.co.uk,Budget/Accounting Analyst IV,5544,1096,6640
6070,Ailyn,Castro,acastrodi@ucsd.edu,Web Designer III,2873,517,3390
6578,Kain,Queen,kqueendj@imageshack.us,Civil Engineer,1087,1896,2983
6007,Alvin,Bedminster,abedminsterdk@nasa.gov,Cost Accountant,9134,557,9691
6437,Marthena,Nicklin,mnicklindl@toplist.cz,Health Coach IV,2688,1840,4528
6745,Bradford,Rishman,brishmando@nyu.edu,Community Outreach Specialist,8450,486,8936
6898,Doe,Robertot,drobertotdp@ucsd.edu,GIS Technical Architect,3704,1788,5492
6454,Arron,Yegorshin,ayegorshindr@fotki.com,Technical Writer,1897,727,2624
6241,Westleigh,Linder,wlinderds@google.nl,Geologist IV,1568,1496,3064
6612,Harlen,Kippin,hkippindt@pinterest.com,Help Desk Technician,1265,1604,2869
6793,Bartie,Whenman,bwhenmandu@imdb.com,Help Desk Technician,2766,1740,4506
6943,Olwen,Tresise,otresisedv@ca.gov,Chief Design Engineer,6668,708,7376
6305,Sallie,Gainor,sgainordz@whitehouse.gov,Geological Engineer,7590,842,8432
6652,Vlad,Pawlik,vpawlike4@google.fr,Marketing Assistant,5164,357,5521
6852,Darsey,Le Gallo,dlegalloe5@imgur.com,Junior Executive,1731,283,2014
6394,Packston,Wollrauch,pwollrauche6@sourceforge.net,Editor,7924,692,8616
6352,Jonah,Fawckner,jfawcknere8@army.mil,Help Desk Technician,7034,1505,8539
6064,Gus,Drakes,gdrakesea@paypal.com,Operator,9654,861,10515
6052,Karol,Affleck,kaffleckec@blogspot.com,Recruiter,5764,1738,7502
6421,Louisette,Ende,lendeed@wunderground.com,Electrical Engineer,7673,423,8096
6974,Lishe,Jellyman,ljellymanee@biglobe.ne.jp,Assistant Media Planner,6632,899,7531
6826,Norah,Pashe,npasheef@issuu.com,Financial Analyst,4132,1912,6044
6545,Brok,Hagerty,bhagertyeh@microsoft.com,Junior Executive,4101,573,4674
6768,Marika,Sertin,msertinei@umich.edu,Compensation Analyst,4493,1986,6479
6806,Philomena,Marshall,pmarshallej@github.com,Staff Accountant III,8291,1089,9380
6834,Bearnard,Pollak,bpollakek@mac.com,Structural Analysis Engineer,7101,1677,8778
6396,Beaufort,Dugget,bduggetel@opensource.org,Compensation Analyst,4172,899,5071
6190,Rebeca,Twydell,rtwydelleq@friendfeed.com,Assistant Professor,2802,715,3517
6907,Chaunce,Piken,cpikenet@va.gov,Senior Sales Associate,9725,1871,11596
6903,Dyan,Jeffrey,djeffreyeu@live.com,Account Executive,5347,604,5951
6971,Di,Fergusson,dfergussonew@amazonaws.com,Nuclear Power Engineer,3856,1678,5534
6307,Tracie,Hellens,thellensex@fastcompany.com,Librarian,5535,1839,7374
6366,Reece,Syseland,rsyselandey@lulu.com,Quality Engineer,3563,1266,4829
6627,Hi,Dickey,hdickeyez@histats.com,Administrative Assistant I,2714,1394,4108
6794,Bennett,Burker,bburkerf1@ezinearticles.com,Occupational Therapist,8556,1276,9832
6418,Ravi,Clyde,rclydef2@discovery.com,Librarian,5969,1118,7087
6888,Briant,MacCracken,bmaccrackenf3@merriam-webster.com,Food Chemist,1034,669,1703
6167,Vidovik,Harrild,vharrildf4@hhs.gov,Sales Representative,5233,524,5757
6976,Juan,Aliman,jalimanf7@comcast.net,Developer IV,6757,1985,8742
6094,Jessie,Toll,jtollf8@ask.com,Account Coordinator,6099,1593,7692
6866,Sella,Faires,sfairesf9@nydailynews.com,Editor,4860,1652,6512
6465,Marcille,Lownes,mlownesfa@themeforest.net,Executive Secretary,3945,1467,5412
6130,Fayette,Fairbairn,ffairbairnfc@nytimes.com,Chief Design Engineer,1704,354,2058
6705,Miranda,Munt,mmuntfe@hostgator.com,Senior Quality Engineer,8691,1257,9948
6916,Christian,Rubie,crubiefg@nytimes.com,Senior Editor,2000,1651,3651
6762,Elvera,Dadge,edadgefi@wired.com,Social Worker,9999,995,10994
6119,Bradley,Ghion,bghionfn@comsenz.com,Analog Circuit Design manager,1643,430,2073
6739,Glennis,Casham,gcashamfo@behance.net,Web Designer II,8397,915,9312
6683,Sibeal,Mantrip,smantripfr@ihg.com,Operator,1311,918,2229
6449,Chaunce,Collelton,ccolleltonft@instagram.com,Software Test Engineer IV,9732,495,10227
6368,Benton,Gatecliffe,bgatecliffefu@ebay.co.uk,Assistant Media Planner,9275,548,9823
6325,Hardy,Kerne,hkernefv@microsoft.com,Accounting Assistant III,7988,1611,9599
6308,Kath,Muckley,kmuckleyfz@tmall.com,Engineer III,5902,786,6688
6030,Tatum,Northage,tnorthageg0@i2i.jp,Recruiting Manager,6181,484,6665
6468,Nefen,Willox,nwilloxg1@youtube.com,Sales Representative,5194,1513,6707
6715,Christoffer,Wilber,cwilberg2@xinhuanet.com,Dental Hygienist,8184,1836,10020
6301,Nicolette,Toquet,ntoquetg3@ask.com,Legal Assistant,2809,1399,4208
6514,Darryl,Height,dheightg4@princeton.edu,Analog Circuit Design manager,8360,1692,10052
6549,Melissa,D'Alessandro,mdalessandrog5@google.co.jp,Business Systems Development Analyst,1549,608,2157
6013,Junie,Klugel,jklugelg7@fema.gov,Quality Engineer,2087,924,3011
6348,Johnna,Schops,jschopsg8@fotki.com,Financial Analyst,3803,1745,5548
6414,Evangelin,Hillaby,ehillabygb@cbsnews.com,Media Manager I,8845,1152,9997
6605,North,Szymoni,nszymonige@ovh.net,Recruiting Manager,9157,748,9905
6254,Deane,Hamnett,dhamnettgh@hud.gov,Design Engineer,8537,1405,9942
6450,Gan,Raddon,graddongi@instagram.com,Assistant Professor,6940,427,7367
6208,Norrie,Goodlett,ngoodlettgj@youtube.com,Internal Auditor,7731,731,8462
6426,Alfredo,Ritter,arittergk@newsvine.com,Recruiting Manager,1948,1269,3217
6045,Bibbye,Fronczak,bfronczakgl@csmonitor.com,Legal Assistant,8214,971,9185
6387,Edsel,Bryer,ebryergm@phpbb.com,Biostatistician II,3161,1564,4725
6074,Opaline,Paulson,opaulsongp@microsoft.com,Engineer III,4177,480,4657
6010,Tudor,Pail,tpailgt@mashable.com,Graphic Designer,8132,1229,9361
6226,Dallis,Tapply,dtapplygu@ucsd.edu,Food Chemist,8281,908,9189
6889,Alexandrina,Stemp,astemph2@naver.com,Safety Technician III,8473,476,8949
6430,Beverie,Crimpe,bcrimpeh4@furl.net,Chief Design Engineer,8527,478,9005
6342,Chrissie,Kennelly,ckennellyh6@ted.com,Programmer I,6657,1839,8496
6438,Consalve,Bexley,cbexleyh7@blinklist.com,Human Resources Assistant II,4516,984,5500
6236,Raynard,Nano,rnanoh8@answers.com,Structural Analysis Engineer,9318,298,9616
6561,Loralyn,Headley,lheadleyh9@illinois.edu,Design Engineer,5842,269,6111
6076,Marin,Banke,mbankeha@scribd.com,Associate Professor,1557,1664,3221
6570,Hagen,Mizzen,hmizzenhc@ebay.co.uk,Office Assistant I,8043,798,8841
6249,Janna,Reyburn,jreyburnhe@macromedia.com,Software Engineer IV,3816,1866,5682
6970,Korrie,Jirsa,kjirsahf@symantec.com,Nurse Practicioner,6280,941,7221
6210,Lucius,Plaister,lplaisterhg@youtube.com,Payment Adjustment Coordinator,2141,1200,3341
6455,Darius,Stading,dstadinghh@boston.com,Food Chemist,3002,206,3208
6568,Keelby,Camps,kcampshi@hc360.com,Sales Representative,7016,200,7216
6184,Lacey,Cowell,lcowellhj@etsy.com,Tax Accountant,4514,938,5452
6964,Laural,Bestar,lbestarhl@comcast.net,Budget/Accounting Analyst IV,4523,1319,5842
6175,Pembroke,Poulsum,ppoulsumho@dailymail.co.uk,Senior Editor,1845,1786,3631
6576,Pammy,Hillan,phillanhq@harvard.edu,Marketing Assistant,3224,1858,5082
6613,Roberta,Wigley,rwigleyhr@geocities.jp,GIS Technical Architect,3354,652,4006
6726,Adriano,Gorvette,agorvettehs@cafepress.com,Help Desk Operator,5358,761,6119
6956,Jdavie,Mouland,jmoulandht@google.co.jp,Research Assistant III,3993,323,4316
6779,Elia,Steventon,esteventonhw@uol.com.br,Programmer III,8560,1060,9620
6936,Meredithe,Deroche,mderochehz@qq.com,Marketing Manager,6410,927,7337
6776,Sam,Bovey,sboveyi0@google.it,Software Test Engineer IV,1616,1438,3054
6835,Bernetta,Irdale,birdalei4@istockphoto.com,Geologist III,5536,1977,7513
6737,Mathe,Bucke,mbuckei7@europa.eu,Junior Executive,2126,1106,3232
6511,Mitchael,Loadwick,mloadwickid@ocn.ne.jp,Professor,4443,1072,5515
6696,Kaitlin,Learmond,klearmondie@diigo.com,Account Executive,8535,1351,9886
6967,Rennie,Tuddall,rtuddallif@vinaora.com,Clinical Specialist,2839,453,3292
6997,Meier,Ovendon,movendonig@altervista.org,Administrative Officer,6707,616,7323
6548,Jerry,Walwood,jwalwoodih@mashable.com,Senior Sales Associate,4891,1265,6156
6875,Clarisse,Tremollet,ctremolletik@discovery.com,Compensation Analyst,1447,663,2110
6408,Tiena,Syphas,tsyphasil@archive.org,Programmer Analyst II,8518,1943,10461
6862,Keri,Turnell,kturnellim@prlog.org,Editor,3074,1917,4991
6051,Erek,Cowpertwait,ecowpertwaitin@bluehost.com,Health Coach I,8123,1287,9410
6461,Paola,Purcell,ppurcellip@ehow.com,VP Sales,9690,926,10616
6567,Micky,Jeenes,mjeenesir@booking.com,Quality Engineer,1643,626,2269
6197,Shaun,Pennycock,spennycockis@cbsnews.com,Chief Design Engineer,9964,1164,11128
6353,Cullan,Blunsom,cblunsomiv@netscape.com,Staff Accountant I,7548,1396,8944
6526,Jeffy,Cobbing,jcobbingix@pinterest.com,Account Executive,5507,665,6172
6691,Fidelia,Withinshaw,fwithinshawiz@washingtonpost.com,Account Representative IV,4985,1023,6008
6777,Lona,Lilleman,llillemanj0@microsoft.com,Account Coordinator,9454,797,10251
6221,Codie,Brookhouse,cbrookhousej3@bizjournals.com,Director of Sales,7031,888,7919
6958,Irwinn,Spaducci,ispaduccij9@dell.com,GIS Technical Architect,3615,1929,5544
6590,Drucie,Kirman,dkirmanjf@php.net,Biostatistician I,1196,260,1456
6354,Antons,Tampen,atampenjg@mozilla.com,Registered Nurse,5678,710,6388
6166,Sidonnie,Thurner,sthurnerji@tinypic.com,Developer III,1370,902,2272
6911,Kira,McCullouch,kmccullouchjj@google.es,Executive Secretary,2885,743,3628
6722,Ashlan,Littleproud,alittleproudjl@jugem.jp,Nurse,2070,735,2805
6116,Zelma,Drinkale,zdrinkalejm@seattletimes.com,GIS Technical Architect,4183,280,4463
6163,Marylee,Burwood,mburwoodjo@china.com.cn,Graphic Designer,2162,1947,4109
6697,Yelena,Meadus,ymeadusjp@jugem.jp,Associate Professor,7076,689,7765
6072,Jesse,Verryan,jverryanjq@economist.com,Desktop Support Technician,3372,1851,5223
6287,Ginger,Seyers,gseyersjr@weibo.com,Analog Circuit Design manager,6357,1164,7521
6127,Gav,Brumbie,gbrumbiejs@soundcloud.com,Occupational Therapist,3548,575,4123
6982,Misti,Dayley,mdayleyju@123-reg.co.uk,Environmental Specialist,1139,1602,2741
6629,Corty,Klimentyev,cklimentyevjv@globo.com,Pharmacist,9442,1133,10575
6299,Romy,Firpo,rfirpojy@hibu.com,Assistant Media Planner,6695,1507,8202
6900,Bearnard,Fain,bfaink2@psu.edu,Librarian,7031,1202,8233
6603,Brittney,Bartoshevich,bbartoshevichk3@intel.com,Senior Editor,8583,616,9199
6314,Stanton,Cantrell,scantrellk4@livejournal.com,Structural Engineer,8864,496,9360
6905,Sawyer,Sheather,ssheatherk5@yellowbook.com,Financial Advisor,4887,716,5603
6231,Drusilla,Speir,dspeirk6@skype.com,Nuclear Power Engineer,7602,315,7917
6732,Sterling,Frontczak,sfrontczakk9@nhs.uk,Senior Financial Analyst,6052,1862,7914
6160,Erwin,Gasnoll,egasnollkb@ftc.gov,Engineer I,3030,1445,4475
6444,Ivar,Rocks,irockskd@typepad.com,Environmental Tech,2795,1663,4458
6931,Goran,Ronaldson,gronaldsonkf@barnesandnoble.com,VP Marketing,2376,383,2759
6757,Aarika,Vasyunin,avasyuninkh@hhs.gov,VP Quality Control,7085,1478,8563
6853,Elsbeth,Labone,elabonekj@github.io,Clinical Specialist,6508,1740,8248
6340,Sara,Duesbury,sduesburykl@businesswire.com,Paralegal,2123,1727,3850
6234,Oralle,Iglesias,oiglesiaskm@ow.ly,VP Product Management,4607,1085,5692
6404,Juliette,Bliven,jblivenkn@guardian.co.uk,Senior Cost Accountant,6752,1869,8621
6233,Boot,Francescone,bfrancesconeko@mapy.cz,Legal Assistant,7836,1662,9498
6993,Susette,Fedorski,sfedorskikq@networksolutions.com,Community Outreach Specialist,8263,226,8489
6553,Veradis,Ind,vindkr@toplist.cz,Budget/Accounting Analyst III,8092,1395,9487
6345,Meggy,Epton,meptonkt@surveymonkey.com,Accounting Assistant IV,7796,773,8569
6370,Cyb,Knight,cknightkw@deliciousdays.com,Safety Technician I,2624,1211,3835
6983,Corbie,Shakesby,cshakesbykx@admin.ch,Computer Systems Analyst III,9046,1122,10168
6808,Gerrie,Blasing,gblasingky@ehow.com,Internal Auditor,4732,856,5588
6721,Maynard,Bartoloma,mbartolomal0@slate.com,Senior Developer,8919,1691,10610
6672,Wilmar,Rogger,wroggerl2@xinhuanet.com,Design Engineer,5833,451,6284
6228,Rayner,Taunton,rtauntonl3@webeden.co.uk,Research Nurse,2933,368,3301
6159,Federica,Bartholat,fbartholatl4@wordpress.com,Analog Circuit Design manager,5222,508,5730
6036,Nady,Ramsey,nramseyl6@slashdot.org,Payment Adjustment Coordinator,6097,335,6432
6685,Dyanne,Althrope,dalthropel7@slideshare.net,Marketing Manager,2733,1302,4035
6004,Wyn,Iacovone,wiacovonel9@hugedomains.com,VP Product Management,8363,282,8645
6355,Elbertina,Eggerton,eeggertonla@amazonaws.com,VP Sales,3104,903,4007
6597,Gigi,Clemente,gclementelb@dot.gov,Web Developer III,1138,451,1589
6596,Tracie,Paviour,tpaviourlc@cmu.edu,Teacher,1232,1000,2232
6457,Moss,Catt,mcattlq@eventbrite.com,Payment Adjustment Coordinator,8639,1888,10527
6690,Gabbie,Matthisson,gmatthissonls@chron.com,VP Sales,4177,1321,5498
6490,Ashleigh,McComb,amccomblu@taobao.com,Technical Writer,1356,690,2046
6391,Hurleigh,Greengrass,hgreengrasslv@unicef.org,Accounting Assistant II,4130,1838,5968
6028,Rea,Stradling,rstradlinglx@wordpress.org,Analyst Programmer,9163,1163,10326
6510,Marylynne,Hymas,mhymasly@jigsy.com,Programmer III,7733,1863,9596
6439,Ronni,MacCaughan,rmaccaughanm0@state.tx.us,Community Outreach Specialist,6522,778,7300
6132,Findlay,Byneth,fbynethm3@woothemes.com,Senior Sales Associate,9229,1102,10331
6288,Melva,Wrefford,mwreffordm6@topsy.com,Administrative Assistant I,7664,1980,9644
6176,Pearline,Jevon,pjevonm7@tiny.cc,Technical Writer,2642,1241,3883
6212,Ulrich,Boatright,uboatrightm8@joomla.org,Software Test Engineer II,3037,962,3999
6541,Jess,Ebrall,jebrallmc@feedburner.com,VP Product Management,8986,1729,10715
6474,Velvet,Puttergill,vputtergillme@webmd.com,Quality Engineer,6168,963,7131
6912,Avigdor,Barnewall,abarnewallmf@altervista.org,Analog Circuit Design manager,8649,1154,9803
6494,Pavla,Kyrkeman,pkyrkemanmh@microsoft.com,Desktop Support Technician,5707,1524,7231
6056,Fernando,Ludwell,fludwellmj@shop-pro.jp,Product Engineer,8126,1941,10067
6555,Keane,Sprouls,ksproulsmo@merriam-webster.com,Human Resources Assistant III,2313,1335,3648
6881,Sibilla,Treen,streenmq@ebay.co.uk,Programmer I,1353,1866,3219
6273,Kordula,Jefford,kjeffordmr@newyorker.com,Nurse Practicioner,4316,1176,5492
6451,Kaye,Dunbabin,kdunbabinmt@weather.com,Web Designer III,2200,1965,4165
6093,Tyson,Reijmers,treijmersmu@adobe.com,Statistician IV,7007,1309,8316
6619,Hall,Charkham,hcharkhammw@admin.ch,Research Associate,8218,760,8978
6169,Veronika,Gabala,vgabalan4@github.com,Paralegal,6336,502,6838
6671,Rosie,Gulliver,rgullivern5@sogou.com,Librarian,1944,371,2315
6373,Nisse,Candy,ncandyn6@canalblog.com,General Manager,6872,1271,8143
6788,Heidi,Finicj,hfinicjn8@liveinternet.ru,Developer II,8846,1355,10201
6164,Petronille,Aloway,palowayna@ft.com,Internal Auditor,1744,336,2080
6557,Cordelia,Vasquez,cvasqueznb@amazon.com,Sales Representative,3303,1723,5026
6344,Stevena,Berthomier,sberthomiernf@va.gov,Senior Developer,3546,930,4476
6037,Jacklin,Faichnie,jfaichnienh@studiopress.com,Senior Developer,9105,1629,10734
6195,Valry,De Caroli,vdecarolink@admin.ch,Biostatistician III,7656,1488,9144
6271,Flor,Braiden,fbraidennn@hc360.com,Software Test Engineer I,7175,387,7562
6024,Hanson,Wreford,hwrefordno@blogspot.com,Nurse Practicioner,3229,1328,4557
6109,Robinetta,Scotchmur,rscotchmurnt@trellian.com,Accountant II,9704,267,9971
6640,Fraser,Rickesies,frickesiesnu@boston.com,Developer I,5908,491,6399
6919,Kendricks,Delgardo,kdelgardonv@time.com,Internal Auditor,2979,1247,4226
6709,Marco,Ianne,miannenz@archive.org,Community Outreach Specialist,6663,1666,8329
6515,Fidela,Castro,fcastroo0@cam.ac.uk,Paralegal,9946,662,10608
6319,Evered,Berling,eberlingo2@oaic.gov.au,Help Desk Technician,8038,1043,9081
6769,Gnni,Pietrzyk,gpietrzyko4@bloomberg.com,Senior Developer,2188,1607,3795
6298,Anabel,Jeannel,ajeannelo6@yahoo.co.jp,Administrative Assistant II,3868,1139,5007
6837,Vilhelmina,Douris,vdouriso7@baidu.com,Design Engineer,9181,1631,10812
6634,Thurstan,Naylor,tnayloro8@ucsd.edu,Speech Pathologist,3879,784,4663
6440,Thelma,Hanrott,thanrottoa@latimes.com,Research Associate,4789,1257,6046
6523,Shelley,Rawson,srawsonoc@hibu.com,Analog Circuit Design manager,6239,730,6969
6577,Gail,Gladhill,ggladhillod@skype.com,Recruiter,6731,1685,8416
6463,Mick,Stabler,mstableroe@usda.gov,Actuary,3518,1511,5029
6941,Vinita,Huggill,vhuggillof@fastcompany.com,Marketing Assistant,7657,1552,9209
6473,Darla,Mattiato,dmattiatoog@ask.com,Quality Control Specialist,4307,200,4507
6496,Luce,Suttill,lsuttilloh@jiathis.com,Office Assistant III,8048,258,8306
6849,Aeriell,Dent,adentol@histats.com,Electrical Engineer,3420,1405,4825
6055,Antonietta,Hirjak,ahirjakom@princeton.edu,Chief Design Engineer,3405,1452,4857
6649,Ddene,Francey,dfranceyon@networkadvertising.org,Marketing Manager,8076,1690,9766
6988,Christy,Battisson,cbattissonor@wikispaces.com,Registered Nurse,1603,829,2432
6083,Siffre,Greatham,sgreathamos@google.ru,Marketing Manager,7397,1197,8594
6874,Berny,Voce,bvoceou@answers.com,Environmental Specialist,1703,661,2364
6406,Leonora,Pinder,lpinderov@sitemeter.com,Software Consultant,1691,1001,2692
6033,Aurelie,Lowen,alowenox@nifty.com,Associate Professor,9819,612,10431
6458,Thadeus,Amoore,tamoorep0@tripod.com,Biostatistician I,7306,1210,8516
6182,Caresse,Simeons,csimeonsp7@imgur.com,Mechanical Systems Engineer,5919,255,6174
6579,Dorolisa,Trosdall,dtrosdallp9@foxnews.com,Director of Sales,4200,1489,5689
6927,Tandie,Gergely,tgergelypd@github.com,Professor,9703,727,10430
6043,Sheffield,Banton,sbantonpi@lycos.com,Environmental Specialist,7235,1957,9192
6044,Celka,Loffhead,cloffheadpk@goodreads.com,Help Desk Operator,2007,1598,3605
6035,Elisabet,Jepensen,ejepensenpl@prweb.com,Editor,6707,653,7360
6018,Nertie,Dragon,ndragonpm@hexun.com,Design Engineer,7465,1691,9156
6247,Sada,Balderson,sbaldersonpp@kickstarter.com,Health Coach II,6955,1614,8569
6512,Gretel,Yurtsev,gyurtsevpq@tripod.com,Web Developer II,4000,1200,5200
6658,Zandra,Manns,zmannsps@bluehost.com,Desktop Support Technician,2750,643,3393
6121,Jarrad,Banfield,jbanfieldpx@fc2.com,Associate Professor,7859,1079,8938
6462,Pernell,Hodcroft,phodcroftq0@creativecommons.org,Engineer III,3143,868,4011
6840,Anne-marie,Dickey,adickeyq2@angelfire.com,Clinical Specialist,7850,940,8790
6656,Charmion,Cannicott,ccannicottq6@slate.com,Geologist I,1559,599,2158
6635,Wood,Fragino,wfraginoq7@biglobe.ne.jp,Software Consultant,8751,1491,10242
6751,Nissy,Rosewell,nrosewellq8@miibeian.gov.cn,GIS Technical Architect,8730,856,9586
6115,Maegan,Danton,mdantonqb@ed.gov,Dental Hygienist,2343,1292,3635
6203,Arnold,Shewen,ashewenqf@shutterfly.com,Executive Secretary,5182,369,5551
6023,Chelsie,Gornar,cgornarqi@npr.org,Graphic Designer,8475,594,9069
6517,Nonah,Mendus,nmendusql@ca.gov,Web Developer III,5629,228,5857
6587,Perkin,Luter,pluterqm@census.gov,Chief Design Engineer,9128,1988,11116
6965,Zorana,Iashvili,ziashviliqo@tinypic.com,Safety Technician II,4493,1137,5630
6279,Aube,Afonso,aafonsoqp@google.co.jp,Paralegal,3458,218,3676
6193,Aldous,Cundy,acundyqq@pen.io,Staff Scientist,9800,894,10694
6978,Darleen,Connerly,dconnerlyqr@wikimedia.org,Assistant Media Planner,2229,302,2531
6222,Jamie,Soule,jsouleqs@businesswire.com,Research Associate,7303,517,7820
6151,Lynn,Ledward,lledwardqt@samsung.com,Food Chemist,2049,1688,3737
6027,Demetra,Lesslie,dlessliequ@deviantart.com,Payment Adjustment Coordinator,5294,595,5889
6797,Kalvin,Mawby,kmawbyqw@cbslocal.com,Desktop Support Technician,2028,1879,3907
6120,Rivkah,Gumb,rgumbqz@virginia.edu,Senior Developer,5514,1307,6821
6843,Nedi,Cecere,ncecerer0@51.la,GIS Technical Architect,3696,850,4546
6699,Babette,Dumphy,bdumphyr2@patch.com,VP Product Management,2848,1969,4817
6940,Trixi,Cremins,tcreminsr3@cnn.com,Software Consultant,1053,393,1446
6586,Enrichetta,Normansell,enormansellr7@surveymonkey.com,Systems Administrator II,9256,215,9471
6417,Mychal,Motton,mmottonr8@jalbum.net,Paralegal,7689,1433,9122
6106,Gates,Godspeede,ggodspeedera@fastcompany.com,Executive Secretary,8972,1342,10314
6719,Nels,Gilpin,ngilpinrc@about.me,Automation Specialist III,3058,1506,4564
6280,Leicester,Shillan,lshillanrh@imdb.com,Financial Analyst,5407,900,6307
6734,Lynnett,Joskowitz,ljoskowitzrj@time.com,Actuary,1078,1889,2967
6335,Sayers,Coils,scoilsrm@taobao.com,Research Associate,6795,1179,7974
6275,Hyacinthe,Flintoft,hflintoftro@foxnews.com,Information Systems Manager,4097,1163,5260
6156,Jaime,Normadell,jnormadellrp@posterous.com,Assistant Professor,2825,1269,4094
7812,Archibold,McAloren,amcaloren0@wordpress.org,Programmer III,6953,1612,8565
7247,Wernher,Slowgrove,wslowgrove1@phoca.cz,Data Coordiator,1841,342,2183
7674,Hedda,Petrelli,hpetrelli2@surveymonkey.com,Sales Associate,7687,1376,9063
7375,Nowell,Furber,nfurber3@comsenz.com,Media Manager II,2778,742,3520
7639,Reynolds,Huffey,rhuffey4@over-blog.com,Graphic Designer,4406,732,5138
7718,Eberto,Howsan,ehowsan5@google.de,Tax Accountant,5175,1089,6264
7858,Cirstoforo,Harle,charle6@wix.com,Internal Auditor,7178,1118,8296
7828,Dionne,Gruby,dgruby7@biglobe.ne.jp,Technical Writer,6406,1019,7425
7155,Gisela,Bewshea,gbewshea8@acquirethisname.com,Payment Adjustment Coordinator,9986,843,10829
7860,Elianore,Papworth,epapworth9@fema.gov,Account Representative I,2663,514,3177
7459,Cleon,Baudet,cbaudeta@walmart.com,Media Manager I,9542,1878,11420
7870,Constanta,Claypoole,cclaypooleb@cdbaby.com,Teacher,6254,448,6702
7883,Dorian,Ranby,dranbyc@photobucket.com,Assistant Professor,1844,537,2381
7168,Geordie,Trevance,gtrevanced@devhub.com,Legal Assistant,5179,647,5826
7859,Oralle,Aucock,oaucocke@yahoo.co.jp,Community Outreach Specialist,5770,1336,7106
7534,George,Sanson,gsansonf@ning.com,Human Resources Assistant II,9095,1493,10588
7283,Peter,Berends,pberendsg@google.cn,Speech Pathologist,4153,555,4708
7056,Shandie,Hillhouse,shillhouseh@delicious.com,Graphic Designer,3328,334,3662
7502,Wandis,Rounsivall,wrounsivalli@networksolutions.com,Cost Accountant,4012,1736,5748
7423,Carlos,Chopping,cchoppingj@amazon.co.uk,Mechanical Systems Engineer,4846,536,5382
7818,Bethena,Smye,bsmyek@deviantart.com,Senior Financial Analyst,8601,200,8801
7793,Aleda,Metzing,ametzingl@delicious.com,Media Manager IV,2998,1202,4200
7422,Carson,Head,cheadm@sitemeter.com,Editor,3262,564,3826
7838,Ebenezer,Elwill,eelwilln@pbs.org,Web Developer I,6793,1735,8528
7483,Filberte,Osmant,fosmanto@unc.edu,Internal Auditor,8942,456,9398
7566,Antoine,Furney,afurneyp@drupal.org,Administrative Assistant I,2831,441,3272
7831,Salomi,de Quincey,sdequinceyq@unc.edu,Cost Accountant,6226,309,6535
7427,Lenka,Fugere,lfugerer@elpais.com,VP Quality Control,1924,203,2127
7612,Cozmo,Taveriner,ctaveriners@census.gov,Biostatistician II,8156,1000,9156
7032,Jamie,Moulsdale,jmoulsdaleu@mayoclinic.com,VP Product Management,8861,1836,10697
7416,Urbanus,Norville,unorvillev@economist.com,Analog Circuit Design manager,8669,1028,9697
7514,Vi,Domenc,vdomencw@comsenz.com,Legal Assistant,5964,1980,7944
7043,Aurora,Lembke,alembkex@cloudflare.com,Occupational Therapist,1313,1479,2792
7802,Mikol,Wakenshaw,mwakenshawy@last.fm,Operator,9096,454,9550
7990,Min,Monget,mmongetz@wired.com,Structural Analysis Engineer,9817,977,10794
7235,Caesar,Lindblom,clindblom10@statcounter.com,General Manager,3078,1326,4404
7908,Micheline,Trewett,mtrewett11@soundcloud.com,Office Assistant IV,3279,1562,4841
7403,Cristin,Hanalan,chanalan12@princeton.edu,Assistant Manager,7867,1041,8908
7584,Laurianne,Risborough,lrisborough13@wikia.com,Internal Auditor,2606,1638,4244
7309,Gert,McKnish,gmcknish14@amazon.de,Teacher,9153,881,10034
7034,Ardella,Lyall,alyall15@msu.edu,Automation Specialist II,9341,1607,10948
7096,Hedda,Bute,hbute16@exblog.jp,Graphic Designer,1766,951,2717
7026,Hamlen,Lotterington,hlotterington17@g.co,Chemical Engineer,4806,293,5099
7647,Sharline,Perch,sperch18@utexas.edu,Analyst Programmer,4377,1501,5878
7251,Shirleen,Merfin,smerfin19@latimes.com,Pharmacist,3563,1752,5315
7340,Vito,Perrat,vperrat1a@elegantthemes.com,Marketing Assistant,2224,429,2653
7562,Delano,Acklands,dacklands1b@liveinternet.ru,Business Systems Development Analyst,6838,1058,7896
7066,Pierce,Lemmers,plemmers1c@123-reg.co.uk,Account Coordinator,4786,1320,6106
7606,Byrom,Lettsom,blettsom1d@clickbank.net,Actuary,1627,207,1834
7776,Bette,Tester,btester1e@mail.ru,Legal Assistant,5506,1542,7048
7786,Ros,Bemlott,rbemlott1f@homestead.com,Executive Secretary,7031,335,7366
7160,Natalie,Grimolbie,ngrimolbie1g@fda.gov,Assistant Media Planner,8900,1783,10683
7306,Bibbye,Wildsmith,bwildsmith1h@howstuffworks.com,GIS Technical Architect,9575,1723,11298
7131,Kayla,Bidewell,kbidewell1i@soundcloud.com,Administrative Officer,7000,1025,8025
7104,Stace,Moylane,smoylane1j@gmpg.org,Clinical Specialist,7823,1801,9624
7374,Ester,Chapple,echapple1k@youtube.com,Web Developer IV,2226,1273,3499
7704,Sidonia,Cobley,scobley1l@sakura.ne.jp,Internal Auditor,1283,569,1852
7548,Findley,Batiste,fbatiste1m@ted.com,Associate Professor,9186,1930,11116
7941,Chancey,Ickeringill,cickeringill1n@blogs.com,VP Marketing,3872,1068,4940
7556,Olivia,Tonge,otonge1o@army.mil,Desktop Support Technician,1066,580,1646
7694,Wiley,Eck,weck1p@adobe.com,Nurse,8587,1591,10178
7352,Amelina,McKevitt,amckevitt1q@yahoo.co.jp,Project Manager,9076,1038,10114
7270,Philis,Geharke,pgeharke1r@cnn.com,Food Chemist,9767,627,10394
7890,Jaynell,Racher,jracher1s@telegraph.co.uk,VP Accounting,8706,794,9500
7192,Herve,Bleier,hbleier1t@bloglovin.com,Information Systems Manager,8946,894,9840
7580,Chrissy,Meeland,cmeeland1u@hp.com,Software Engineer I,8486,774,9260
7082,Alie,Nemchinov,anemchinov1v@so-net.ne.jp,Executive Secretary,3138,1689,4827
7045,Anstice,Biaggiotti,abiaggiotti1w@printfriendly.com,Staff Scientist,3501,478,3979
7554,Wilhelmine,Wisby,wwisby1x@yellowbook.com,Graphic Designer,1185,1478,2663
7080,Nealon,Lopes,nlopes1z@about.com,Sales Representative,2877,677,3554
7913,Lyman,Vise,lvise20@spotify.com,Quality Engineer,1408,721,2129
7743,Tawnya,Rollett,trollett21@usda.gov,Mechanical Systems Engineer,9405,246,9651
7227,Kele,Deedes,kdeedes22@jiathis.com,Physical Therapy Assistant,8406,1088,9494
7675,Velvet,Andriss,vandriss23@odnoklassniki.ru,Administrative Assistant I,4528,1887,6415
7977,Alison,Chave,achave25@bigcartel.com,Community Outreach Specialist,3477,1124,4601
8000,Gabby,Kittless,gkittless27@nih.gov,Software Engineer III,9394,238,9632
7799,Spike,Paxforde,spaxforde28@discuz.net,Web Developer IV,3558,1853,5411
7121,Nevsa,Abelevitz,nabelevitz29@alexa.com,Geologist IV,6764,1642,8406
7022,Astrix,Bohey,abohey2a@usgs.gov,Sales Associate,2121,1905,4026
7539,Ulrick,MacCulloch,umacculloch2b@va.gov,Speech Pathologist,1709,1430,3139
7953,Fredric,Farquharson,ffarquharson2d@seattletimes.com,Senior Quality Engineer,2057,1725,3782
7207,Erena,Creese,ecreese2f@intel.com,Senior Financial Analyst,1471,430,1901
7401,Ofelia,Accum,oaccum2g@indiegogo.com,Nuclear Power Engineer,8280,286,8566
7693,Daphene,Lailey,dlailey2h@usatoday.com,Office Assistant I,6049,1699,7748
7261,Cleopatra,Inston,cinston2i@reddit.com,Tax Accountant,8664,1937,10601
7697,Leia,Kment,lkment2j@walmart.com,Editor,5581,209,5790
7738,Arabella,Pau,apau2k@reddit.com,Social Worker,4218,1174,5392
7662,Gage,Eyckel,geyckel2l@gov.uk,Payment Adjustment Coordinator,6874,579,7453
7634,Adey,Hacquoil,ahacquoil2m@cmu.edu,Registered Nurse,4150,1260,5410
7463,Rad,Goodyear,rgoodyear2n@hud.gov,Registered Nurse,7632,1079,8711
7015,Lauryn,Barltrop,lbarltrop2o@printfriendly.com,Director of Sales,1729,1394,3123
7670,Lezley,Slaight,lslaight2p@scientificamerican.com,Nuclear Power Engineer,8204,1235,9439
7973,Aryn,Gurton,agurton2q@imageshack.us,Associate Professor,4025,606,4631
7240,Christiano,De Clairmont,cdeclairmont2r@archive.org,Recruiting Manager,1294,1001,2295
7545,Mitch,Szymaniak,mszymaniak2t@youku.com,Structural Engineer,4389,1491,5880
7636,Sandye,Handscomb,shandscomb2u@histats.com,Project Manager,6850,1587,8437
7519,Gracia,Sanbroke,gsanbroke2v@lycos.com,Speech Pathologist,8859,1624,10483
7239,Ed,Mothersdale,emothersdale2w@netlog.com,Help Desk Technician,6463,1971,8434
7462,Melly,Press,mpress2x@tripod.com,Cost Accountant,5069,967,6036
7317,Coleman,Gypps,cgypps2y@dell.com,Structural Analysis Engineer,1266,1387,2653
7238,Tamiko,Brun,tbrun2z@examiner.com,Computer Systems Analyst I,4704,1742,6446
7568,Manny,Shalders,mshalders31@amazon.co.jp,Budget/Accounting Analyst IV,7675,786,8461
7367,Sissie,Norssister,snorssister32@goodreads.com,Product Engineer,8352,687,9039
7349,Erhart,Gosneye,egosneye33@meetup.com,Software Consultant,2448,1911,4359
7964,Nancey,Mingey,nmingey34@spotify.com,Compensation Analyst,8320,937,9257
7101,Ludovico,Loody,lloody36@hatena.ne.jp,Speech Pathologist,7547,1063,8610
7505,Guinna,Eykelhof,geykelhof37@mediafire.com,Senior Sales Associate,2658,304,2962
7811,Karoline,McLeman,kmcleman39@irs.gov,Editor,1694,337,2031
7257,Jacenta,Atty,jatty3a@purevolume.com,Assistant Media Planner,6976,736,7712
7635,Wilton,Aynold,waynold3b@odnoklassniki.ru,Internal Auditor,3862,737,4599
7616,Tim,Grube,tgrube3c@slashdot.org,Biostatistician III,9609,704,10313
7229,Freddie,Postles,fpostles3d@theatlantic.com,Data Coordiator,6318,1055,7373
7493,Klara,Jacobowitz,kjacobowitz3e@hud.gov,Recruiter,4111,909,5020
7673,Aurora,Brimming,abrimming3f@oakley.com,VP Accounting,2836,1498,4334
7578,Brody,Meatcher,bmeatcher3g@zimbio.com,Human Resources Manager,6484,1261,7745
7139,Marilin,Atling,matling3h@google.nl,Human Resources Assistant IV,4713,1377,6090
7501,Darill,Heustace,dheustace3i@deviantart.com,Pharmacist,2764,218,2982
7378,Phillis,Perotti,pperotti3j@mtv.com,Accounting Assistant IV,8242,274,8516
7321,Jerry,Caughan,jcaughan3k@acquirethisname.com,Programmer Analyst II,8537,1119,9656
7314,Nanine,Normanvill,nnormanvill3l@utexas.edu,Teacher,2257,1680,3937
7313,Gilligan,Tackley,gtackley3m@meetup.com,Environmental Specialist,7678,1039,8717
7165,Bili,Millson,bmillson3n@mail.ru,Civil Engineer,7121,1736,8857
7469,Malcolm,Cockshut,mcockshut3o@zimbio.com,Software Consultant,2465,616,3081
7698,Tommie,Hulland,thulland3p@whitehouse.gov,Junior Executive,4021,1846,5867
7949,Rhona,Housin,rhousin3q@oracle.com,Recruiter,8089,784,8873
7709,Blair,Iles,biles3r@goodreads.com,Programmer I,2132,1497,3629
7823,Marcel,Elcum,melcum3s@cdc.gov,Cost Accountant,3117,936,4053
7788,Marys,Winspire,mwinspire3t@ft.com,Librarian,3700,944,4644
7343,Julee,Stockhill,jstockhill3u@tumblr.com,Software Engineer II,1956,289,2245
7357,Katleen,O'Gavin,kogavin3v@nps.gov,Web Developer IV,6564,236,6800
7557,Dolly,Newnham,dnewnham3w@meetup.com,VP Marketing,3075,1574,4649
7398,Jacintha,Giacobini,jgiacobini3x@myspace.com,Environmental Specialist,2946,565,3511
7804,Maegan,Durrand,mdurrand3y@tmall.com,Data Coordiator,1434,332,1766
7204,Quinton,Trowsdale,qtrowsdale3z@skype.com,Product Engineer,5327,773,6100
7163,Nan,Butrimovich,nbutrimovich40@etsy.com,Operator,4575,291,4866
7196,Budd,Leggott,bleggott41@ycombinator.com,Structural Analysis Engineer,4423,818,5241
7740,Lotty,Inkin,linkin43@icio.us,Media Manager II,2673,1253,3926
7144,Dione,Jordin,djordin44@unesco.org,Human Resources Manager,1476,1028,2504
7016,Gabby,Gownge,ggownge46@cafepress.com,Desktop Support Technician,8056,657,8713
7685,Janith,Klass,jklass47@yellowbook.com,Help Desk Technician,2099,866,2965
7791,Alleyn,Hasnip,ahasnip48@sakura.ne.jp,Editor,4290,1180,5470
7471,Neile,Camelia,ncamelia4a@barnesandnoble.com,Speech Pathologist,4474,954,5428
7494,Kelly,Ferres,kferres4b@craigslist.org,Senior Sales Associate,8330,1145,9475
7479,Wilona,Smithin,wsmithin4c@usnews.com,Associate Professor,5506,589,6095
7337,Letta,Ethelstone,lethelstone4d@nytimes.com,Project Manager,4371,1126,5497
7399,Padriac,Senchenko,psenchenko4e@umn.edu,Marketing Assistant,2212,1183,3395
7855,Loise,Burkitt,lburkitt4g@nyu.edu,VP Quality Control,5648,1399,7047
7585,Nicolais,Hune,nhune4h@engadget.com,Senior Quality Engineer,1039,1301,2340
7699,Laetitia,Ducker,lducker4i@arstechnica.com,Help Desk Operator,6005,1412,7417
7122,Marietta,Egdale,megdale4j@blogger.com,Human Resources Manager,4910,1540,6450
7535,Garv,O' Donohue,godonohue4k@godaddy.com,Social Worker,9594,1445,11039
7914,Miguel,Rupp,mrupp4l@reference.com,VP Accounting,9423,822,10245
7397,Gerhardine,Elegood,gelegood4n@google.fr,Assistant Manager,5566,788,6354
7515,Leela,Ricardou,lricardou4o@thetimes.co.uk,Geological Engineer,3867,1630,5497
7279,Sydney,Lotwich,slotwich4r@state.tx.us,Health Coach IV,4711,1694,6405
7936,Merwyn,Attard,mattard4s@gnu.org,Health Coach IV,1682,1214,2896
7689,Lonnie,Vinnicombe,lvinnicombe4t@mayoclinic.com,Pharmacist,5797,657,6454
7622,Letitia,Rickerby,lrickerby4u@biblegateway.com,Staff Scientist,2522,1751,4273
7455,Estrellita,Stoll,estoll4v@github.com,Desktop Support Technician,8317,1203,9520
7407,Fidela,Adin,fadin4w@cnn.com,Cost Accountant,7487,798,8285
7491,Fernande,Lennie,flennie4x@ocn.ne.jp,Nurse Practicioner,4278,1753,6031
7513,Reyna,Saket,rsaket4y@time.com,Social Worker,5807,279,6086
7190,Selby,Paal,spaal4z@bizjournals.com,Social Worker,1895,1187,3082
7832,Isa,Impy,iimpy50@macromedia.com,Help Desk Operator,8354,1202,9556
7390,Hesther,Boake,hboake51@auda.org.au,Geological Engineer,3709,774,4483
7162,Sonny,Pitkaithly,spitkaithly52@github.io,Senior Developer,6191,1489,7680
7312,Jazmin,Strutley,jstrutley54@boston.com,Nuclear Power Engineer,1427,1433,2860
7055,Ward,Rawcliff,wrawcliff55@freewebs.com,Environmental Tech,8486,920,9406
7282,Rhodia,Shackesby,rshackesby56@cmu.edu,Social Worker,4980,403,5383
7620,Fanni,Gaven,fgaven57@sourceforge.net,Database Administrator III,9262,411,9673
7728,Ainsley,MacGee,amacgee59@unesco.org,Graphic Designer,6927,1876,8803
7805,Micky,Stobbs,mstobbs5a@java.com,Software Engineer II,2742,1348,4090
7344,Angelita,McKinn,amckinn5b@wunderground.com,General Manager,6744,1521,8265
7920,Nathanial,Imlock,nimlock5c@yolasite.com,Senior Editor,1911,1994,3905
7782,Barry,Winfred,bwinfred5d@geocities.jp,Nurse Practicioner,1954,1486,3440
7916,Randal,Standish,rstandish5f@technorati.com,Project Manager,3478,1682,5160
7197,Valentia,Cardenas,vcardenas5g@opera.com,Account Coordinator,8472,873,9345
7331,Alberto,Sowrey,asowrey5h@exblog.jp,Director of Sales,1862,242,2104
7815,Bev,Brolly,bbrolly5i@reddit.com,Statistician II,8856,1866,10722
7597,Merna,Lintall,mlintall5j@ebay.co.uk,Statistician I,3145,1305,4450
7726,Lizzie,Tinan,ltinan5l@posterous.com,Director of Sales,3115,883,3998
7012,Franky,Propper,fpropper5m@google.it,Programmer I,4591,640,5231
7298,Norina,Ellcock,nellcock5o@twitpic.com,Accounting Assistant IV,4827,997,5824
7078,Christie,Dusey,cdusey5p@deliciousdays.com,Nurse,6064,1712,7776
7356,Sela,Pagin,spagin5q@blinklist.com,Information Systems Manager,5245,539,5784
7214,Boycie,Archbald,barchbald5s@intel.com,Electrical Engineer,4621,1099,5720
7069,Estella,Hopfner,ehopfner5u@google.co.jp,Statistician II,2445,1980,4425
7093,Filmer,Pinsent,fpinsent5v@fc2.com,Account Executive,4947,1412,6359
7915,Cheston,Gravener,cgravener5w@spiegel.de,Dental Hygienist,5820,1006,6826
7242,Davon,Knox,dknox5x@lycos.com,Budget/Accounting Analyst IV,7436,1936,9372
7965,Shaine,Pawel,spawel5y@flavors.me,Senior Cost Accountant,5797,762,6559
7091,Martha,Ackeroyd,mackeroyd5z@people.com.cn,GIS Technical Architect,1802,1204,3006
7166,Gauthier,Bardnam,gbardnam60@hao123.com,Paralegal,3648,654,4302
7541,Huntington,Holah,hholah62@businessinsider.com,Research Associate,6613,500,7113
7325,Kain,Scolland,kscolland65@economist.com,Budget/Accounting Analyst I,7048,1456,8504
7412,Orland,Meuse,omeuse66@about.me,Marketing Assistant,3675,602,4277
7102,Sid,Patshull,spatshull67@accuweather.com,Engineer III,9209,1131,10340
7083,Doti,Shugg,dshugg69@jugem.jp,Help Desk Operator,3034,1095,4129
7849,Ivett,Tyres,ityres6a@sogou.com,Staff Scientist,1625,651,2276
7848,Georgena,Mellmoth,gmellmoth6b@baidu.com,Electrical Engineer,4752,735,5487
7304,Loydie,Blesing,lblesing6e@google.co.uk,Research Assistant III,6834,601,7435
7713,Sybille,Anstee,sanstee6f@home.pl,Occupational Therapist,5869,430,6299
7057,Peggy,Allsup,pallsup6g@geocities.com,Business Systems Development Analyst,5481,700,6181
7528,Peyton,Kulvear,pkulvear6h@stumbleupon.com,Human Resources Assistant III,1719,1657,3376
7961,Virgina,Barbery,vbarbery6i@google.com.au,Help Desk Technician,3427,1667,5094
7851,Bernardo,Yaakov,byaakov6j@mysql.com,Payment Adjustment Coordinator,1046,1622,2668
7995,Kristel,Scandrett,kscandrett6k@imageshack.us,Environmental Tech,8849,1737,10586
7359,Kearney,Tolhurst,ktolhurst6m@engadget.com,Environmental Specialist,1837,1467,3304
7006,Eda,Gabbot,egabbot6n@cbc.ca,Research Nurse,4247,665,4912
7211,Dora,Garr,dgarr6o@purevolume.com,VP Quality Control,1511,1845,3356
7950,Gaye,Winteringham,gwinteringham6p@arizona.edu,Health Coach II,9620,1224,10844
7592,Gail,Matthesius,gmatthesius6q@dedecms.com,Chemical Engineer,3378,221,3599
7020,Urbano,Pulley,upulley6s@is.gd,Human Resources Manager,7590,1568,9158
7702,Gian,Dreye,gdreye6u@japanpost.jp,Junior Executive,6996,414,7410
7762,Tillie,Varker,tvarker6v@g.co,Structural Analysis Engineer,4839,403,5242
7330,Marleah,Fuzzey,mfuzzey6w@abc.net.au,Chief Design Engineer,2170,1451,3621
7523,Nev,Janodet,njanodet6x@walmart.com,Pharmacist,3940,1375,5315
7774,Arlen,Tour,atour6y@topsy.com,Senior Sales Associate,6344,1955,8299
7671,Chauncey,Vittet,cvittet6z@gmpg.org,Structural Engineer,3508,1841,5349
7233,Ronnie,Frangione,rfrangione70@jimdo.com,Automation Specialist III,8196,1530,9726
7735,Boycie,Brik,bbrik71@ibm.com,Research Associate,2674,405,3079
7428,Kellia,Tenby,ktenby73@slideshare.net,Engineer III,9197,1524,10721
7454,Myrna,Alldred,malldred74@abc.net.au,Executive Secretary,2046,1670,3716
7206,Patrica,Robey,probey75@google.nl,Help Desk Operator,9277,816,10093
7342,Francene,Couvet,fcouvet76@dot.gov,Cost Accountant,6456,1640,8096
7031,Willdon,Conry,wconry77@cloudflare.com,Legal Assistant,6687,1404,8091
7752,Raymund,Benediktovich,rbenediktovich78@bloglines.com,Senior Financial Analyst,7669,1868,9537
7929,Uriah,Pickburn,upickburn79@ocn.ne.jp,Teacher,8017,1467,9484
7599,Kathie,Dowbakin,kdowbakin7a@mtv.com,Financial Analyst,2574,1687,4261
7001,Salem,Barford,sbarford7b@weibo.com,Staff Scientist,1165,1984,3149
7113,Mannie,Camin,mcamin7c@jiathis.com,Software Consultant,5002,726,5728
7645,Laney,Laste,llaste7d@accuweather.com,Human Resources Assistant I,9304,898,10202
7230,Emmalee,Rodear,erodear7f@tmall.com,Speech Pathologist,5552,638,6190
7868,Rudiger,Frodsham,rfrodsham7g@msu.edu,Nurse Practicioner,2417,1984,4401
7902,Katti,Hinks,khinks7h@nationalgeographic.com,Account Representative IV,2491,469,2960
7220,Tammara,Legg,tlegg7i@bravesites.com,Assistant Professor,9432,395,9827
7875,Valaree,Gunner,vgunner7j@yandex.ru,Quality Engineer,2205,752,2957
7714,Alleen,Feldklein,afeldklein7k@nifty.com,Financial Advisor,2813,1512,4325
7500,Hymie,Dami,hdami7l@fotki.com,Accounting Assistant III,6145,1450,7595
7213,Lemmie,Leyton,lleyton7m@skyrock.com,Associate Professor,9692,743,10435
7017,Warden,Durbin,wdurbin7n@symantec.com,Staff Accountant II,2234,867,3101
7182,Sharl,Shawdforth,sshawdforth7p@prlog.org,Research Associate,8455,1836,10291
7624,Rebbecca,Brimm,rbrimm7q@msn.com,Administrative Officer,9725,322,10047
7583,Ginevra,Heims,gheims7t@quantcast.com,Librarian,1942,1584,3526
7651,Deva,Fulle,dfulle7u@indiatimes.com,General Manager,3103,528,3631
7817,Crista,Klimkin,cklimkin7x@tiny.cc,Project Manager,3652,1807,5459
7586,Rory,Rodwell,rrodwell7y@discovery.com,Health Coach III,4542,710,5252
7191,Loreen,Cunliffe,lcunliffe7z@fotki.com,Research Associate,8124,1523,9647
7267,Clint,Jezzard,cjezzard80@angelfire.com,Mechanical Systems Engineer,4806,841,5647
7003,Truda,Radden,tradden82@yandex.ru,Compensation Analyst,4803,861,5664
7904,Webb,Betun,wbetun83@clickbank.net,Senior Cost Accountant,6835,1764,8599
7900,Barbara,Abramchik,babramchik84@phoca.cz,Structural Engineer,3388,1880,5268
7042,Alexandrina,Loch,aloch86@cdbaby.com,Quality Control Specialist,6781,1058,7839
7753,Cicely,Chesney,cchesney88@constantcontact.com,Software Engineer IV,2235,1509,3744
7751,Lem,Gronowe,lgronowe89@123-reg.co.uk,Food Chemist,3314,1671,4985
7760,Portia,Passie,ppassie8a@photobucket.com,Programmer Analyst I,3282,874,4156
7518,Tera,Durant,tdurant8b@amazon.co.uk,Senior Editor,5969,348,6317
7993,Cathee,Steinson,csteinson8d@abc.net.au,Community Outreach Specialist,7675,1846,9521
7476,Hillery,Riply,hriply8e@naver.com,Structural Analysis Engineer,3156,1169,4325
7273,Candi,Ball,cball8f@ox.ac.uk,Human Resources Manager,1436,1361,2797
7499,Annnora,Sleigh,asleigh8g@youku.com,Compensation Analyst,1674,1389,3063
7765,Selma,Kopje,skopje8j@4shared.com,Assistant Media Planner,7837,1329,9166
7896,Marjy,Sheen,msheen8k@google.co.jp,Human Resources Manager,1100,1614,2714
7328,Donni,Shilvock,dshilvock8l@paginegialle.it,Quality Engineer,6878,1002,7880
7669,Gale,Kennicott,gkennicott8n@dyndns.org,Software Consultant,1205,1740,2945
7145,Allyson,Einchcombe,aeinchcombe8o@eventbrite.com,General Manager,2509,1530,4039
7561,Alvira,Geraghty,ageraghty8p@gmpg.org,Geological Engineer,9450,1178,10628
7353,Belvia,Sneezum,bsneezum8q@google.pl,Business Systems Development Analyst,5978,1207,7185
7640,Thibaut,Layus,tlayus8r@51.la,Registered Nurse,7431,996,8427
7991,Gianina,Cicchitello,gcicchitello8s@ucsd.edu,Community Outreach Specialist,7704,1678,9382
7417,Jaquith,Edmand,jedmand8t@sogou.com,Web Developer III,6913,1100,8013
7030,Grenville,Lees,glees8u@tuttocitta.it,Software Engineer I,9192,1382,10574
7086,Rici,Pickerell,rpickerell8v@elegantthemes.com,Senior Developer,5186,202,5388
7049,Cary,Cuxon,ccuxon8w@admin.ch,Nurse Practicioner,3320,754,4074
7504,Elsa,Nunson,enunson8x@shop-pro.jp,Assistant Manager,8467,1656,10123
7077,Gwenny,Gillham,ggillham8y@phpbb.com,Programmer Analyst III,5099,1176,6275
7370,Shurlocke,Lindup,slindup8z@unc.edu,Registered Nurse,8283,770,9053
7631,Rozina,Pavlishchev,rpavlishchev91@redcross.org,Civil Engineer,2376,1866,4242
7492,Lana,Butterick,lbutterick93@fema.gov,Research Associate,9745,595,10340
7901,Hesther,Vauls,hvauls94@sun.com,Speech Pathologist,8515,1795,10310
7105,Thibaud,Bryson,tbryson9a@home.pl,Systems Administrator II,2803,396,3199
7264,Evania,Woollett,ewoollett9d@eepurl.com,Help Desk Operator,3950,876,4826
7880,Adriena,Jamrowicz,ajamrowicz9g@usa.gov,Sales Representative,9000,981,9981
7243,Benoit,Surmeir,bsurmeir9i@altervista.org,Food Chemist,7555,1335,8890
7019,Martin,McKennan,mmckennan9j@w3.org,Research Assistant II,4101,602,4703
7064,Rainer,Basketfield,rbasketfield9k@mashable.com,Tax Accountant,1135,1080,2215
7627,Bondie,Francesco,bfrancesco9l@examiner.com,Staff Accountant II,6410,1962,8372
7351,Kinna,Steptow,ksteptow9m@shinystat.com,Physical Therapy Assistant,7829,880,8709
7642,Brandi,Dyball,bdyball9n@bloglines.com,Librarian,3617,957,4574
7368,Nanete,Balducci,nbalducci9o@free.fr,Administrative Officer,8527,1699,10226
7641,Reamonn,Gamage,rgamage9p@spotify.com,Marketing Manager,9843,1556,11399
7692,Ethelind,Fenty,efenty9q@pagesperso-orange.fr,Staff Scientist,4057,436,4493
7383,Merwin,Rainer,mrainer9r@paginegialle.it,Quality Engineer,9018,1124,10142
7198,Benton,Marzelo,bmarzelo9s@elpais.com,Teacher,7473,1392,8865
7683,Jackelyn,Toten,jtoten9w@gravatar.com,Research Assistant I,7744,1617,9361
7722,Mellisa,Aiers,maiers9x@last.fm,Junior Executive,1976,1982,3958
7070,Loren,Glennon,lglennon9y@smh.com.au,Health Coach I,7363,1941,9304
7218,Marja,Giovanetti,mgiovanettia0@4shared.com,Cost Accountant,1099,249,1348
7472,Pacorro,Parmby,pparmbya2@va.gov,Research Associate,9766,1380,11146
7691,Kala,Bolger,kbolgera3@jiathis.com,Graphic Designer,7157,1614,8771
7460,Brennen,Houlison,bhoulisona4@netscape.com,VP Accounting,3126,270,3396
7529,Patrizio,Patria,ppatriaa5@mac.com,Administrative Officer,2315,812,3127
7773,Bari,Syplus,bsyplusa6@comsenz.com,Sales Representative,9191,1352,10543
7892,Dot,Goulthorp,dgoulthorpa7@t.co,Analog Circuit Design manager,1128,900,2028
7687,Theodor,Parkyn,tparkyna9@tmall.com,Associate Professor,3703,1413,5116
7128,Hollie,Dymocke,hdymockeab@cafepress.com,Teacher,9491,944,10435
7415,Jessie,Philipson,jphilipsonad@jimdo.com,Speech Pathologist,2104,1542,3646
7679,Maggee,Frenzl,mfrenzlae@flickr.com,Electrical Engineer,7598,1174,8772
7731,Malcolm,De Filippo,mdefilippoaf@squarespace.com,VP Quality Control,6842,1107,7949
7866,Mariam,Andryszczak,mandryszczakah@cmu.edu,Database Administrator II,8697,965,9662
7696,Ebenezer,Bough,eboughaj@xinhuanet.com,Developer III,4099,969,5068
7947,Vince,Howle,vhowleak@soup.io,Professor,6158,1073,7231
7148,Alisun,Curwood,acurwoodal@tripadvisor.com,Senior Quality Engineer,3792,1545,5337
7231,Zared,Maso,zmasoam@sourceforge.net,Nurse,2814,678,3492
7496,Zaria,Taffrey,ztaffreyan@alibaba.com,Web Designer II,1552,1549,3101
7659,Cass,Burrett,cburrettao@europa.eu,Financial Advisor,6827,1465,8292
7899,Malcolm,Silversmidt,msilversmidtap@accuweather.com,Research Assistant III,3401,203,3604
7560,Clarine,Chesterfield,cchesterfieldas@google.pl,Programmer Analyst I,4836,820,5656
7061,Tricia,Slaght,tslaghtau@csmonitor.com,Senior Cost Accountant,7104,1517,8621
7667,Karleen,Muscroft,kmuscroftay@fema.gov,Operator,6906,294,7200
7856,Mil,O'Sheerin,mosheerinb0@cocolog-nifty.com,Senior Sales Associate,4896,1834,6730
7047,Min,Jaukovic,mjaukovicb1@wunderground.com,Web Developer II,9332,253,9585
7053,Cordie,Fullylove,cfullyloveb2@opera.com,Marketing Assistant,4356,601,4957
7437,Shaylynn,Kinner,skinnerb4@furl.net,Research Associate,7094,542,7636
7258,Flossy,Fraschini,ffraschinib5@washington.edu,Clinical Specialist,8289,1551,9840
7721,Amaleta,Duplock,aduplockb6@engadget.com,Account Representative III,7125,688,7813
7527,Brittne,Sholl,bshollb9@jiathis.com,Clinical Specialist,9772,1274,11046
7575,Pall,Shallcroff,pshallcroffba@redcross.org,Nurse,9357,1589,10946
7481,Yardley,Oene,yoenebe@sourceforge.net,Staff Scientist,1137,240,1377
7984,Abdel,Blatherwick,ablatherwickbf@themeforest.net,VP Product Management,2665,1442,4107
7976,Lothario,Pargiter,lpargiterbg@pen.io,Research Assistant IV,6004,1220,7224
7477,Vasilis,Barajas,vbarajasbh@about.com,Developer IV,7731,640,8371
7593,Adele,Worviell,aworviellbi@barnesandnoble.com,Financial Advisor,2134,851,2985
7467,Annabel,Londer,alonderbj@sun.com,Assistant Media Planner,2379,1842,4221
7076,Tisha,Harhoff,tharhoffbl@scribd.com,Sales Associate,1940,1902,3842
7690,Mallorie,Brayshaw,mbrayshawbo@histats.com,Community Outreach Specialist,6709,759,7468
7272,Derril,Guislin,dguislinbq@technorati.com,Human Resources Manager,8958,1253,10211
7912,Marguerite,Ech,mechbr@bloglovin.com,Software Consultant,9357,1288,10645
7074,Fairfax,Mc Ilwrick,fmcilwrickbs@timesonline.co.uk,General Manager,1504,1896,3400
7285,Ludovico,Wearn,lwearnbt@cafepress.com,Pharmacist,1394,491,1885
7072,Laryssa,Rivard,lrivardbu@merriam-webster.com,Senior Developer,5158,653,5811
7215,Sigvard,Fowley,sfowleybv@yellowbook.com,Research Associate,9228,1900,11128
7933,Francisca,Bygraves,fbygravesbw@statcounter.com,Office Assistant IV,7491,257,7748
7777,Ilene,Duckinfield,iduckinfieldbx@tuttocitta.it,Nuclear Power Engineer,6157,1974,8131
7894,Petrina,Kynton,pkyntonby@intel.com,Financial Analyst,1607,633,2240
7571,Kathie,Vedmore,kvedmorebz@columbia.edu,Senior Developer,6572,930,7502
7073,Nissy,O' Neligan,noneliganc1@flavors.me,Help Desk Technician,1712,398,2110
7843,Kirk,Coaster,kcoasterc2@walmart.com,Staff Scientist,6125,893,7018
7442,Ximenes,Eastmead,xeastmeadc5@utexas.edu,Administrative Officer,6751,713,7464
7877,Trisha,Colby,tcolbyc7@ocn.ne.jp,Senior Editor,3263,380,3643
7741,Udall,Duggary,uduggaryc9@cornell.edu,Operator,6472,1785,8257
7302,Berne,Kielty,bkieltyca@wsj.com,Assistant Manager,6042,1240,7282
7821,Nadeen,Cabble,ncabblecb@biglobe.ne.jp,Registered Nurse,7834,1732,9566
7299,Bordy,Fishbourne,bfishbournecc@myspace.com,Civil Engineer,4949,1686,6635
7232,Frank,Taks,ftakscd@wufoo.com,Senior Sales Associate,9463,1026,10489
7803,Arline,Shambroke,ashambrokecf@archive.org,Automation Specialist I,2776,1638,4414
7293,Humbert,O'Hare,hoharecg@bandcamp.com,VP Sales,1134,224,1358
7052,Emmet,Goodison,egoodisonch@bloomberg.com,Environmental Tech,7231,987,8218
7119,Mareah,Edds,meddscj@foxnews.com,Tax Accountant,9474,1394,10868
7369,Dorette,Normaville,dnormavilleck@google.cn,Health Coach II,3716,618,4334
7649,Bryn,McClary,bmcclarycl@samsung.com,Director of Sales,6192,1205,7397
7434,Dora,Rosbrough,drosbroughcn@psu.edu,Web Designer III,2546,261,2807
7587,Clotilda,Melin,cmelinco@icio.us,Health Coach IV,2014,314,2328
7157,Conney,Antoinet,cantoinetcp@paginegialle.it,Business Systems Development Analyst,2167,1075,3242
7188,Jessika,Crannis,jcranniscr@is.gd,Recruiter,9681,734,10415
7508,Kania,Meaders,kmeaderscs@indiatimes.com,Pharmacist,3271,530,3801
7862,Andree,Bracknell,abracknellct@ezinearticles.com,Health Coach IV,1351,416,1767
7450,Katie,O'Kerin,kokerincv@gmpg.org,Office Assistant II,7197,915,8112
7754,Dacia,Duinkerk,dduinkerkcw@g.co,Engineer III,3907,1112,5019
7310,Charlene,Challener,cchallenercx@soup.io,Product Engineer,8836,580,9416
7164,Sally,Snawdon,ssnawdond0@ucoz.com,Paralegal,1790,1432,3222
7888,Malynda,Spurrier,mspurrierd2@yahoo.co.jp,Software Engineer II,2893,494,3387
7614,Roland,Villar,rvillard4@constantcontact.com,Assistant Media Planner,8610,390,9000
7152,Dag,Pecha,dpechad5@dyndns.org,Social Worker,1446,1585,3031
7054,Silvanus,Larratt,slarrattd6@blog.com,Programmer III,1997,1699,3696
7041,Olivia,Olding,ooldingd8@answers.com,GIS Technical Architect,5480,1686,7166
7842,Silvain,Tidmas,stidmasd9@barnesandnoble.com,Marketing Assistant,2362,733,3095
7430,Paton,Biesty,pbiestydb@harvard.edu,Mechanical Systems Engineer,1998,438,2436
7789,Clemente,Harvard,charvarddd@prlog.org,VP Sales,1361,1038,2399
7969,Darb,Quinane,dquinanede@paginegialle.it,Desktop Support Technician,8515,741,9256
7201,Gale,Tompkiss,gtompkissdf@bravesites.com,VP Marketing,6475,1972,8447
7193,Fletcher,Coade,fcoadedj@tamu.edu,Registered Nurse,5171,773,5944
7630,Pete,Meekings,pmeekingsdk@people.com.cn,Human Resources Assistant IV,6228,1653,7881
7775,Hayward,Twiggs,htwiggsdl@parallels.com,Accountant III,4582,1168,5750
7790,Benjamin,Slimm,bslimmdm@vistaprint.com,Senior Developer,5500,1668,7168
7186,Berkeley,Aleksankin,baleksankindn@g.co,Recruiter,1555,451,2006
7960,Fionna,Draco,fdracodo@yellowbook.com,Senior Editor,7097,405,7502
7938,Gerri,Murr,gmurrdq@biglobe.ne.jp,Compensation Analyst,3755,717,4472
7289,Dugald,Reisen,dreisendr@newsvine.com,Senior Cost Accountant,6204,972,7176
7999,Benton,Caudell,bcaudelldt@ehow.com,Assistant Media Planner,5185,1125,6310
7062,Catherin,Parffrey,cparffreydu@ovh.net,Marketing Manager,4825,1324,6149
7887,Crissie,Gossan,cgossandx@addtoany.com,Teacher,4109,1775,5884
7792,Stavro,MacAloren,smacalorendy@google.ca,Software Engineer IV,7334,380,7714
7717,Bernardo,Demougeot,bdemougeotdz@cam.ac.uk,Director of Sales,6366,297,6663
7023,Pepito,Nossent,pnossente0@naver.com,Graphic Designer,6083,403,6486
7968,Lesley,Frend,lfrende1@yolasite.com,Quality Engineer,8204,1207,9411
7563,Aundrea,Jobbing,ajobbinge2@accuweather.com,Teacher,8589,1644,10233
7736,Jecho,Scrooby,jscroobye3@homestead.com,Chemical Engineer,1385,1074,2459
7303,Stewart,Purdom,spurdome5@nih.gov,Biostatistician IV,2796,1772,4568
7360,Shelly,Bare,sbaree6@smugmug.com,Office Assistant III,6033,968,7001
7872,Mario,Finnan,mfinnane7@bloglovin.com,Geological Engineer,3446,1371,4817
7291,Lemmy,Powis,lpowise9@barnesandnoble.com,Dental Hygienist,8183,251,8434
7970,Gannie,Chafer,gchafered@odnoklassniki.ru,Assistant Media Planner,2735,713,3448
7426,Mela,Spragg,mspraggee@intel.com,Paralegal,7533,980,8513
7919,Skip,Abelson,sabelsoneg@oracle.com,Geological Engineer,9995,552,10547
7205,Herschel,Chidgey,hchidgeyel@narod.ru,Tax Accountant,5691,1886,7577
7236,Clarey,Loade,cloadeem@newsvine.com,Statistician III,3287,1062,4349
7373,Corrine,Davall,cdavalleo@theguardian.com,Senior Financial Analyst,8727,1165,9892
7572,Dianemarie,Gooch,dgoocheq@seattletimes.com,Senior Developer,6994,977,7971
7097,Tiphani,McColl,tmccoller@myspace.com,Computer Systems Analyst IV,2534,1526,4060
7300,Leona,Pfeffel,lpfeffeles@bloglines.com,Senior Editor,3808,535,4343
7473,Bev,Burkert,bburkertet@uiuc.edu,Editor,9751,1151,10902
7159,Reed,Crock,rcrockew@g.co,Quality Engineer,9738,292,10030
7621,Elsa,Salomon,esalomonex@odnoklassniki.ru,Assistant Media Planner,4953,221,5174
7924,Mab,Papez,mpapezey@baidu.com,Account Representative I,9664,353,10017
7879,Lorette,Frayn,lfraynez@eventbrite.com,Environmental Specialist,5461,1560,7021
7989,Leo,Ferrarotti,lferrarottif0@arizona.edu,Nurse Practicioner,8752,480,9232
7248,Reggie,Seaward,rseawardf5@yellowbook.com,Human Resources Manager,5556,1620,7176
7979,Darleen,Cashen,dcashenf7@accuweather.com,Recruiter,8027,453,8480
7844,Elayne,Trudgeon,etrudgeonf8@digg.com,Database Administrator II,4049,457,4506
7046,Feliks,Standering,fstanderingf9@sohu.com,Registered Nurse,5064,872,5936
7996,Derry,Aylmer,daylmerfb@sbwire.com,Media Manager IV,5810,1878,7688
7439,Olivia,Hards,ohardsfc@msu.edu,Assistant Professor,1884,1883,3767
7250,Yves,Utridge,yutridgefd@photobucket.com,Dental Hygienist,6382,1789,8171
7522,Jasmin,Kuschke,jkuschkeff@psu.edu,Account Executive,5496,1913,7409
7591,Alexia,Barthorpe,abarthorpefg@tuttocitta.it,General Manager,7741,1851,9592
7327,Raviv,Banfill,rbanfillfh@dailymail.co.uk,Marketing Manager,5485,1421,6906
7372,Caye,Strotone,cstrotonefj@china.com.cn,Graphic Designer,1349,1561,2910
7222,Verene,Vasilyevski,vvasilyevskifl@histats.com,Research Associate,8440,537,8977
7180,Olva,Thying,othyingfm@nba.com,Recruiting Manager,4802,551,5353
7648,Fianna,Lapthorne,flapthornefn@oracle.com,Chief Design Engineer,6744,714,7458
7033,Wallas,Fasler,wfaslerfo@tamu.edu,Human Resources Manager,8736,800,9536
7413,Silvester,Cherry Holme,scherryholmefq@ucoz.com,Systems Administrator III,2630,1836,4466
7187,Addia,Erlam,aerlamft@mapquest.com,Civil Engineer,9629,1136,10765
7982,Tanny,Newbury,tnewburyfu@cargocollective.com,Technical Writer,4633,1100,5733
7798,Mohandis,Enga,mengafv@jimdo.com,Mechanical Systems Engineer,1479,625,2104
7465,Gerda,Eggleson,gegglesonfw@indiegogo.com,Office Assistant III,6476,1080,7556
7376,Lonny,Figg,lfiggg0@webs.com,Structural Engineer,4543,1842,6385
7986,Marybeth,Niccolls,mniccollsg1@umn.edu,Senior Financial Analyst,8231,1846,10077
7429,Cos,Hassekl,chasseklg3@dot.gov,Research Assistant II,2371,1243,3614
7424,Anton,Fattorini,afattorinig4@ebay.co.uk,Senior Editor,2758,1297,4055
7720,Webb,Leggen,wleggeng5@disqus.com,Business Systems Development Analyst,5530,537,6067
7997,Valenka,Kamall,vkamallg6@merriam-webster.com,Environmental Specialist,5526,1565,7091
7980,Jeanelle,Halpine,jhalpineg7@examiner.com,Pharmacist,3364,1030,4394
7092,Fran,Gledhill,fgledhillg8@feedburner.com,Quality Control Specialist,5514,1419,6933
7200,Othilie,Freda,ofredag9@npr.org,Staff Scientist,9815,1826,11641
7396,Wanids,Grinikhin,wgrinikhingb@nasa.gov,Programmer Analyst III,6188,663,6851
7444,Mac,Balazs,mbalazsgc@un.org,Biostatistician II,3390,631,4021
7409,Lou,Grassot,lgrassotgg@bandcamp.com,Compensation Analyst,8381,1462,9843
7394,Kaja,Hawler,khawlergh@harvard.edu,Research Assistant III,6463,1863,8326
7408,Catriona,Burditt,cburdittgi@over-blog.com,Senior Financial Analyst,5298,367,5665
7940,Ezequiel,Slingsby,eslingsbygj@columbia.edu,Civil Engineer,1848,537,2385
7771,Hilary,Bengefield,hbengefieldgl@booking.com,Accounting Assistant IV,4799,931,5730
7371,Kenon,Spaight,kspaightgm@whitehouse.gov,Product Engineer,7577,1063,8640
7716,Petronille,Creany,pcreanygn@tripadvisor.com,Professor,6668,1100,7768
7458,Gibby,Ledbury,gledburygo@sourceforge.net,Structural Analysis Engineer,5822,1367,7189
7068,Fonzie,Alves,falvesgr@drupal.org,Statistician IV,4673,1622,6295
7632,Jamima,Liggens,jliggensgs@qq.com,Junior Executive,2662,469,3131
7443,Shaylynn,Irnis,sirnisgz@so-net.ne.jp,Sales Representative,5398,888,6286
7918,Elliott,Buttrick,ebuttrickh0@behance.net,VP Accounting,5923,1941,7864
7891,Brooke,Sone,bsoneh1@friendfeed.com,Financial Analyst,6197,907,7104
7094,Raina,King,rkingh2@auda.org.au,General Manager,5647,1826,7473
7761,Sanderson,Romand,sromandh4@51.la,Business Systems Development Analyst,8020,1365,9385
7014,Clea,Charnley,ccharnleyh6@wikipedia.org,Help Desk Technician,9930,940,10870
7783,Osbourne,Croyser,ocroyserh7@eepurl.com,Assistant Media Planner,5350,959,6309
7712,Angel,Killick,akillickh8@eepurl.com,Accountant III,9735,528,10263
7542,Simon,Falkingham,sfalkinghamha@gizmodo.com,Accounting Assistant IV,8810,1412,10222
7686,Sydney,Summerton,ssummertonhb@theatlantic.com,Director of Sales,3843,1142,4985
7897,Daryl,Hanwright,dhanwrighthc@oakley.com,Nuclear Power Engineer,2241,250,2491
7125,Sukey,Deere,sdeerehg@sohu.com,Media Manager IV,9728,354,10082
7555,Townsend,Kalb,tkalbhh@woothemes.com,Human Resources Assistant III,7855,1427,9282
7326,Rickie,Gilkes,rgilkeshj@naver.com,Executive Secretary,8233,1622,9855
7079,Luce,Stollery,lstolleryhk@bbb.org,Civil Engineer,6713,1229,7942
7867,Hamlen,Artingstall,hartingstallhm@cloudflare.com,Help Desk Operator,7308,426,7734
7136,Angelle,Pulsford,apulsfordhn@ehow.com,Help Desk Technician,6815,1613,8428
7486,Marcel,Moizer,mmoizerho@altervista.org,Assistant Media Planner,4587,365,4952
7008,Bartholomeo,Barrat,bbarrathp@wiley.com,Software Consultant,4244,1938,6182
7329,Joann,Mullally,jmullallyhq@sun.com,Structural Analysis Engineer,9823,1730,11553
7626,Erminia,Seavers,eseavershr@earthlink.net,Staff Accountant IV,3691,1865,5556
7435,Eberto,Rodenborch,erodenborchht@cnn.com,Compensation Analyst,4204,1310,5514
7739,Debor,Huegett,dhuegetthv@epa.gov,Environmental Tech,6213,1132,7345
7806,Artemis,Basham,abashami0@walmart.com,Office Assistant IV,6346,1224,7570
7787,Janela,St. Hill,jsthilli1@forbes.com,Health Coach II,2973,1025,3998
7871,Ashby,Venable,avenablei2@constantcontact.com,Registered Nurse,7979,524,8503
7778,Burg,Pursglove,bpursglovei3@tmall.com,Payment Adjustment Coordinator,4516,1112,5628
7810,Jae,Ferrarello,jferrarelloi8@smh.com.au,Data Coordiator,4718,612,5330
7797,Maria,Guerra,mguerraia@wired.com,Operator,9385,223,9608
7377,Virgie,Nolton,vnoltonib@flavors.me,VP Accounting,2523,419,2942
7992,Raye,Otteridge,rotteridgeif@myspace.com,Speech Pathologist,7168,1741,8909
7937,Alanah,Millberg,amillbergig@illinois.edu,Help Desk Technician,7212,1335,8547
7705,Dynah,Payne,dpayneih@harvard.edu,Nuclear Power Engineer,3971,1758,5729
7678,Rhys,D'Ugo,rdugoij@freewebs.com,Associate Professor,9473,599,10072
7177,Arin,Shepton,asheptonik@archive.org,VP Marketing,9011,1553,10564
7784,Laurice,Deware,ldewarein@census.gov,Information Systems Manager,2546,998,3544
7040,Melosa,Harrismith,mharrismithio@ustream.tv,Analyst Programmer,7336,1948,9284
7431,Forrester,Pritty,fprittyiq@ihg.com,Senior Editor,7628,1892,9520
7664,Linell,Grainger,lgraingerir@examiner.com,Account Executive,1851,453,2304
7420,Daniella,Bonas,dbonasis@comsenz.com,Payment Adjustment Coordinator,5114,1706,6820
7732,Erl,Labro,elabroit@sciencedirect.com,Associate Professor,1877,1113,2990
7245,Izaak,Dalzell,idalzelliu@reference.com,Developer I,6827,418,7245
7130,Emelyne,Cowlishaw,ecowlishawiv@vimeo.com,Marketing Assistant,8858,485,9343
7603,Wandis,Vinall,wvinalliw@blogtalkradio.com,Senior Sales Associate,8022,266,8288
7183,Karlens,Renoden,krenodenix@yellowpages.com,Electrical Engineer,8475,1038,9513
7497,Simona,Ovendale,sovendaleiy@amazon.com,Technical Writer,9678,1670,11348
7167,Gusti,Brobak,gbrobakj1@parallels.com,VP Product Management,3269,672,3941
7103,Adara,Ilem,ailemj2@tripadvisor.com,Speech Pathologist,9903,1422,11325
7129,Chaddie,Pesticcio,cpesticcioj4@about.me,Programmer III,7670,1121,8791
7569,Emory,Dowsey,edowseyj8@google.co.uk,Quality Control Specialist,9089,809,9898
7075,Farica,Grishin,fgrishinjb@plala.or.jp,Pharmacist,8566,752,9318
7256,Tracey,Farquar,tfarquarjc@csmonitor.com,Financial Advisor,4597,763,5360
7596,Milty,Normaville,mnormavilleje@usatoday.com,Account Representative II,5154,1304,6458
7656,Zack,Lauthian,zlauthianjf@ox.ac.uk,Business Systems Development Analyst,9535,1071,10606
7488,Claudian,Ferreira,cferreirajh@vk.com,Recruiter,1270,863,2133
7038,Albert,Barnfather,abarnfatherji@eventbrite.com,Software Consultant,4663,1092,5755
7822,Dulce,Gillott,dgillottjj@networkadvertising.org,Data Coordiator,5416,272,5688
7292,Otes,Samways,osamwaysjn@photobucket.com,Analog Circuit Design manager,9665,1421,11086
7971,Whitney,Heminsley,wheminsleyjq@bloomberg.com,VP Sales,7467,1180,8647
7280,Ebba,Fooks,efooksjs@hp.com,Biostatistician I,2991,1647,4638
7269,Kalil,Tozer,ktozerju@wordpress.org,Accountant II,2455,1681,4136
7905,Cele,Mayoh,cmayohk0@shinystat.com,Statistician IV,6217,327,6544
7729,Niki,Kenwin,nkenwink1@si.edu,Structural Analysis Engineer,2158,1425,3583
7567,Bondy,Cheatle,bcheatlek6@nih.gov,Account Coordinator,7703,463,8166
7358,Sheilah,Wateridge,swateridgek7@cmu.edu,Marketing Assistant,8893,589,9482
7723,Ellynn,Rasmus,erasmusk8@delicious.com,Recruiter,6317,1301,7618
7549,Stephannie,Rollitt,srollittk9@ebay.co.uk,Assistant Media Planner,6286,734,7020
7552,Liva,Praten,lpratenka@imdb.com,Computer Systems Analyst II,5319,626,5945
7024,Kessia,Tutchener,ktutchenerkb@google.co.uk,Account Coordinator,8706,1285,9991
7392,Tiffany,Twyford,ttwyfordkd@omniture.com,Tax Accountant,5292,1859,7151
7389,Merrick,Cleevely,mcleevelykf@theglobeandmail.com,Geological Engineer,1333,424,1757
7525,Clarita,O'Crowley,cocrowleykg@state.tx.us,Geological Engineer,1911,1335,3246
7895,Lizabeth,Sholem,lsholemki@etsy.com,Paralegal,6224,1966,8190
7785,Rorie,Skechley,rskechleykj@prnewswire.com,Cost Accountant,3509,1765,5274
7095,Andrei,Hobgen,ahobgenkk@ifeng.com,Environmental Specialist,8267,1454,9721
7959,Quinta,Hansman,qhansmankp@dmoz.org,Financial Advisor,8815,1961,10776
7189,Milissent,Doldon,mdoldonkq@addtoany.com,Programmer Analyst IV,5393,520,5913
7845,Guillermo,Paylor,gpaylorkt@cdc.gov,Senior Editor,7686,561,8247
7332,Quinton,Polkinghorne,qpolkinghorneku@lulu.com,Teacher,1641,1531,3172
7029,Shadow,Hordle,shordlekv@wordpress.org,Help Desk Technician,6406,1867,8273
7271,Alvina,Tadlow,atadlowkw@biblegateway.com,Health Coach I,2646,1132,3778
7865,Salli,Calway,scalwaykx@wikispaces.com,Nurse,7738,1428,9166
7266,Paola,Reynold,preynoldky@delicious.com,Assistant Professor,3941,1423,5364
7682,Orlan,McCathy,omccathyl0@zimbio.com,Analyst Programmer,7001,841,7842
7881,Lazar,Lemasney,llemasneyl3@unblog.fr,Analog Circuit Design manager,9812,726,10538
7466,Yves,McKilroe,ymckilroel6@blinklist.com,Nuclear Power Engineer,6277,1928,8205
7090,Chrissie,Langton,clangtonl8@w3.org,Tax Accountant,9573,442,10015
7498,Boonie,Oubridge,boubridgela@miibeian.gov.cn,Occupational Therapist,4569,583,5152
7825,Euphemia,Michell,emichelllc@narod.ru,Paralegal,8582,461,9043
7333,Ignazio,Rough,iroughld@com.com,Budget/Accounting Analyst III,7274,1454,8728
7884,Ollie,Taylor,otaylorle@edublogs.org,Programmer II,3135,763,3898
7464,Joletta,Nannoni,jnannonilk@vinaora.com,Project Manager,3748,1082,4830
7341,Heindrick,Champley,hchampleyll@harvard.edu,Assistant Professor,4209,429,4638
7934,Kittie,Ridger,kridgerlm@alibaba.com,Programmer Analyst IV,1089,982,2071
7972,Lothario,Wilkin,lwilkinlp@prlog.org,Information Systems Manager,6778,1107,7885
7841,Hunt,Cromleholme,hcromleholmelu@goo.ne.jp,Tax Accountant,6948,617,7565
7100,Rustin,McMorran,rmcmorranlv@state.tx.us,Systems Administrator II,6037,1892,7929
7185,Chastity,Jewitt,cjewittlw@umn.edu,Software Test Engineer II,7201,903,8104
7955,Elsi,Pringell,epringelllx@slideshare.net,Senior Developer,7920,678,8598
7387,Vanya,Oty,votym1@163.com,Social Worker,6366,1164,7530
7819,Dierdre,Stonelake,dstonelakem4@tamu.edu,Programmer Analyst I,6447,813,7260
7212,Hulda,Spiller,hspillerm7@fc2.com,Quality Engineer,2505,673,3178
7749,Anton,Clementel,aclementelmb@csmonitor.com,Developer II,2084,1764,3848
7923,Wang,McPherson,wmcphersonmg@paginegialle.it,Administrative Assistant IV,6959,1565,8524
7228,Carol,Waterstone,cwaterstonemi@prweb.com,Speech Pathologist,7748,1941,9689
7652,Tammy,McGann,tmcgannmj@engadget.com,Automation Specialist III,4623,1821,6444
7116,Maurice,Muselli,mmusellimo@google.nl,Payment Adjustment Coordinator,4315,932,5247
7284,Si,Micklem,smicklemmq@photobucket.com,Software Consultant,3974,1255,5229
7395,Thatcher,Bartlett,tbartlettmt@delicious.com,Cost Accountant,9883,211,10094
7382,Barron,Jehu,bjehumu@a8.net,Recruiting Manager,6079,1960,8039
7536,Tedman,Croisdall,tcroisdallmv@dyndns.org,Director of Sales,7182,1632,8814
7134,Jessee,Cherrett,jcherrettn1@ow.ly,Programmer Analyst III,5041,1859,6900
7184,Tricia,Adair,tadairn9@hud.gov,Professor,3898,249,4147
7174,Mariya,Parkey,mparkeyna@typepad.com,Human Resources Assistant I,8159,1857,10016
7998,Margaret,Reaper,mreapernf@icio.us,Environmental Tech,7700,1654,9354
7108,Gilberto,Reeme,greemeng@bluehost.com,Software Engineer II,8291,762,9053
7487,Holly-anne,Found,hfoundnh@ed.gov,Information Systems Manager,5840,1314,7154
7701,Terencio,Dregan,tdregannj@yelp.com,Senior Quality Engineer,4313,672,4985
7249,Northrup,Papaccio,npapaccionk@hud.gov,Environmental Specialist,5340,1372,6712
7524,Onofredo,Heeley,oheeleynn@topsy.com,Social Worker,9100,1488,10588
7974,Ivory,Prevett,iprevettnq@wordpress.com,Desktop Support Technician,7565,530,8095
7600,Hollie,Usmar,husmarnu@icq.com,Research Nurse,3687,1066,4753
7733,Durante,Philippe,dphilippenx@google.nl,Analyst Programmer,8156,1244,9400
7039,Rayshell,Hourican,rhouricannz@slideshare.net,Recruiter,5044,1840,6884
7217,Loreen,Ducastel,lducastelo0@adobe.com,Quality Control Specialist,4451,1757,6208
7814,Franciskus,Lavies,flavieso7@stumbleupon.com,Senior Editor,3658,767,4425
7615,Dusty,Gorges,dgorgesoa@intel.com,Design Engineer,4223,1552,5775
7339,Datha,Polle,dpolleob@wp.com,Biostatistician II,3632,1266,4898
7447,Cathleen,Henrichsen,chenrichsenoc@facebook.com,Analog Circuit Design manager,4095,1035,5130
7588,Friederike,Sprowles,fsprowlesof@vinaora.com,Occupational Therapist,9223,1959,11182
7795,Karita,Spinney,kspinneyog@ifeng.com,Food Chemist,5570,244,5814
7985,Barry,Stefi,bstefioh@typepad.com,Automation Specialist I,8434,1556,9990
7085,Orsola,Wolseley,owolseleyol@netlog.com,Operator,8362,1331,9693
7275,Arlen,Streeton,astreetonon@auda.org.au,Programmer I,2342,1016,3358
7962,Cecelia,Wimlet,cwimletoo@parallels.com,Civil Engineer,9459,1407,10866
7380,Charlie,Dourin,cdourinoq@livejournal.com,Speech Pathologist,4875,402,5277
7954,Dominica,Mattheissen,dmattheissenot@woothemes.com,Occupational Therapist,7286,418,7704
7546,Reinhold,Densell,rdensellov@auda.org.au,Technical Writer,2487,1257,3744
7837,Gillian,McCaughey,gmccaugheyoy@indiegogo.com,Media Manager III,8710,1654,10364
7577,Gui,Moneypenny,gmoneypennyoz@cbslocal.com,Analog Circuit Design manager,9633,1391,11024
7109,Reagan,Toffoletto,rtoffolettop0@google.ru,Assistant Media Planner,1825,1434,3259
7927,Leda,Whiskerd,lwhiskerdp1@amazon.co.uk,Budget/Accounting Analyst III,7898,1904,9802
7638,Whitney,Barmadier,wbarmadierpd@uol.com.br,Systems Administrator I,5159,1414,6573
7354,Miriam,Sabates,msabatespg@hatena.ne.jp,Software Engineer I,3440,1450,4890
7475,Nickey,Roast,nroastph@gravatar.com,Automation Specialist IV,7829,980,8809
7873,Feliks,Remington,fremingtonpl@posterous.com,Safety Technician I,3486,1217,4703
7695,Marsiella,Hurdedge,mhurdedgepn@delicious.com,Health Coach I,4807,1436,6243
7107,Kaitlyn,Gooderham,kgooderhampo@kickstarter.com,Geological Engineer,2818,1165,3983
7727,Ruthe,Sherborne,rsherbornepq@vkontakte.ru,Business Systems Development Analyst,6300,1987,8287
7063,Chance,Dobbison,cdobbisonpt@cmu.edu,Programmer II,1496,1289,2785
7521,Amitie,Edgeller,aedgellerpu@netscape.com,Developer II,2576,478,3054
7297,Emanuel,Walkington,ewalkingtonpv@people.com.cn,Technical Writer,1685,1958,3643
7224,Gerda,Jillis,gjillispw@usnews.com,VP Accounting,9352,389,9741
7509,Roxine,Wilshere,rwilsherepx@thetimes.co.uk,Marketing Manager,8376,1614,9990
7677,Corenda,Hubbock,chubbockq2@yandex.ru,Community Outreach Specialist,5413,923,6336
7547,Sarette,Wand,swandq6@blogtalkradio.com,Systems Administrator III,5689,1073,6762
7607,Malachi,Braywood,mbraywoodq9@cdbaby.com,Compensation Analyst,8836,915,9751
7461,Trueman,Matei,tmateiqb@cbslocal.com,Nurse Practicioner,4918,1328,6246
7921,Kean,Copperwaite,kcopperwaiteqe@uiuc.edu,Geologist III,5700,696,6396
7878,Hendrik,Thursby,hthursbyqf@list-manage.com,Engineer I,6869,1575,8444
7316,Stephana,Wallbrook,swallbrookqi@weibo.com,Director of Sales,6767,1409,8176
7734,Alastair,Duerden,aduerdenql@illinois.edu,Assistant Manager,6078,1578,7656
7625,Euphemia,Rearie,erearieqo@sourceforge.net,Web Designer IV,8432,436,8868
7605,Malina,Champniss,mchampnissqr@msu.edu,Product Engineer,3886,429,4315
7830,Kane,Organer,korganerqs@scribd.com,Staff Scientist,4922,835,5757
7898,Eddy,Piatkow,epiatkowqt@mit.edu,Assistant Manager,5264,1217,6481
7011,Gabriell,Claxton,gclaxtonqy@redcross.org,Geological Engineer,9036,1056,10092
7319,Maxy,Petkens,mpetkensr2@eventbrite.com,Payment Adjustment Coordinator,1946,1291,3237
7305,Ivar,Francey,ifranceyr3@jugem.jp,Community Outreach Specialist,4978,330,5308
7582,Gregorius,Ivkovic,givkovicr5@ihg.com,Environmental Specialist,8793,455,9248
7512,Rodger,Standon,rstandonr6@rakuten.co.jp,Mechanical Systems Engineer,2880,435,3315
7853,Renard,Talbot,rtalbotr7@bigcartel.com,Office Assistant II,3931,1563,5494
7123,Hestia,Gabbitus,hgabbitusrd@opensource.org,Registered Nurse,3900,483,4383
7507,Dion,Chessun,dchessunrl@cbc.ca,General Manager,8772,432,9204
7574,Nataniel,Gavaran,ngavaranro@time.com,Professor,6105,415,6520
7943,Berny,Graundisson,bgraundissonrq@marketwatch.com,Financial Advisor,3786,751,4537
7433,Gusella,Berceros,gbercerosrr@edublogs.org,Design Engineer,7361,795,8156
9940,Garreth,Patey,gpatey0@gnu.org,Quality Engineer,1759,1673,3432
10000,Agustin,Drakeley,adrakeley1@pagesperso-orange.fr,GIS Technical Architect,3436,1861,5297
9115,Anthea,De Brett,adebrett2@ebay.co.uk,Human Resources Manager,4028,551,4579
9975,Carla,Bathoe,cbathoe3@senate.gov,Automation Specialist III,5959,1335,7294
9605,Murray,Gryglewski,mgryglewski4@feedburner.com,VP Product Management,8190,1330,9520
9993,Mart,Allington,mallington5@baidu.com,Cost Accountant,5753,1575,7328
9417,Glori,Puckinghorne,gpuckinghorne6@apache.org,Systems Administrator II,4955,1814,6769
9688,Chelsie,Thebeau,cthebeau7@ebay.com,Administrative Assistant II,1720,426,2146
9638,Mikkel,Elt,melt8@t.co,Junior Executive,9354,1183,10537
9216,Hewie,Randle,hrandle9@wisc.edu,Physical Therapy Assistant,8654,927,9581
9223,Tybi,Durrant,tdurranta@wix.com,Design Engineer,5981,516,6497
9890,Astrix,Sidaway,asidawayb@yahoo.com,Senior Editor,1644,1580,3224
9578,Ado,Gallaher,agallaherc@nih.gov,Occupational Therapist,2522,1285,3807
9600,Hebert,Gundrey,hgundreyd@google.com.br,Dental Hygienist,5788,1201,6989
9998,Bree,Underhill,bunderhille@patch.com,Information Systems Manager,2681,1454,4135
9840,Horatia,Avraam,havraamf@fotki.com,Accountant IV,4205,1290,5495
9025,Roanne,Frankema,rfrankemag@last.fm,Web Developer IV,9583,343,9926
9137,Bryon,Kirwin,bkirwinh@redcross.org,Civil Engineer,7613,1088,8701
9020,Malinde,Davidman,mdavidmani@t.co,Marketing Manager,9872,740,10612
9856,Adele,Piatek,apiatekj@tmall.com,Physical Therapy Assistant,1909,348,2257
9734,Neel,Coleby,ncolebyk@examiner.com,Clinical Specialist,1516,1416,2932
9647,Chickie,Ruperto,crupertol@sina.com.cn,Research Associate,4054,1672,5726
9251,Win,Cannan,wcannanm@ebay.co.uk,Community Outreach Specialist,4453,268,4721
9119,Nollie,Cowlishaw,ncowlishawn@engadget.com,Business Systems Development Analyst,2819,837,3656
9894,Brigitta,Zannelli,bzannellio@ucsd.edu,Assistant Professor,7005,694,7699
9832,Malchy,Gosby,mgosbyp@github.io,Cost Accountant,2202,1155,3357
9412,Haslett,Robrose,hrobroseq@cocolog-nifty.com,Professor,9975,1766,11741
9732,Dorita,Kevlin,dkevlinr@seattletimes.com,Structural Engineer,4113,901,5014
9410,Ailene,Dronsfield,adronsfields@discuz.net,Sales Representative,5924,1367,7291
9580,Letisha,Perdue,lperduet@icio.us,Tax Accountant,8769,1325,10094
9372,Kirby,Eden,kedenu@e-recht24.de,VP Quality Control,9300,271,9571
9126,Leelah,Caulcutt,lcaulcuttv@mail.ru,Quality Control Specialist,8244,1109,9353
9778,Etta,Yeo,eyeow@zdnet.com,Senior Cost Accountant,3270,1917,5187
9687,Maressa,Toffoletto,mtoffolettox@mysql.com,Research Associate,2254,657,2911
9337,Lammond,Garmon,lgarmony@godaddy.com,Administrative Assistant IV,1145,693,1838
9873,Delbert,Dobbie,ddobbiez@aboutads.info,Project Manager,1716,1249,2965
9201,Nedda,Gulland,ngulland10@cbslocal.com,Structural Analysis Engineer,7749,515,8264
9630,Liuka,Wilfing,lwilfing12@nytimes.com,Executive Secretary,4724,1336,6060
9333,Mortie,Baszkiewicz,mbaszkiewicz13@ifeng.com,Occupational Therapist,2773,528,3301
9974,Abbot,Rawne,arawne14@twitter.com,Budget/Accounting Analyst IV,6488,1256,7744
9945,Ximenes,Rennock,xrennock15@deliciousdays.com,Account Coordinator,2485,1223,3708
9650,Forbes,Blay,fblay16@plala.or.jp,Senior Editor,7050,697,7747
9467,Port,Desforges,pdesforges17@devhub.com,Safety Technician I,5476,839,6315
9755,Sunny,Edward,sedward18@wiley.com,Community Outreach Specialist,2458,1202,3660
9130,Donavon,Angel,dangel19@yandex.ru,Research Nurse,1901,1267,3168
9842,Tish,Le Barr,tlebarr1a@google.com.hk,Health Coach III,9869,1670,11539
9127,Rahel,Seivertsen,rseivertsen1b@examiner.com,Account Executive,3139,462,3601
9764,Winnah,Leyden,wleyden1c@devhub.com,Data Coordiator,7922,761,8683
9305,Jemie,Francescozzi,jfrancescozzi1d@usa.gov,Systems Administrator I,5673,690,6363
9670,Federica,Karolyi,fkarolyi1e@techcrunch.com,Chief Design Engineer,9422,531,9953
9089,Josiah,Giacomini,jgiacomini1f@exblog.jp,Analog Circuit Design manager,7960,1884,9844
9583,Tomas,Bravery,tbravery1g@indiegogo.com,Senior Sales Associate,7486,1800,9286
9446,Patsy,Habard,phabard1h@macromedia.com,Budget/Accounting Analyst II,9292,1762,11054
9898,Bronnie,Kobpac,bkobpac1i@independent.co.uk,Mechanical Systems Engineer,1693,1794,3487
9165,Brigham,Kidstone,bkidstone1j@cocolog-nifty.com,Director of Sales,7852,558,8410
9690,Fredi,Spurdon,fspurdon1k@house.gov,Product Engineer,5923,1129,7052
9572,Regen,De Beauchamp,rdebeauchamp1l@twitpic.com,General Manager,3426,548,3974
9917,Morissa,Langfitt,mlangfitt1m@tripod.com,VP Accounting,6149,1391,7540
9637,Antonio,Snoddin,asnoddin1n@ucsd.edu,Community Outreach Specialist,5624,1540,7164
9224,Venita,Chaudrelle,vchaudrelle1o@list-manage.com,Environmental Tech,1679,1504,3183
9765,Miner,Phillps,mphillps1p@diigo.com,VP Marketing,7835,1084,8919
9807,Vanessa,Shirley,vshirley1q@diigo.com,Administrative Officer,4159,366,4525
9545,Sandi,Machin,smachin1r@pbs.org,Safety Technician I,5272,514,5786
9767,Salome,Baffin,sbaffin1s@uol.com.br,Desktop Support Technician,7811,1248,9059
9141,Rosalinde,Uccello,ruccello1t@noaa.gov,Administrative Officer,7730,822,8552
9858,Torrance,Lapides,tlapides1u@cnet.com,Mechanical Systems Engineer,1773,1707,3480
9779,Ileane,Demsey,idemsey1v@wix.com,Business Systems Development Analyst,1662,404,2066
9957,Natalee,Deadman,ndeadman1w@fc2.com,Analyst Programmer,1570,280,1850
9562,Derk,Smittoune,dsmittoune1x@accuweather.com,Senior Financial Analyst,7651,1043,8694
9674,Kris,Tirte,ktirte1y@reddit.com,Engineer IV,4594,1449,6043
9932,Kaine,Mayo,kmayo1z@ovh.net,Associate Professor,2720,213,2933
9462,Karrie,Hellwich,khellwich20@bing.com,VP Product Management,2152,366,2518
9424,Aloise,Jerrans,ajerrans21@un.org,VP Quality Control,8455,1257,9712
9943,Randee,Ricca,rricca22@irs.gov,Safety Technician III,3658,655,4313
9645,Troy,Hartshorn,thartshorn23@businesswire.com,Community Outreach Specialist,9908,1530,11438
9586,Antonin,Stonuary,astonuary24@ibm.com,Nurse,4868,301,5169
9388,Janice,Schultes,jschultes25@wiley.com,Paralegal,4703,1008,5711
9486,Penny,Metzig,pmetzig26@aol.com,Tax Accountant,8703,1369,10072
9672,Marlyn,Pyer,mpyer27@canalblog.com,Analyst Programmer,5951,1939,7890
9757,Lavena,Coniam,lconiam28@utexas.edu,Community Outreach Specialist,2254,711,2965
9770,Nelly,Murrish,nmurrish29@latimes.com,Financial Advisor,1008,1769,2777
9948,Randal,Smallpeice,rsmallpeice2a@taobao.com,Compensation Analyst,2625,1229,3854
9208,Giffard,Scraney,gscraney2b@e-recht24.de,Geological Engineer,5880,1803,7683
9322,Jaine,Brennan,jbrennan2d@house.gov,Structural Engineer,8941,756,9697
9383,Maxy,Bloss,mbloss2f@amazon.co.jp,Product Engineer,3803,1341,5144
9413,Arnaldo,Dillon,adillon2g@walmart.com,Developer IV,7888,913,8801
9922,Fraser,Colleer,fcolleer2h@apple.com,Help Desk Operator,9077,896,9973
9291,Leslie,Gilpin,lgilpin2i@ustream.tv,Structural Analysis Engineer,8438,574,9012
9109,Cointon,Bulfoot,cbulfoot2k@opera.com,Account Executive,9512,1909,11421
9332,Putnem,Sissel,psissel2l@goo.gl,Senior Developer,5274,834,6108
9526,Sven,McLagain,smclagain2m@macromedia.com,Registered Nurse,7336,1671,9007
9695,Peggy,Wringe,pwringe2n@cdc.gov,Community Outreach Specialist,1483,413,1896
9443,Cherida,Hacquel,chacquel2o@nifty.com,Structural Engineer,1890,326,2216
9685,Odey,Eayrs,oeayrs2p@networkadvertising.org,GIS Technical Architect,3967,1000,4967
9290,Roi,Gelderd,rgelderd2q@gravatar.com,Marketing Assistant,8480,1220,9700
9554,Darcey,Davenport,ddavenport2r@time.com,Automation Specialist III,9217,632,9849
9763,Worthy,Brimman,wbrimman2t@jiathis.com,Software Test Engineer IV,1667,1042,2709
9189,Melisandra,Vaughten,mvaughten2u@weebly.com,Health Coach IV,9619,1125,10744
9790,Pen,Osichev,posichev2v@dailymotion.com,Human Resources Manager,6521,291,6812
9124,Madeleine,Reinbech,mreinbech2x@bluehost.com,VP Sales,4771,1932,6703
9202,Stephanus,Hartshorn,shartshorn2y@answers.com,Staff Scientist,3499,1156,4655
9915,Gavra,Clotworthy,gclotworthy2z@list-manage.com,Data Coordiator,7111,291,7402
9495,Brana,Frossell,bfrossell30@hc360.com,Senior Cost Accountant,7437,1411,8848
9235,Isobel,Rouch,irouch32@cocolog-nifty.com,Operator,3688,395,4083
9156,Harriet,Polon,hpolon34@nydailynews.com,Analog Circuit Design manager,1915,586,2501
9793,Silvie,Payfoot,spayfoot35@php.net,Chief Design Engineer,3025,514,3539
9248,Giustina,Seadon,gseadon36@ox.ac.uk,GIS Technical Architect,9357,1350,10707
9368,Arly,Lindfors,alindfors37@cbsnews.com,Librarian,3152,1671,4823
9460,Rocky,Spenton,rspenton38@trellian.com,Senior Cost Accountant,4370,938,5308
9900,Kimble,Simonassi,ksimonassi39@amazon.com,Programmer II,4679,1812,6491
9214,Dillie,Murty,dmurty3a@weibo.com,Office Assistant II,5836,279,6115
9593,Maritsa,Petrillo,mpetrillo3b@china.com.cn,Librarian,2817,694,3511
9706,Rod,Martinat,rmartinat3c@hubpages.com,Web Developer III,4391,235,4626
9057,Jessi,Fulger,jfulger3d@webs.com,Social Worker,3495,667,4162
9252,Jerome,McCarl,jmccarl3e@google.com.au,Programmer II,9275,583,9858
9534,Gerti,Gabbetis,ggabbetis3f@discovery.com,Nuclear Power Engineer,4252,492,4744
9143,Benjie,Commins,bcommins3i@hibu.com,Senior Editor,5821,608,6429
9232,Minta,Jedras,mjedras3j@hugedomains.com,Community Outreach Specialist,3115,442,3557
9703,Osborne,Mogridge,omogridge3k@taobao.com,Software Consultant,3911,1353,5264
9408,Vivienne,Lainton,vlainton3l@ucoz.ru,Senior Financial Analyst,3336,1866,5202
9585,Gwenni,Ranner,granner3n@springer.com,Design Engineer,5088,516,5604
9161,Adella,Dummett,adummett3o@google.it,Engineer II,1066,206,1272
9344,Saleem,Center,scenter3p@usda.gov,Quality Control Specialist,8496,620,9116
9828,Patten,Whyberd,pwhyberd3q@blogspot.com,Nuclear Power Engineer,1431,799,2230
9964,Mariette,Barnhill,mbarnhill3s@forbes.com,Actuary,1253,1161,2414
9951,Ali,Wildish,awildish3t@gravatar.com,Community Outreach Specialist,2587,1701,4288
9796,Karrah,Coase,kcoase3u@europa.eu,Systems Administrator III,2181,605,2786
9726,Thornie,Billyard,tbillyard3v@a8.net,VP Marketing,8762,421,9183
9571,Tressa,Readwing,treadwing3w@auda.org.au,Operator,8128,1055,9183
9356,Caroljean,Reck,creck3x@utexas.edu,Tax Accountant,4920,1392,6312
9967,Jessie,Cornner,jcornner3y@narod.ru,Actuary,9605,1879,11484
9106,Tara,Heasly,theasly3z@google.pl,Human Resources Manager,5397,1017,6414
9905,Dani,Taill,dtaill40@timesonline.co.uk,Project Manager,3494,1262,4756
9003,Delainey,Collie,dcollie41@trellian.com,Administrative Assistant IV,9806,439,10245
9657,Nappie,Langan,nlangan42@1und1.de,Assistant Professor,9085,904,9989
9082,Maddi,Rozenzweig,mrozenzweig43@github.io,Administrative Officer,5914,1540,7454
9448,Heida,Khalid,hkhalid44@infoseek.co.jp,Recruiting Manager,3028,1052,4080
9204,Danette,Dymond,ddymond45@bandcamp.com,Speech Pathologist,1544,1099,2643
9043,Gloriane,Lissandrini,glissandrini46@geocities.com,Senior Quality Engineer,9266,1035,10301
9370,Jarrad,Ridgers,jridgers49@yandex.ru,Director of Sales,1463,1452,2915
9092,Barrie,Chadwin,bchadwin4a@java.com,Senior Sales Associate,2628,1180,3808
9885,Lilith,Loines,lloines4b@booking.com,Chemical Engineer,9687,616,10303
9625,Gayla,Lewsley,glewsley4c@w3.org,Software Test Engineer II,3903,221,4124
9021,Gaspar,Klousner,gklousner4d@youtu.be,Occupational Therapist,8394,508,8902
9327,Davy,Dudny,ddudny4e@ebay.com,Sales Associate,1746,909,2655
9950,Jasmina,Ollerearnshaw,jollerearnshaw4f@goo.ne.jp,Data Coordiator,8618,1845,10463
9052,Claus,Bampforth,cbampforth4g@fc2.com,Sales Associate,4952,1301,6253
9192,Binny,Lisciandri,blisciandri4h@yale.edu,Programmer Analyst I,5633,936,6569
9104,Loralie,Jenkyn,ljenkyn4i@ucsd.edu,Financial Analyst,6969,1920,8889
9319,Micah,Brogi,mbrogi4j@google.com.hk,Editor,9749,610,10359
9643,Elinor,Moncrefe,emoncrefe4k@over-blog.com,Statistician III,8765,1182,9947
9188,Violante,Vivash,vvivash4l@ihg.com,Occupational Therapist,2891,1853,4744
9050,Susannah,Edwicker,sedwicker4m@nature.com,General Manager,6554,368,6922
9711,Gibby,Batham,gbatham4n@java.com,Social Worker,7546,1816,9362
9761,Konstantine,Bentham,kbentham4o@baidu.com,Senior Sales Associate,6718,1369,8087
9655,Gonzalo,Terrelly,gterrelly4q@prlog.org,Dental Hygienist,5794,1632,7426
9923,Cristie,Elegood,celegood4r@toplist.cz,Accounting Assistant III,2238,1247,3485
9013,Dev,Bruckmann,dbruckmann4s@elpais.com,Business Systems Development Analyst,1046,1772,2818
9514,Ailyn,Caulfield,acaulfield4t@mozilla.org,Research Assistant I,8868,1668,10536
9587,Thedric,Pynner,tpynner4u@huffingtonpost.com,Professor,6283,441,6724
9146,Tildi,Hayen,thayen4v@reference.com,Electrical Engineer,4601,1264,5865
9561,Clayborn,Hastewell,chastewell4w@sogou.com,Financial Advisor,2510,1107,3617
9158,Abby,Hevey,ahevey4x@dailymotion.com,Physical Therapy Assistant,7187,1062,8249
9654,Waylin,Jacquemet,wjacquemet4y@github.com,Editor,8305,1716,10021
9821,Gregorio,Searight,gsearight4z@sina.com.cn,Programmer Analyst III,2880,795,3675
9035,Melli,Mertsching,mmertsching50@ihg.com,Nurse Practicioner,3569,983,4552
9380,Kelsi,Fender,kfender51@shareasale.com,Clinical Specialist,2150,978,3128
9238,Thane,Berk,tberk52@redcross.org,Clinical Specialist,4810,905,5715
9027,Dollie,Brand-Hardy,dbrandhardy53@mlb.com,Physical Therapy Assistant,9297,1255,10552
9267,Bertie,Bruinsma,bbruinsma54@newsvine.com,Tax Accountant,1022,516,1538
9523,Ber,McKague,bmckague55@wordpress.org,Research Associate,9502,1002,10504
9644,Nadean,Dunnett,ndunnett56@wikipedia.org,Automation Specialist I,2601,1779,4380
9379,Callie,Penwright,cpenwright57@ucsd.edu,Account Executive,3129,304,3433
9789,Phebe,Robbey,probbey58@fema.gov,Safety Technician IV,3712,1997,5709
9863,Sunshine,Peaden,speaden59@ucoz.ru,Budget/Accounting Analyst I,4077,850,4927
9970,Silvano,Gurnee,sgurnee5b@acquirethisname.com,Geologist II,5714,1843,7557
9968,Dane,Cruwys,dcruwys5d@godaddy.com,Food Chemist,4442,689,5131
9423,Teddie,Yves,tyves5g@flavors.me,Biostatistician III,1723,1184,2907
9071,Jerrome,Gathwaite,jgathwaite5h@bloglovin.com,Actuary,1499,715,2214
9598,Sigismondo,Lange,slange5j@i2i.jp,Software Test Engineer II,5304,993,6297
9802,Bessie,Gumbley,bgumbley5k@netlog.com,Software Test Engineer IV,8042,1551,9593
9667,Almeda,Prozillo,aprozillo5l@oakley.com,General Manager,1122,296,1418
9249,Caressa,Pindred,cpindred5m@wordpress.com,Registered Nurse,5580,1678,7258
9081,Licha,Whillock,lwhillock5n@toplist.cz,Media Manager III,8082,1246,9328
9656,Budd,Droghan,bdroghan5o@tinypic.com,Project Manager,4903,1839,6742
9924,Quintin,Cowton,qcowton5p@fda.gov,Civil Engineer,8355,578,8933
9782,Herb,Boylan,hboylan5q@ocn.ne.jp,Marketing Assistant,3761,1585,5346
9752,Gregor,Doneld,gdoneld5r@globo.com,Information Systems Manager,6982,748,7730
9339,Wakefield,Carillo,wcarillo5s@yellowbook.com,Sales Associate,1317,1718,3035
9274,Wallas,Jiranek,wjiranek5t@symantec.com,Assistant Manager,4616,1962,6578
9679,Vernice,Mahaffey,vmahaffey5u@sciencedaily.com,Senior Editor,9780,1148,10928
9148,Carolann,Kealy,ckealy5v@census.gov,Nurse,8464,1069,9533
9681,Durante,Castellone,dcastellone5w@uol.com.br,Social Worker,6372,1309,7681
9529,Albie,Leat,aleat5x@comsenz.com,Administrative Assistant III,6886,1007,7893
9095,Juline,Bulford,jbulford5z@adobe.com,Analog Circuit Design manager,8280,1249,9529
9468,Roth,MacCaghan,rmaccaghan60@weather.com,Nurse,6404,1061,7465
9696,Florence,Hayward,fhayward61@japanpost.jp,Information Systems Manager,2465,1223,3688
9916,Sky,Shergold,sshergold62@huffingtonpost.com,Technical Writer,5091,571,5662
9070,Cecilla,Scay,cscay63@oakley.com,Assistant Media Planner,9033,650,9683
9422,Juliane,Fumagallo,jfumagallo64@seattletimes.com,Media Manager IV,4777,652,5429
9629,Callean,Pilsworth,cpilsworth66@oaic.gov.au,Payment Adjustment Coordinator,5331,1090,6421
9066,Euphemia,Southerton,esoutherton67@java.com,Nurse,6831,314,7145
9836,Sunny,Cleverly,scleverly68@dagondesign.com,Research Associate,8634,432,9066
9175,Debee,Brosoli,dbrosoli69@guardian.co.uk,Web Developer III,8054,551,8605
9046,Hercule,McQuode,hmcquode6a@un.org,Technical Writer,9465,617,10082
9896,Michelle,Futter,mfutter6b@tinypic.com,Assistant Media Planner,7638,409,8047
9498,Johnna,Kelmere,jkelmere6c@ocn.ne.jp,Quality Control Specialist,5564,1068,6632
9902,Erskine,Padmore,epadmore6f@fotki.com,Quality Control Specialist,8252,214,8466
9848,Garrot,Maric,gmaric6g@dailymail.co.uk,Associate Professor,7726,1931,9657
9225,Angelia,Trowle,atrowle6h@toplist.cz,Technical Writer,6368,222,6590
9038,Cecile,Cordeiro,ccordeiro6i@mayoclinic.com,Internal Auditor,3101,875,3976
9459,Felice,McLinden,fmclinden6k@ftc.gov,Account Representative IV,2762,534,3296
9584,Vannie,Tozer,vtozer6m@chronoengine.com,Sales Representative,2385,657,3042
9735,Shela,Rogier,srogier6n@bluehost.com,Assistant Professor,3564,748,4312
9434,Kimberli,Whitmore,kwhitmore6o@si.edu,Engineer I,7728,1730,9458
9962,Yuri,Helkin,yhelkin6q@ow.ly,Actuary,5627,861,6488
9705,Jolee,Safe,jsafe6r@ocn.ne.jp,Staff Scientist,5291,1454,6745
9056,Caspar,Bennellick,cbennellick6s@dailymotion.com,Cost Accountant,7719,742,8461
9206,Leonie,Applewhite,lapplewhite6t@biglobe.ne.jp,Associate Professor,7619,2000,9619
9920,Sly,Videneev,svideneev6u@mozilla.org,Human Resources Assistant III,5278,933,6211
9517,Morty,Wilprecht,mwilprecht6v@theatlantic.com,Media Manager III,3272,1965,5237
9315,Dasie,Aspenlon,daspenlon6x@kickstarter.com,Design Engineer,1840,1805,3645
9899,Rhody,Wiffler,rwiffler6z@yelp.com,Graphic Designer,6548,1432,7980
9980,Claiborn,Dufoure,cdufoure70@miibeian.gov.cn,Marketing Assistant,5309,1378,6687
9938,Cassandre,Erdely,cerdely71@mlb.com,Pharmacist,7710,260,7970
9624,Melodee,Harmson,mharmson72@t.co,Registered Nurse,6629,1469,8098
9041,Blake,Roscher,broscher73@nsw.gov.au,Environmental Tech,5066,1961,7027
9879,Sissy,Weldrake,sweldrake75@bluehost.com,Staff Scientist,4931,986,5917
9244,Grenville,Whickman,gwhickman76@ihg.com,Account Coordinator,5592,985,6577
9455,Pascal,De Mitris,pdemitris77@deliciousdays.com,Pharmacist,5644,546,6190
9072,Ervin,Wheble,ewheble78@ibm.com,Budget/Accounting Analyst II,2796,1914,4710
9817,Abagail,Benbough,abenbough7a@dmoz.org,Business Systems Development Analyst,7334,757,8091
9851,Collin,Livesey,clivesey7b@ox.ac.uk,Assistant Media Planner,4559,855,5414
9632,Ivie,Taberer,itaberer7c@princeton.edu,Developer I,1244,815,2059
9658,Filippa,Henriksson,fhenriksson7d@loc.gov,Marketing Assistant,3441,757,4198
9493,Ogden,Tufts,otufts7e@abc.net.au,Electrical Engineer,9160,688,9848
9391,Dennie,Buttrick,dbuttrick7f@gravatar.com,Internal Auditor,4228,492,4720
9282,Neile,Ghidoni,nghidoni7g@dot.gov,Quality Engineer,2825,1950,4775
9387,Marion,Skewis,mskewis7h@washington.edu,Staff Accountant I,7162,284,7446
9103,Sanders,Jurasz,sjurasz7i@paginegialle.it,VP Quality Control,5007,1004,6011
9621,Marthena,Fossick,mfossick7j@scribd.com,Safety Technician IV,7582,831,8413
9260,Georgy,Searjeant,gsearjeant7k@forbes.com,Senior Quality Engineer,2750,1226,3976
9279,Roxane,Celand,rceland7l@theglobeandmail.com,Systems Administrator III,2990,1347,4337
9740,Steffen,Camilletti,scamilletti7m@hatena.ne.jp,Operator,2776,1870,4646
9494,Dynah,Cammell,dcammell7n@google.nl,Assistant Media Planner,9161,868,10029
9294,Andy,Rame,arame7o@uiuc.edu,Quality Engineer,9951,1538,11489
9531,Katrinka,Heyball,kheyball7p@marriott.com,Marketing Manager,4516,1937,6453
9200,Carri,Longlands,clonglands7q@shinystat.com,Electrical Engineer,7007,1264,8271
9659,Janeta,Brodway,jbrodway7r@smugmug.com,Accounting Assistant I,9089,1023,10112
9709,Carmen,Thaller,cthaller7t@free.fr,Environmental Tech,1820,1661,3481
9280,Verena,Dewitt,vdewitt7u@usda.gov,Administrative Assistant I,6496,1316,7812
9693,Gerri,Gimson,ggimson7x@samsung.com,Administrative Assistant II,3838,489,4327
9994,Ches,McCay,cmccay7y@fastcompany.com,Occupational Therapist,4623,1509,6132
9612,Horton,Itzkovich,hitzkovich7z@tamu.edu,Payment Adjustment Coordinator,7738,467,8205
9925,Raymund,Grocott,rgrocott80@cnet.com,Administrative Officer,7150,288,7438
9374,Ardenia,Ansteys,aansteys82@rambler.ru,Clinical Specialist,3893,438,4331
9555,Bessy,Lamberts,blamberts84@apache.org,Nuclear Power Engineer,2124,298,2422
9286,Alanna,Brenard,abrenard85@mtv.com,Professor,3063,821,3884
9359,Charissa,Strowan,cstrowan87@oakley.com,Help Desk Operator,2280,1796,4076
9036,Tibold,Peplaw,tpeplaw88@who.int,Graphic Designer,9359,1740,11099
9753,Blayne,Bonsale,bbonsale89@gizmodo.com,Social Worker,6202,421,6623
9966,Erma,Pedrielli,epedrielli8a@google.co.uk,Human Resources Assistant III,2192,1308,3500
9128,Tasha,Camlin,tcamlin8d@loc.gov,Structural Analysis Engineer,7463,564,8027
9640,Whitby,Svanini,wsvanini8e@prnewswire.com,Physical Therapy Assistant,4206,1000,5206
9797,Sidoney,Puzey,spuzey8g@princeton.edu,Graphic Designer,5357,885,6242
9045,Fleurette,McGurgan,fmcgurgan8h@vk.com,General Manager,2311,778,3089
9783,Sigfried,Gilyatt,sgilyatt8i@slate.com,Assistant Professor,5983,679,6662
9069,Richie,Brigge,rbrigge8j@upenn.edu,Accounting Assistant II,2806,328,3134
9800,Timoteo,Lamborn,tlamborn8k@usda.gov,Help Desk Operator,1639,1700,3339
9042,Grayce,Oxnam,goxnam8l@i2i.jp,Accountant IV,7942,1223,9165
9949,Ben,Garrand,bgarrand8m@phpbb.com,Software Engineer IV,5524,332,5856
9971,Francklin,Kopmann,fkopmann8n@quantcast.com,Help Desk Operator,4365,809,5174
9284,Pauletta,Dunford,pdunford8p@imdb.com,Professor,7475,1777,9252
9456,Gwenette,Fetter,gfetter8q@nationalgeographic.com,Environmental Specialist,8363,831,9194
9048,Patrice,Cafferky,pcafferky8s@webnode.com,Recruiter,4051,782,4833
9347,Derry,Criple,dcriple8v@deliciousdays.com,Associate Professor,6359,1667,8026
9254,Waneta,Pelfer,wpelfer8w@timesonline.co.uk,Structural Engineer,3748,901,4649
9759,Gal,Loving,gloving8x@vkontakte.ru,Structural Analysis Engineer,6621,1333,7954
9642,Chrissy,Poundford,cpoundford8y@symantec.com,Food Chemist,4658,1520,6178
9157,Jewel,Dealy,jdealy92@webeden.co.uk,VP Quality Control,1547,1882,3429
9190,Sigfried,Gjerde,sgjerde93@bizjournals.com,Quality Control Specialist,7712,1886,9598
9138,Raul,Di Francesco,rdifrancesco94@dmoz.org,Operator,8930,320,9250
9653,Lorens,Szepe,lszepe95@paypal.com,Project Manager,9460,684,10144
9401,Larisa,Pargiter,lpargiter96@foxnews.com,Engineer II,7578,244,7822
9867,Carmella,Cardoe,ccardoe99@google.co.uk,Business Systems Development Analyst,3004,1168,4172
9921,Gunar,Emanuelov,gemanuelov9a@archive.org,Junior Executive,5884,1006,6890
9436,Kippie,Jennions,kjennions9b@ocn.ne.jp,Budget/Accounting Analyst I,7213,1711,8924
9904,Darn,Mingaye,dmingaye9c@zimbio.com,Systems Administrator II,8651,1700,10351
9725,Liesa,Riveles,lriveles9d@intel.com,Professor,8991,670,9661
9730,Benjie,Rogers,brogers9f@examiner.com,Civil Engineer,7280,1113,8393
9065,Nikolai,Giacovetti,ngiacovetti9g@phoca.cz,Research Associate,6056,337,6393
9405,Goddart,Rate,grate9h@spotify.com,Director of Sales,2919,1312,4231
9062,Norry,Gilogly,ngilogly9i@amazon.co.uk,Database Administrator II,1337,915,2252
9707,Thorndike,Berr,tberr9j@paypal.com,Staff Accountant I,7937,714,8651
9363,Cam,Gerraty,cgerraty9k@tuttocitta.it,Information Systems Manager,9369,1209,10578
9602,Michaela,Caudelier,mcaudelier9l@gnu.org,Pharmacist,8847,354,9201
9881,Cristabel,Cattroll,ccattroll9m@addtoany.com,Environmental Tech,9313,1487,10800
9096,Kleon,Gulland,kgulland9n@sogou.com,Programmer IV,7065,495,7560
9569,Sandye,Puddefoot,spuddefoot9o@cnet.com,Account Representative III,2491,899,3390
9868,Carissa,Triggel,ctriggel9r@squarespace.com,Marketing Assistant,4319,993,5312
9615,Alberik,Hewins,ahewins9s@smh.com.au,Office Assistant IV,1481,1671,3152
9633,Harrietta,Nortunen,hnortunen9u@sbwire.com,Graphic Designer,7912,1677,9589
9298,Siegfried,Schimke,sschimke9v@vimeo.com,Media Manager II,9603,299,9902
9219,Farlie,Bridgement,fbridgement9x@npr.org,Research Associate,2804,410,3214
9546,Daveen,Stigers,dstigers9y@addtoany.com,Financial Analyst,8929,528,9457
9912,Noami,Georger,ngeorger9z@blogger.com,Human Resources Manager,7417,364,7781
9860,Constantino,Arundel,carundela0@java.com,Sales Associate,3328,1876,5204
9414,Cammie,Slater,cslatera1@pcworld.com,Mechanical Systems Engineer,1730,1036,2766
9939,Bennett,Ovington,bovingtona2@marketwatch.com,Geological Engineer,3456,1962,5418
9741,Christabella,Keemer,ckeemera3@va.gov,Office Assistant III,4491,1458,5949
9804,Rich,Uwins,ruwinsa4@google.com.br,Operator,9646,1983,11629
9334,Coleman,Pheasant,cpheasanta5@goo.ne.jp,Graphic Designer,4543,1355,5898
9576,Jayme,Langstone,jlangstonea6@telegraph.co.uk,Actuary,2304,1133,3437
9450,Raul,Callan,rcallana7@thetimes.co.uk,Legal Assistant,6258,1771,8029
9965,Haroun,Kiddie,hkiddiea8@accuweather.com,Assistant Professor,9233,1060,10293
9906,Bendick,Gurden,bgurdena9@wp.com,Safety Technician III,3877,1571,5448
9031,Daren,Wherry,dwherryab@paginegialle.it,Software Consultant,2914,668,3582
9452,Lura,Millin,lmillinac@slate.com,VP Quality Control,7099,1775,8874
9722,Ford,Losebie,flosebieaf@purevolume.com,Engineer I,8883,999,9882
9952,Davidde,Whitchurch,dwhitchurchag@forbes.com,Web Designer I,3716,1972,5688
9937,Cassie,Polye,cpolyeah@github.io,Dental Hygienist,4351,1044,5395
9257,Baron,Flook,bflookai@edublogs.org,Research Assistant I,4097,1804,5901
9803,Jannel,Sloane,jsloaneaj@acquirethisname.com,Quality Engineer,2381,712,3093
9373,Dasha,Brodley,dbrodleyal@elegantthemes.com,Executive Secretary,1748,1125,2873
9230,Dolly,Marven,dmarvenan@merriam-webster.com,Nurse Practicioner,1460,581,2041
9447,Nanine,Qusklay,nqusklayap@people.com.cn,VP Marketing,1504,455,1959
9348,Kendre,Woodwind,kwoodwindaq@bravesites.com,Chemical Engineer,1768,1397,3165
9303,Shaun,Jeffryes,sjeffryesaw@infoseek.co.jp,Quality Engineer,4508,1681,6189
9217,Kelly,Ravens,kravensax@cnet.com,Senior Financial Analyst,1722,634,2356
9438,Enrichetta,Bearns,ebearnsay@ebay.co.uk,Sales Representative,7524,262,7786
9543,Worth,Mannion,wmannionaz@meetup.com,Environmental Specialist,6495,1306,7801
9074,Fowler,Campo,fcampob0@typepad.com,Teacher,4834,702,5536
9942,Dolorita,Terris,dterrisb1@prweb.com,VP Marketing,9428,315,9743
9463,Keary,Brownjohn,kbrownjohnb2@cnn.com,Account Representative IV,8282,1018,9300
9678,Dix,Loreit,dloreitb3@smugmug.com,Database Administrator IV,6150,1471,7621
9533,Diena,McShirrie,dmcshirrieb5@globo.com,Senior Sales Associate,3690,1769,5459
9061,Maureen,Wetter,mwetterb7@go.com,Environmental Specialist,4750,1539,6289
9985,Colette,Cowe,ccoweb8@livejournal.com,Account Coordinator,5249,776,6025
9914,Bailie,Heller,bhellerbc@hp.com,Accounting Assistant II,7533,467,8000
9721,Angelo,Grumley,agrumleybd@ibm.com,VP Quality Control,1177,1910,3087
9927,Addison,Georgot,ageorgotbe@icio.us,Software Consultant,8385,719,9104
9827,Marion,Esch,meschbf@tumblr.com,Assistant Media Planner,4853,237,5090
9729,Ainsley,Purvess,apurvessbg@myspace.com,Cost Accountant,9586,480,10066
9271,Sherman,Swayte,sswaytebh@sphinn.com,GIS Technical Architect,1913,1821,3734
9489,Bink,Vaugham,bvaughambi@marriott.com,Research Assistant IV,1044,1652,2696
9301,Batholomew,Keavy,bkeavybj@dagondesign.com,Biostatistician II,4999,587,5586
9891,Dwain,Wherton,dwhertonbm@thetimes.co.uk,Office Assistant III,9499,1439,10938
9846,Ardath,Fouldes,afouldesbn@posterous.com,Help Desk Technician,2518,1355,3873
9581,Myrwyn,Brownbridge,mbrownbridgebo@hud.gov,Structural Engineer,2484,962,3446
9458,Freida,Lardeux,flardeuxbp@ifeng.com,Systems Administrator IV,9696,605,10301
9628,Merla,Balser,mbalserbq@cbc.ca,Human Resources Manager,2436,1646,4082
9926,Judye,Ebbens,jebbensbu@ox.ac.uk,Actuary,1025,1453,2478
9398,Valentijn,Roxbee,vroxbeeby@engadget.com,Quality Control Specialist,8640,610,9250
9032,Deb,Robun,drobunbz@imgur.com,Teacher,3001,795,3796
9866,Margaret,Garmey,mgarmeyc0@ucsd.edu,Software Engineer IV,9083,570,9653
9837,Garrett,Crackett,gcrackettc1@bing.com,Geologist IV,7047,355,7402
9009,Mychal,McKilroe,mmckilroec7@telegraph.co.uk,Office Assistant I,2607,509,3116
9481,Siward,Poinsett,spoinsettc8@blogtalkradio.com,Research Assistant I,7757,487,8244
9309,Atlanta,Gatward,agatwardc9@macromedia.com,Budget/Accounting Analyst III,1351,1977,3328
9715,Isadore,Garnar,igarnarcb@jigsy.com,Help Desk Technician,5559,558,6117
9469,Penelopa,Henfre,phenfrecc@berkeley.edu,Environmental Specialist,4797,312,5109
9996,Hadleigh,Oxborough,hoxboroughcd@joomla.org,Clinical Specialist,2079,295,2374
9340,Jason,Spurdon,jspurdonce@gnu.org,Administrative Officer,6273,893,7166
9811,Linc,Kurtis,lkurtiscf@mapquest.com,Health Coach II,2851,1455,4306
9281,Henryetta,Marryatt,hmarryattcg@slate.com,Nuclear Power Engineer,4230,1239,5469
9771,Ricky,Kiraly,rkiralych@diigo.com,Electrical Engineer,6143,1361,7504
9595,Niki,Tuffin,ntuffinck@hugedomains.com,Software Consultant,2699,1201,3900
9871,Akim,Hawkslee,ahawksleecl@epa.gov,Occupational Therapist,1767,1484,3251
9272,Osbert,Lafferty,olaffertyco@sphinn.com,Developer III,3363,1430,4793
9813,Clark,Rikel,crikelcs@elpais.com,Research Nurse,1871,1253,3124
9490,Ermin,Francioli,efranciolict@businesswire.com,Account Coordinator,9211,1025,10236
9292,Kelsi,Spikins,kspikinscv@sciencedaily.com,Business Systems Development Analyst,2657,1465,4122
9604,Bernardina,Disney,bdisneycw@engadget.com,Structural Analysis Engineer,2453,440,2893
9748,Darryl,Pietranek,dpietranekcx@ask.com,Operator,3530,1098,4628
9542,Pollyanna,Garron,pgarrond1@people.com.cn,Automation Specialist IV,8772,1893,10665
9613,Celestia,Heppenspall,cheppenspalld2@uol.com.br,Pharmacist,6545,1562,8107
9311,Perle,Boulter,pboulterd3@canalblog.com,Staff Scientist,4454,328,4782
9497,Cirilo,Heninghem,cheninghemd6@addtoany.com,Physical Therapy Assistant,2982,1727,4709
9098,Luis,Goozee,lgoozeed7@360.cn,General Manager,6043,1868,7911
9107,Jodie,Dallman,jdallmand8@bandcamp.com,Financial Analyst,1584,1163,2747
9990,Ula,Richie,urichieda@ucoz.ru,Assistant Manager,1326,1166,2492
9117,Garth,Wesley,gwesleydb@digg.com,Operator,4226,1214,5440
9088,Meghann,Hewertson,mhewertsondc@ow.ly,Teacher,9575,518,10093
9044,Imogen,Memmory,imemmorydd@chicagotribune.com,Staff Scientist,6959,385,7344
9538,Gretel,Ince,gincede@posterous.com,Physical Therapy Assistant,8909,1033,9942
9762,Siegfried,Mountjoy,smountjoydi@ameblo.jp,Actuary,9962,318,10280
9171,Chicky,Woolston,cwoolstondj@yale.edu,Registered Nurse,4370,1549,5919
9641,Kelcey,Mottinelli,kmottinellidk@live.com,General Manager,8348,1140,9488
9849,Carry,Dyet,cdyetdl@google.nl,Marketing Assistant,6770,638,7408
9451,Garrik,Duferie,gduferiedn@prnewswire.com,Operator,8766,1558,10324
9118,Florella,Koppens,fkoppensdo@google.ru,Environmental Tech,6160,921,7081
9875,Ganny,Vequaud,gvequauddp@patch.com,VP Product Management,1198,1977,3175
9033,Helaina,Dows,hdowsdr@wufoo.com,Associate Professor,9106,1188,10294
9241,Dominic,Coulbeck,dcoulbeckds@elegantthemes.com,Help Desk Operator,6258,271,6529
9522,Lyndy,Hancorn,lhancorndu@hp.com,Data Coordiator,6600,1023,7623
9472,Mikaela,Abrahams,mabrahamsdv@woothemes.com,Quality Engineer,7728,702,8430
9686,Jessee,Chastang,jchastangdw@infoseek.co.jp,Staff Accountant IV,4871,997,5868
9302,Marie,Hambly,mhamblydx@biblegateway.com,Help Desk Technician,5698,1355,7053
9577,Roselin,Guislin,rguislindy@telegraph.co.uk,Administrative Officer,9004,551,9555
9059,Ellen,Ahrenius,eahreniusdz@tuttocitta.it,Data Coordiator,6281,1288,7569
9859,Loree,Ivashintsov,livashintsove0@usda.gov,Accounting Assistant IV,9921,1892,11813
9708,Lisetta,Kerfoot,lkerfoote2@oakley.com,Financial Analyst,7975,802,8777
9888,Elinor,Suatt,esuatte4@google.ru,Programmer Analyst II,7536,1262,8798
9134,Abel,McMenamie,amcmenamiee5@vimeo.com,Structural Engineer,3816,993,4809
9935,Lynde,Eubank,leubanke7@wp.com,Help Desk Technician,8658,1367,10025
9834,Karie,Sore,ksoreeb@youku.com,Software Test Engineer III,1714,1845,3559
9152,Gwyneth,Redrup,gredrupec@nps.gov,Internal Auditor,6067,1365,7432
9616,Derwin,Tomaszkiewicz,dtomaszkiewiczed@addtoany.com,Desktop Support Technician,7381,1288,8669
9085,Tracee,Sharland,tsharlandeg@businessweek.com,Design Engineer,9075,1204,10279
9008,Isidora,Vinton,ivintoneh@auda.org.au,Database Administrator IV,3387,1438,4825
9614,Lula,Velti,lveltiei@google.nl,Research Associate,4024,1952,5976
9575,Farrell,Sima,fsimaej@fc2.com,Accountant I,1336,1452,2788
9442,Darrell,Jeannequin,djeannequinel@merriam-webster.com,Software Test Engineer IV,2724,1962,4686
9399,Marianne,Poad,mpoadeo@cafepress.com,Help Desk Technician,7244,713,7957
9559,Leontyne,Fillary,lfillaryep@wikispaces.com,Programmer I,1440,1113,2553
9549,Adelbert,Callendar,acallendares@seattletimes.com,Technical Writer,3977,358,4335
9163,Gasparo,Najafian,gnajafianet@archive.org,Cost Accountant,3028,1710,4738
9701,Demetra,Astill,dastilleu@apache.org,Assistant Manager,8103,1359,9462
9850,Eb,Yeudall,eyeudallex@sogou.com,Help Desk Operator,1857,296,2153
9820,Carlota,Rubi,crubiez@google.co.uk,Recruiting Manager,6716,688,7404
9325,Darill,Lassells,dlassellsf2@ihg.com,Quality Control Specialist,7293,547,7840
9983,Jeremy,Bortoli,jbortolif3@cbc.ca,Technical Writer,7616,1508,9124
9064,Damon,Brayshaw,dbrayshawf6@blogspot.com,Technical Writer,2057,1468,3525
9617,Gwenora,McAdam,gmcadamf8@eepurl.com,Sales Associate,9069,1687,10756
9162,Lorrin,Fillis,lfillisf9@house.gov,Accounting Assistant I,6960,1626,8586
9245,Kelley,Lafflin,klafflinfb@google.ru,Desktop Support Technician,6096,1126,7222
9350,Vonnie,Wraggs,vwraggsfc@usgs.gov,Account Executive,2673,1007,3680
9582,Ab,Pettman,apettmanfh@dion.ne.jp,Marketing Manager,2049,785,2834
9766,Mahalia,Nadin,mnadinfi@umich.edu,VP Quality Control,1567,1464,3031
9521,Roana,McKeever,rmckeeverfp@i2i.jp,Database Administrator I,2931,262,3193
9277,Guss,Ferrillio,gferrilliofs@themeforest.net,Quality Engineer,8006,1331,9337
9682,Kaia,Ubsdall,kubsdallft@oaic.gov.au,VP Product Management,9832,1929,11761
9428,Salaidh,Barok,sbarokfv@theguardian.com,Accounting Assistant III,5012,828,5840
9651,Marcille,Wagg,mwaggfx@nydailynews.com,Human Resources Assistant II,7485,1137,8622
9331,Manuel,Lake,mlakefz@joomla.org,VP Quality Control,8103,232,8335
9153,Cass,Klicher,cklicherg0@latimes.com,Speech Pathologist,8017,1112,9129
9151,Maxy,Stolworthy,mstolworthyg1@theglobeandmail.com,Occupational Therapist,7561,1862,9423
9791,Shaylyn,Allwood,sallwoodg2@free.fr,Physical Therapy Assistant,9716,1047,10763
9509,Otis,Winsom,owinsomg4@unesco.org,Technical Writer,7652,799,8451
9609,Felix,Baunton,fbauntong6@samsung.com,Chief Design Engineer,4423,1132,5555
9884,Ulrikaumeko,Gommey,ugommeyg9@noaa.gov,Office Assistant II,2417,1589,4006
9663,Brewster,Jentin,bjentinga@skype.com,Recruiting Manager,7410,841,8251
9563,Berti,Dumphy,bdumphygc@nydailynews.com,Geologist I,4122,718,4840
9750,Isabella,Walch,iwalchgd@wordpress.org,Analog Circuit Design manager,2980,1321,4301
9958,Cecelia,Fley,cfleyge@drupal.org,Professor,8325,764,9089
9908,Elsie,Selby,eselbygf@yellowbook.com,Technical Writer,3898,817,4715
9023,Claresta,Rude,crudegg@msu.edu,Payment Adjustment Coordinator,5866,281,6147
9310,Powell,Ellett,pellettgl@ca.gov,Social Worker,7133,1657,8790
9112,Herculie,Sannes,hsannesgn@youtube.com,Analog Circuit Design manager,7629,833,8462
9211,Sephira,Shear,ssheargo@phoca.cz,Quality Engineer,2916,1353,4269
9170,Wilbur,Denes,wdenesgp@lulu.com,Analog Circuit Design manager,6319,1318,7637
9530,Otto,Jannings,ojanningsgq@over-blog.com,Food Chemist,8434,1480,9914
9247,Tally,Loins,tloinsgr@mlb.com,Recruiting Manager,8874,457,9331
9662,Alaric,McKimm,amckimmgs@list-manage.com,Technical Writer,1349,262,1611
9323,Vin,Barizeret,vbarizeretgu@prnewswire.com,Structural Analysis Engineer,6295,758,7053
9326,Rafferty,Buzza,rbuzzagv@rambler.ru,Geologist I,2308,1261,3569
9005,Broddie,Gammon,bgammongy@nhs.uk,Graphic Designer,5498,1664,7162
9560,Dud,Rawcliffe,drawcliffeh3@goo.gl,Environmental Tech,7024,1112,8136
9855,Elberta,Rylands,erylandsh5@uiuc.edu,Research Associate,4732,894,5626
9336,Karoly,Sugg,ksuggh7@ocn.ne.jp,Computer Systems Analyst III,4689,1627,6316
9416,Emmey,Logsdail,elogsdailh8@vk.com,Office Assistant II,3392,1924,5316
9516,Bibbie,Helix,bhelixhd@nih.gov,Accounting Assistant I,1093,1113,2206
9256,Page,Splaven,psplavenhf@shop-pro.jp,Media Manager IV,3521,1582,5103
9346,Caro,Henriet,chenriethh@statcounter.com,Help Desk Technician,3547,839,4386
9415,Howard,Sainsberry,hsainsberryhi@ezinearticles.com,Software Test Engineer III,2336,481,2817
9872,Chlo,Heims,cheimshj@phoca.cz,Data Coordiator,6181,922,7103
9299,Chery,Bendan,cbendanhk@51.la,Cost Accountant,5486,384,5870
9689,Dulcinea,Mashal,dmashalho@so-net.ne.jp,Human Resources Manager,4427,451,4878
9507,Baxie,Fink,bfinkhp@sphinn.com,Nurse Practicioner,3783,1522,5305
9907,Sammie,Jarmyn,sjarmynhr@earthlink.net,Occupational Therapist,5069,1503,6572
9352,Selma,Carette,scarettehs@google.com,Senior Cost Accountant,4772,1534,6306
9004,Bertine,Haylands,bhaylandshu@google.nl,Systems Administrator II,3665,1618,5283
9006,Frederico,Northley,fnorthleyhw@etsy.com,Registered Nurse,9339,458,9797
9361,Gena,Hamsher,ghamsheri0@free.fr,Budget/Accounting Analyst III,9575,1953,11528
9788,Filide,De la Eglise,fdelaeglisei2@sphinn.com,Food Chemist,6869,1940,8809
9835,Joly,Blacklawe,jblacklawei4@jimdo.com,Health Coach IV,6002,1548,7550
9818,Gordy,Feaviour,gfeaviouri5@t-online.de,Graphic Designer,4800,1871,6671
9418,Merry,Bulfit,mbulfiti8@thetimes.co.uk,Nurse Practicioner,5300,944,6244
9341,Tomaso,Ronald,tronaldia@washingtonpost.com,Actuary,5761,1976,7737
9100,Pat,Howroyd,phowroydic@marketwatch.com,VP Sales,3314,1228,4542
9246,Caz,Gathercoal,cgathercoalid@usa.gov,Quality Control Specialist,9995,1980,11975
9439,Joeann,Chatto,jchattoif@trellian.com,Junior Executive,2560,536,3096
9342,Teddy,Kenington,tkeningtonig@google.co.uk,Accountant I,1506,1323,2829
9470,Cooper,Mattack,cmattackii@narod.ru,Accountant I,7291,1935,9226
9500,Dorise,Randall,drandallij@mozilla.com,Senior Sales Associate,2033,1505,3538
9136,Wood,O'Cleary,woclearyik@cbsnews.com,VP Sales,8945,436,9381
9099,Elisha,Frye,efryeip@dagondesign.com,Staff Scientist,2399,1824,4223
9691,Luce,Fauning,lfauningiq@apple.com,Assistant Manager,6309,854,7163
9550,Claudette,Morphew,cmorphewir@bloglovin.com,Research Associate,9542,774,10316
9930,Kristy,Turnor,kturnoriu@wp.com,Senior Financial Analyst,2233,210,2443
9317,Giff,Bianco,gbiancoiv@nps.gov,Computer Systems Analyst I,1374,938,2312
9421,Nana,Rontree,nrontreeix@behance.net,Senior Editor,2868,600,3468
9684,Patin,Leneve,plenevej1@i2i.jp,Automation Specialist I,7888,1708,9596
9259,Lydie,Flexman,lflexmanj2@gmpg.org,Community Outreach Specialist,4920,1421,6341
9037,Adrien,Kendall,akendallj3@booking.com,Desktop Support Technician,7029,578,7607
9015,Jill,Swetmore,jswetmorej4@bloglovin.com,Human Resources Assistant III,8603,455,9058
9362,Mendy,Ettles,mettlesj5@npr.org,Senior Cost Accountant,4612,343,4955
9125,Eryn,Crosgrove,ecrosgrovej7@reference.com,Cost Accountant,9180,1576,10756
9592,Linell,Gioani,lgioanij8@techcrunch.com,Graphic Designer,2370,1050,3420
9986,Issy,Antonignetti,iantonignettijf@hp.com,Research Assistant II,7953,1810,9763
9702,Bax,Tunnah,btunnahjg@example.com,Chief Design Engineer,6671,1481,8152
9431,Elroy,Jefferies,ejefferiesjj@phoca.cz,Geological Engineer,5922,1807,7729
9991,Devinne,Donativo,ddonativojk@weibo.com,Office Assistant I,6753,261,7014
9928,Pen,Fridlington,pfridlingtonjm@ifeng.com,Physical Therapy Assistant,4788,599,5387
9597,Bartie,Erskine Sandys,berskinesandysjo@weebly.com,Staff Accountant IV,8162,1462,9624
9824,Conny,Jolley,cjolleyjp@wisc.edu,Pharmacist,4345,1514,5859
9749,Kristofer,Worsnup,kworsnupjq@unc.edu,Associate Professor,4352,1621,5973
9354,Blisse,Kitchenham,bkitchenhamjt@google.ca,Health Coach III,9515,995,10510
9193,Arnuad,Jancik,ajancikjx@diigo.com,Payment Adjustment Coordinator,7623,1042,8665
9270,Harley,Ben,hbenk0@tinyurl.com,Speech Pathologist,2832,921,3753
9731,Matias,Cutress,mcutressk5@twitter.com,Engineer II,5241,1590,6831
9981,Chelsie,Negal,cnegalk7@ucoz.ru,Sales Associate,1769,1988,3757
9564,Carley,Coey,ccoeyk8@dyndns.org,GIS Technical Architect,7279,1672,8951
9784,Twila,Dominy,tdominyk9@sogou.com,Chief Design Engineer,5052,349,5401
9233,Sutherlan,Prowse,sprowseka@stumbleupon.com,VP Marketing,8580,469,9049
9754,Sergei,Towner,stownerkf@webmd.com,Mechanical Systems Engineer,7755,654,8409
9321,Jinny,Elacoate,jelacoatekk@google.com.au,Marketing Manager,6471,1774,8245
9454,Debi,Keble,dkeblekl@pbs.org,Human Resources Manager,7249,297,7546
9931,Langston,MacCahee,lmaccaheekn@unesco.org,Business Systems Development Analyst,8655,1247,9902
9435,Rockie,Spieght,rspieghtkt@timesonline.co.uk,Quality Control Specialist,3393,949,4342
9903,Dion,Pardey,dpardeyku@artisteer.com,Programmer III,9298,1434,10732
9382,Xenia,Fawcus,xfawcuskw@paginegialle.it,Analyst Programmer,3949,1689,5638
9676,Zack,Tainton,ztaintonkx@istockphoto.com,Desktop Support Technician,7436,705,8141
9618,Isac,McGarrie,imcgarrieky@blinklist.com,Senior Sales Associate,3352,698,4050
9320,Kayle,Halm,khalml0@studiopress.com,Quality Engineer,6225,909,7134
9610,Lurline,Strowther,lstrowtherl2@utexas.edu,Community Outreach Specialist,9907,1155,11062
9496,Desmund,Brislen,dbrislenl3@gnu.org,Librarian,9158,333,9491
9123,Shirlee,Fist,sfistl6@cyberchimps.com,Paralegal,5726,964,6690
9430,Krystal,Style,kstylel9@mail.ru,Graphic Designer,9301,1790,11091
9228,Jaimie,Kleinplatz,jkleinplatzlc@cornell.edu,Quality Engineer,2093,1401,3494
9393,Zoe,Briant,zbriantle@chronoengine.com,Associate Professor,8786,1932,10718
9213,Tanner,Delhay,tdelhaylf@purevolume.com,Nurse,4320,1454,5774
9440,Inna,Luck,ilucklg@usatoday.com,Dental Hygienist,7756,1836,9592
9551,Rosalind,Buscombe,rbuscombelh@weebly.com,Junior Executive,8180,1581,9761
9053,Ina,Vasiljevic,ivasiljevicli@prlog.org,Sales Associate,6799,1540,8339
9660,Philbert,Le Galle,plegallelj@abc.net.au,Marketing Manager,3170,593,3763
9737,Robbyn,Jocelyn,rjocelynlk@addtoany.com,Food Chemist,6265,1162,7427
9425,Ellsworth,Bracegirdle,ebracegirdleln@hp.com,Civil Engineer,8373,296,8669
9314,Daphne,Rubke,drubkelq@studiopress.com,Actuary,4616,1525,6141
9786,Rennie,Fonquernie,rfonquernielr@hubpages.com,Professor,2796,1796,4592
9992,Robin,Davidovitch,rdavidovitchls@studiopress.com,Software Engineer I,2529,742,3271
9051,Dunstan,Stocking,dstockinglt@msn.com,VP Sales,6161,1511,7672
9114,Gabbey,Stille,gstillelu@posterous.com,Geologist II,3832,862,4694
9634,Phyllis,Savill,psavilllx@dropbox.com,Electrical Engineer,9076,696,9772
9527,Jules,Pourvoieur,jpourvoieurlz@vimeo.com,Actuary,2092,437,2529
9816,Ardella,Sharpling,asharplingm0@istockphoto.com,Geologist IV,2635,1187,3822
9221,Byrle,Iddins,biddinsm1@cocolog-nifty.com,Paralegal,5122,462,5584
9378,Ellswerth,Eisikowitch,eeisikowitchm4@imgur.com,Technical Writer,6556,650,7206
9566,Lilias,Lamps,llampsma@auda.org.au,Cost Accountant,5131,846,5977
9944,Jillayne,Boame,jboamemf@geocities.com,Assistant Media Planner,6620,739,7359
9113,Candida,Steljes,csteljesmg@ask.com,Office Assistant I,4928,1334,6262
9812,Rod,Aldcorn,raldcornmh@home.pl,Administrative Assistant III,2281,547,2828
9780,Tracie,Samms,tsammsmi@sbwire.com,Financial Analyst,9708,1553,11261
9174,Ellsworth,Bonsey,ebonseyml@foxnews.com,Sales Representative,9532,1820,11352
9402,Michal,McKernon,mmckernonmn@telegraph.co.uk,Senior Cost Accountant,9687,506,10193
9203,Cob,Liver,clivermq@gizmodo.com,Internal Auditor,3278,506,3784
9209,Ed,Tattersall,etattersallmt@vimeo.com,Office Assistant I,9836,619,10455
9665,Laurena,Vedekhin,lvedekhinmv@facebook.com,Health Coach II,7868,1545,9413
9979,Kath,Ranyelld,kranyelldn0@cbc.ca,Safety Technician I,5012,459,5471
9589,Cos,Poulsen,cpoulsenn1@ebay.com,Cost Accountant,1276,1078,2354
9060,Alric,Barsham,abarshamn2@google.com,Senior Quality Engineer,7225,658,7883
9631,Eloise,Newvell,enewvelln3@amazon.co.uk,Assistant Manager,4332,450,4782
9499,Ericka,Standage,estandagen4@xinhuanet.com,Engineer III,4690,605,5295
9539,Zonda,Deval,zdevaln8@linkedin.com,Assistant Manager,7115,1480,8595
9466,Roobbie,Jago,rjagonb@parallels.com,Help Desk Technician,7767,1299,9066
9049,Ruben,Nutman,rnutmannf@dailymail.co.uk,Software Engineer II,2096,1774,3870
9847,Suzanna,Moores,smooresni@altervista.org,Web Developer II,2499,1661,4160
9390,Velma,Maven,vmavennk@cargocollective.com,Senior Sales Associate,8141,1858,9999
9548,Malinde,Del Dello,mdeldellonl@ed.gov,VP Product Management,2298,876,3174
9386,Noelyn,Ipgrave,nipgravenm@microsoft.com,Senior Financial Analyst,7959,658,8617
9661,Katya,Crumly,kcrumlyno@newyorker.com,Media Manager II,4303,419,4722
9181,Vaclav,Puttnam,vputtnamnp@biglobe.ne.jp,Systems Administrator II,8020,1604,9624
9673,Tad,Shoorbrooke,tshoorbrookent@state.tx.us,Developer IV,9791,833,10624
9995,Jdavie,Bohden,jbohdenny@boston.com,Assistant Manager,1221,1591,2812
9371,Mari,Guiver,mguivernz@berkeley.edu,Systems Administrator III,2939,204,3143
9381,Cecelia,Tweede,ctweedeo2@nbcnews.com,Recruiter,1638,366,2004
9091,Hardy,Garralts,hgarraltso3@google.nl,Occupational Therapist,9761,264,10025
9261,Carmelia,Crotty,ccrottyo5@yale.edu,Project Manager,2314,1502,3816
9411,Aube,Dohmann,adohmannoc@flavors.me,Research Associate,9744,324,10068
9012,Mariam,Gilbane,mgilbaneog@phpbb.com,VP Product Management,8097,206,8303
9978,Gun,Vannikov,gvannikovoh@eepurl.com,Legal Assistant,9242,738,9980
9018,Terrance,Gylle,tgylleoi@cbc.ca,Research Nurse,3998,1227,5225
9236,Arlie,Reinard,areinardoj@oaic.gov.au,Help Desk Technician,4172,640,4812
9895,Forster,Bronger,fbrongerok@sun.com,Chemical Engineer,7102,967,8069
9745,Barney,MacIver,bmaciverom@cocolog-nifty.com,Developer II,9142,826,9968
9963,Tammie,Heiton,theitonon@ning.com,Account Representative II,5848,1146,6994
9426,Charlie,Manilow,cmanilowot@digg.com,Nurse,6780,1163,7943
9479,Claudius,Knivett,cknivettou@zdnet.com,General Manager,2662,812,3474
9810,Madel,Mingay,mmingayov@sciencedirect.com,Teacher,6295,895,7190
9864,Perri,Phillimore,pphillimoreox@mozilla.com,Internal Auditor,5685,1315,7000
9758,Agnesse,Aysh,aayshoy@nasa.gov,Business Systems Development Analyst,9361,927,10288
9395,Veronique,Hancell,vhancelloz@va.gov,Information Systems Manager,5314,1153,6467
9131,Hasty,Tuting,htutingp5@yellowbook.com,Web Designer III,5421,1439,6860
9420,Paule,Scrine,pscrinep6@ocn.ne.jp,Structural Engineer,6516,1665,8181
9649,Florence,Bickerstaff,fbickerstaffpa@free.fr,Assistant Media Planner,4761,1629,6390
9058,Carlyn,Painten,cpaintenpc@symantec.com,Environmental Tech,9529,699,10228
9760,Darleen,Bravington,dbravingtonpd@paginegialle.it,Legal Assistant,7142,1190,8332
9133,Glen,Johananov,gjohananovpi@topsy.com,Software Consultant,2157,1475,3632
9351,Fern,Acors,facorspj@nationalgeographic.com,Sales Associate,3492,1193,4685
9186,Tabina,Rutland,trutlandps@cyberchimps.com,Senior Quality Engineer,5992,1173,7165
9243,Zenia,Bettleson,zbettlesonpv@nasa.gov,Research Assistant IV,4625,757,5382
9083,Jenica,Scalia,jscaliapw@jiathis.com,Chemical Engineer,3109,1698,4807
9167,Laurence,Jest,ljestpx@wsj.com,Help Desk Operator,8511,236,8747
9843,Noby,Gosse,ngosseq0@soup.io,Help Desk Operator,3786,1819,5605
9853,Ad,Churchouse,achurchouseq2@ted.com,Civil Engineer,8638,865,9503
9407,Griselda,Liddle,gliddleq3@wix.com,Computer Systems Analyst III,1422,384,1806
9283,Gracie,Handrick,ghandrickq7@sogou.com,Senior Editor,5261,744,6005
9196,Ramsay,Steanson,rsteansonqa@amazon.co.jp,Tax Accountant,2472,499,2971
9160,Nigel,Billanie,nbillanieqd@shop-pro.jp,Marketing Assistant,3917,1644,5561
9102,Linea,Vasyukhin,lvasyukhinqe@hao123.com,Data Coordiator,5847,1968,7815
9680,Philbert,Cranke,pcrankeqf@loc.gov,Software Test Engineer III,4638,445,5083
9889,Bourke,Dunseath,bdunseathqg@homestead.com,Physical Therapy Assistant,4886,424,5310
9392,Cosmo,Nockolds,cnockoldsqi@homestead.com,Statistician I,2062,951,3013
9268,Lynnell,Binnell,lbinnellqj@usda.gov,Assistant Manager,7632,1527,9159
9022,Tull,Attkins,tattkinsql@engadget.com,Research Nurse,9634,1517,11151
9353,Alic,Cauldfield,acauldfieldqq@slideshare.net,Help Desk Technician,5639,1231,6870
9697,Valma,Loreit,vloreitqs@nature.com,Environmental Specialist,2464,1197,3661
9484,Robinet,McLaine,rmclaineqx@edublogs.org,Occupational Therapist,1263,289,1552
9409,Monty,Mayoh,mmayohqz@github.com,Financial Advisor,5775,1818,7593
9999,Al,Duggon,aduggonr1@ycombinator.com,Speech Pathologist,9379,779,10158
9313,Rachele,Fisbey,rfisbeyr2@about.com,Senior Editor,6898,655,7553
9205,Freeman,D'Abbot-Doyle,fdabbotdoyler6@deliciousdays.com,Clinical Specialist,4746,1540,6286
9918,Lindsay,Mitchell,lmitchellr7@edublogs.org,Physical Therapy Assistant,5856,614,6470
9480,Cale,Combe,ccomber9@eepurl.com,Technical Writer,2001,714,2715
9594,Darsie,Schaffler,dschafflerra@tumblr.com,Computer Systems Analyst II,2091,210,2301
9568,Dyane,Halfacree,dhalfacreerd@mtv.com,Human Resources Manager,1906,430,2336
9168,Erek,Rowlands,erowlandsre@tinyurl.com,Recruiter,3698,587,4285
9306,Rhys,Cromwell,rcromwellri@buzzfeed.com,Junior Executive,2160,1726,3886
9692,Zeb,Paxforde,zpaxforderk@blogspot.com,Data Coordiator,9617,1605,11222
9787,Kendre,Berntsson,kberntssonrq@tripadvisor.com,Assistant Media Planner,6410,1515,7925
10132,Marsiella,Newland,mnewland0@behance.net,Quality Control Specialist,8295,1338,9633
10202,Gilbert,Isoldi,gisoldi1@cbslocal.com,Speech Pathologist,6642,977,7619
10519,Klarrisa,Espy,kespy2@booking.com,Developer II,2210,308,2518
10897,Brucie,Roft,broft3@usnews.com,Software Consultant,6284,1302,7586
10344,Susy,Smallbone,ssmallbone4@loc.gov,Director of Sales,2447,400,2847
10543,Roderick,Goodin,rgoodin5@reference.com,Staff Scientist,7217,388,7605
10264,Octavia,McRory,omcrory6@guardian.co.uk,Graphic Designer,2682,1566,4248
10686,Clifford,Pamment,cpamment7@cdbaby.com,Business Systems Development Analyst,2974,734,3708
10103,Celesta,Tuffrey,ctuffrey8@sohu.com,Actuary,3128,1834,4962
10234,Gale,Conboy,gconboy9@indiatimes.com,VP Accounting,2872,825,3697
10913,Hadleigh,McGlaud,hmcglauda@unc.edu,Professor,9706,264,9970
10484,Gal,Bargh,gbarghb@quantcast.com,Staff Scientist,3564,1776,5340
10831,Melva,Larkins,mlarkinsc@wordpress.com,Senior Quality Engineer,6963,1429,8392
10418,Cecily,Jouhandeau,cjouhandeaud@hexun.com,Editor,2495,1687,4182
10717,Markos,Alves,malvese@com.com,Budget/Accounting Analyst II,5319,1125,6444
10996,Lev,Halse,lhalsef@cbc.ca,VP Product Management,8553,732,9285
10470,Kleon,Blinerman,kblinermang@nhs.uk,Technical Writer,9017,1029,10046
10023,Evangelin,Watsam,ewatsamh@i2i.jp,Assistant Manager,3018,767,3785
10832,Domingo,Pawley,dpawleyi@businessweek.com,Research Assistant IV,9373,1762,11135
10177,Herman,Brasher,hbrasherj@digg.com,Editor,4534,367,4901
10070,Claudetta,Massey,cmasseyk@rakuten.co.jp,VP Marketing,9168,437,9605
10528,Frederique,Steere,fsteerel@guardian.co.uk,Account Coordinator,8177,1940,10117
10865,Maurene,Philippart,mphilippartm@bbc.co.uk,Recruiter,7139,679,7818
10536,Kean,Rubee,krubeen@apache.org,General Manager,8738,1466,10204
10631,Rici,Shynn,rshynno@shinystat.com,VP Quality Control,3398,1719,5117
10068,Shelagh,Bedminster,sbedminsterp@163.com,Automation Specialist II,5417,1114,6531
10804,Charis,Benka,cbenkaq@dion.ne.jp,Legal Assistant,9673,494,10167
10045,Jordan,O'Cahill,jocahillr@about.me,Director of Sales,2992,403,3395
10670,Borden,Steinham,bsteinhams@51.la,Operator,2583,695,3278
10125,Tess,Beach,tbeacht@ovh.net,Social Worker,3284,1976,5260
10294,Ruy,Genn,rgennu@acquirethisname.com,VP Marketing,5784,827,6611
10477,Braden,Wabersinke,bwabersinkev@mac.com,Compensation Analyst,6036,325,6361
10288,Abe,Wilsdon,awilsdonw@amazonaws.com,Account Executive,7556,972,8528
10875,Mic,McKeney,mmckeneyx@qq.com,Staff Scientist,6814,989,7803
10372,Aida,Camamill,acamamilly@usnews.com,Compensation Analyst,2676,296,2972
10910,Adan,Mobberley,amobberleyz@spotify.com,Developer II,4542,1989,6531
10675,Alvinia,Wormleighton,awormleighton10@domainmarket.com,Dental Hygienist,6182,246,6428
10829,Josee,Burwell,jburwell11@yahoo.com,Recruiting Manager,1680,1292,2972
10438,Welbie,Wainwright,wwainwright12@sakura.ne.jp,Web Designer I,5394,1817,7211
10569,Oona,Richmont,orichmont13@irs.gov,Biostatistician IV,8885,1751,10636
10273,Jeanie,Grimley,jgrimley15@slideshare.net,Senior Editor,3897,409,4306
10147,Huey,Fittall,hfittall16@istockphoto.com,Senior Developer,4493,1880,6373
10051,Dara,Kettoe,dkettoe17@tuttocitta.it,Research Nurse,8466,1087,9553
10240,Oralle,Lanigan,olanigan18@oaic.gov.au,Quality Control Specialist,6530,880,7410
10118,Meggi,Norton,mnorton19@blogspot.com,Occupational Therapist,5862,1753,7615
10721,Harriette,Butfield,hbutfield1a@opera.com,Paralegal,8303,499,8802
10290,Aretha,Noen,anoen1b@nps.gov,Tax Accountant,2151,760,2911
10169,Karoline,Labrenz,klabrenz1c@storify.com,Assistant Professor,1645,1604,3249
10616,Wally,Bachelar,wbachelar1d@amazonaws.com,Database Administrator II,6269,1617,7886
10124,Nikolai,MacLaughlin,nmaclaughlin1e@bbc.co.uk,Teacher,9698,858,10556
10545,Jenifer,McLurg,jmclurg1f@mlb.com,Physical Therapy Assistant,7252,379,7631
10035,Lana,Snalham,lsnalham1g@cafepress.com,Software Consultant,2176,691,2867
10274,Jordon,Brookson,jbrookson1h@gov.uk,Technical Writer,7734,1321,9055
10157,Otis,Aicken,oaicken1i@economist.com,Software Test Engineer IV,5965,1752,7717
10396,Trudey,Muncie,tmuncie1j@spotify.com,Staff Accountant III,6500,1925,8425
10178,Drona,Wannop,dwannop1k@list-manage.com,Analog Circuit Design manager,7320,1388,8708
10174,Rich,Kauschke,rkauschke1l@psu.edu,Web Developer II,5642,800,6442
10385,Berte,Cohani,bcohani1m@chron.com,Assistant Professor,2442,1071,3513
10325,Bibi,Alwin,balwin1n@taobao.com,VP Accounting,5406,842,6248
10108,Karlee,Fallis,kfallis1o@china.com.cn,Geological Engineer,4342,869,5211
10598,Kacie,Romei,kromei1p@sun.com,Quality Control Specialist,7940,561,8501
10985,Skylar,Neve,sneve1q@ucoz.com,Geologist I,2589,249,2838
10952,Lanie,Patty,lpatty1r@skyrock.com,Senior Developer,7518,1549,9067
10699,Forbes,Cookman,fcookman1s@dagondesign.com,Structural Analysis Engineer,6994,289,7283
10267,Rossie,Bisley,rbisley1t@icio.us,Systems Administrator II,1012,1932,2944
10312,Avery,Roberds,aroberds1u@imdb.com,Senior Sales Associate,1400,1879,3279
10364,Marve,Tetla,mtetla1v@dagondesign.com,Systems Administrator I,7218,1592,8810
10774,Justin,Anfonsi,janfonsi1w@4shared.com,Budget/Accounting Analyst II,6824,524,7348
10643,Silvio,Mettericke,smettericke1x@ebay.com,Technical Writer,3462,643,4105
10022,Sean,Girardetti,sgirardetti1y@webmd.com,Accountant I,9529,332,9861
10899,Zorine,Alston,zalston1z@slashdot.org,Automation Specialist II,3644,405,4049
10349,Damara,O'Deegan,dodeegan20@wp.com,Recruiter,4337,1568,5905
10818,Melisa,Fursse,mfursse21@comcast.net,Pharmacist,8877,1832,10709
10669,Jackie,Bedin,jbedin22@studiopress.com,Sales Associate,6988,1942,8930
10919,Anson,Aldrick,aaldrick23@indiegogo.com,Web Developer I,8879,1697,10576
10783,Teri,Danton,tdanton24@dion.ne.jp,Operator,5121,1825,6946
10432,Reinwald,Hattersley,rhattersley25@soup.io,Research Assistant III,2930,1524,4454
10891,Ignacio,Domotor,idomotor26@google.de,General Manager,5010,1980,6990
10203,Rey,Byatt,rbyatt27@nydailynews.com,Statistician I,5965,684,6649
10100,Jarret,Pinnick,jpinnick28@seattletimes.com,Senior Quality Engineer,1929,1572,3501
10414,Sky,Ecles,secles29@yellowbook.com,Account Representative IV,1071,1957,3028
10648,Faina,Beat,fbeat2a@washington.edu,Cost Accountant,5811,1273,7084
10058,Kimberlee,Adamson,kadamson2b@skyrock.com,Programmer Analyst II,9467,1594,11061
10538,Jules,Schrir,jschrir2c@cmu.edu,Analyst Programmer,8400,335,8735
10708,Darice,Liptrod,dliptrod2d@seesaa.net,Assistant Media Planner,6478,1441,7919
10772,Stanislas,Fludgate,sfludgate2e@utexas.edu,Software Consultant,5780,1107,6887
10789,Sebastiano,D'Antoni,sdantoni2f@pen.io,Sales Representative,5725,1670,7395
10638,Mab,Nice,mnice2g@google.co.uk,VP Sales,7046,803,7849
10757,Katti,Blew,kblew2h@sciencedirect.com,Account Executive,7422,670,8092
10600,Mahala,Sheals,msheals2i@sbwire.com,Compensation Analyst,3070,767,3837
10845,Delmar,Comolli,dcomolli2j@usgs.gov,Recruiting Manager,7834,1616,9450
10864,Ceciley,Oates,coates2k@nydailynews.com,Statistician II,3792,1759,5551
10356,Ulysses,Shilston,ushilston2l@dyndns.org,Occupational Therapist,3681,864,4545
10876,Velma,Costello,vcostello2o@mysql.com,Assistant Media Planner,6801,252,7053
10577,Lawry,Sayers,lsayers2p@fotki.com,Senior Quality Engineer,6818,1797,8615
10928,Carlynne,Biffen,cbiffen2q@tripod.com,Desktop Support Technician,9982,281,10263
10409,Tallie,Furness,tfurness2r@soundcloud.com,Web Developer III,3747,1453,5200
10363,Brana,Omar,bomar2s@tripod.com,Civil Engineer,6626,954,7580
10463,Steven,Weblin,sweblin2t@fotki.com,Analyst Programmer,9115,360,9475
10612,Page,Sprowell,psprowell2u@howstuffworks.com,Pharmacist,7891,633,8524
10310,Mendy,Chawner,mchawner2v@comcast.net,Developer IV,8620,1782,10402
10454,Jojo,Gadd,jgadd2w@constantcontact.com,Statistician III,1357,292,1649
10282,Christiano,Curgenuer,ccurgenuer2x@wix.com,Mechanical Systems Engineer,7331,779,8110
10272,Rachele,Grasner,rgrasner2y@prlog.org,Marketing Manager,9443,1491,10934
10915,Osbourne,Felten,ofelten2z@nba.com,Human Resources Manager,5334,1062,6396
10802,Ariadne,Gayne,agayne30@wsj.com,Biostatistician II,2381,714,3095
10410,Adelheid,Mounsey,amounsey32@xinhuanet.com,Operator,9966,1134,11100
10759,Modesty,Chippindall,mchippindall33@opensource.org,Research Assistant III,8153,1259,9412
10769,Tove,Leaney,tleaney34@shareasale.com,Financial Analyst,8685,1824,10509
10109,Catherina,Quinion,cquinion35@cam.ac.uk,Research Nurse,5009,1303,6312
10369,Xaviera,Goodboddy,xgoodboddy37@paginegialle.it,Software Consultant,6165,1140,7305
10480,Lou,Broomer,lbroomer38@github.io,Chief Design Engineer,8330,1347,9677
10838,Hilton,Auten,hauten39@umich.edu,Biostatistician IV,9812,793,10605
10137,Clemmy,MacNab,cmacnab3b@salon.com,Environmental Specialist,3065,1744,4809
10799,Blinny,Brunsen,bbrunsen3c@barnesandnoble.com,Developer II,9566,283,9849
10557,Pascal,Orcott,porcott3d@deviantart.com,Director of Sales,8966,733,9699
10163,Esteban,Uphill,euphill3e@flickr.com,Desktop Support Technician,1375,1491,2866
10128,Anneliese,Slym,aslym3f@guardian.co.uk,Senior Developer,1194,332,1526
10446,Daniella,Furnival,dfurnival3g@nymag.com,Media Manager III,5185,1715,6900
10031,Thor,Catlin,tcatlin3h@theguardian.com,Business Systems Development Analyst,3210,377,3587
10257,Ricoriki,Denholm,rdenholm3i@smugmug.com,Occupational Therapist,6977,1355,8332
10504,Gaspard,Biddlecombe,gbiddlecombe3j@google.cn,Community Outreach Specialist,9740,892,10632
10434,Derrik,Clout,dclout3k@wisc.edu,Programmer III,5840,600,6440
10522,Bond,Hyder,bhyder3l@buzzfeed.com,Accountant IV,8908,269,9177
10099,Lory,Alennikov,lalennikov3m@chron.com,Paralegal,6742,1533,8275
10105,Far,Leadston,fleadston3n@google.nl,Marketing Assistant,2264,1392,3656
10346,Perri,Comrie,pcomrie3o@wp.com,Staff Scientist,3620,754,4374
10266,Cathy,Asquith,casquith3p@fc2.com,Environmental Specialist,1135,1409,2544
10979,Astra,Keggin,akeggin3q@usa.gov,Administrative Assistant IV,2884,1271,4155
10316,Hersh,Reinbeck,hreinbeck3s@1688.com,Nurse Practicioner,9334,487,9821
10317,Beryle,Scoles,bscoles3t@bizjournals.com,Mechanical Systems Engineer,5586,1555,7141
10435,Sybilla,Cradock,scradock3u@t-online.de,Electrical Engineer,7936,657,8593
10440,Raleigh,Houlaghan,rhoulaghan3w@mediafire.com,VP Sales,7589,249,7838
10276,Greer,Petroselli,gpetroselli3y@joomla.org,Recruiter,7732,1351,9083
10441,Mora,Vardon,mvardon3z@miibeian.gov.cn,Geologist II,5094,261,5355
10116,Wilmette,Fleote,wfleote40@tinypic.com,Human Resources Assistant IV,5942,1690,7632
10208,Moll,Strainge,mstrainge41@is.gd,VP Quality Control,8161,325,8486
10676,Arlyn,Hallet,ahallet42@bandcamp.com,Desktop Support Technician,2516,1060,3576
10303,Moises,Buss,mbuss43@miibeian.gov.cn,Health Coach I,6726,1739,8465
10624,Cristionna,Nuccitelli,cnuccitelli44@yahoo.co.jp,Pharmacist,2277,1248,3525
10790,Noach,Erett,nerett45@devhub.com,Mechanical Systems Engineer,3773,1932,5705
10895,Gawen,Falcus,gfalcus46@utexas.edu,Computer Systems Analyst IV,1699,592,2291
10691,Brittney,Luto,bluto47@com.com,Account Executive,5026,1409,6435
10647,Murry,Dallicoat,mdallicoat48@yolasite.com,Nurse Practicioner,2854,966,3820
10175,Flint,Hindmore,fhindmore49@ebay.com,Actuary,6954,882,7836
10278,Robinia,Gumley,rgumley4a@desdev.cn,Help Desk Operator,2168,732,2900
10896,Malinda,Peteri,mpeteri4b@themeforest.net,Data Coordiator,8487,1935,10422
10779,Candace,Sagar,csagar4c@nationalgeographic.com,Geologist II,9801,490,10291
10582,Murial,Bertwistle,mbertwistle4d@blinklist.com,GIS Technical Architect,8919,378,9297
10680,Malchy,Bulfield,mbulfield4f@geocities.jp,Analog Circuit Design manager,9579,271,9850
10611,Burt,Tapply,btapply4g@bluehost.com,Account Executive,8795,383,9178
10224,Gwenneth,Marcus,gmarcus4h@cbc.ca,Director of Sales,4239,1325,5564
10580,Antonia,McGill,amcgill4i@goodreads.com,Administrative Assistant II,6255,1135,7390
10127,Frederigo,Langland,flangland4j@wunderground.com,Structural Analysis Engineer,3283,1148,4431
10581,Arlena,Denne,adenne4k@paypal.com,Computer Systems Analyst II,6418,1810,8228
10231,Mitchael,Bachshell,mbachshell4m@accuweather.com,Computer Systems Analyst IV,1014,788,1802
10750,Ingrid,Britney,ibritney4n@answers.com,Research Nurse,9442,612,10054
10287,Ceciley,McMullen,cmcmullen4o@scientificamerican.com,Dental Hygienist,6650,1447,8097
10839,Lisbeth,Harvett,lharvett4p@ehow.com,Teacher,1797,1231,3028
10554,Viv,Kennsley,vkennsley4q@dell.com,Engineer II,3335,1540,4875
10088,Gwendolyn,Pirri,gpirri4r@bloomberg.com,Senior Sales Associate,9109,302,9411
10133,Dieter,Caston,dcaston4s@zimbio.com,Human Resources Assistant I,1515,1236,2751
10886,Zena,Chittie,zchittie4t@theatlantic.com,Research Assistant I,2680,1385,4065
10614,Pauly,Beenham,pbeenham4u@bluehost.com,Financial Advisor,1927,1299,3226
10381,Arielle,Rainsbury,arainsbury4v@woothemes.com,Mechanical Systems Engineer,4650,360,5010
10101,Flem,Marcum,fmarcum4w@chicagotribune.com,Operator,1611,663,2274
10304,Abramo,Cathrae,acathrae4y@printfriendly.com,Quality Engineer,9890,819,10709
10742,Tamma,Oldnall,toldnall50@cam.ac.uk,Account Coordinator,3768,502,4270
10510,Dale,McCart,dmccart51@networkadvertising.org,Software Engineer II,7583,866,8449
10568,Jolee,Hillam,jhillam52@prweb.com,Project Manager,2380,1384,3764
10152,Emmalyn,Fintoph,efintoph53@ebay.co.uk,Research Nurse,6401,1004,7405
10889,Catherin,Pearde,cpearde54@bbb.org,Chemical Engineer,6410,1598,8008
10997,Ibrahim,Myderscough,imyderscough55@themeforest.net,Help Desk Operator,7594,1190,8784
10871,Audrye,Dayment,adayment56@reverbnation.com,Financial Advisor,5689,1174,6863
10827,Celeste,Lipyeat,clipyeat58@army.mil,Financial Analyst,2000,1661,3661
10217,Guntar,Adamolli,gadamolli59@rambler.ru,Biostatistician IV,9434,306,9740
10578,Ashla,Rivalant,arivalant5a@utexas.edu,Editor,2062,1648,3710
10170,Jessamyn,Benoit,jbenoit5b@kickstarter.com,Programmer III,1024,1185,2209
10323,Baird,Lowles,blowles5c@webs.com,Account Executive,5596,1395,6991
10805,Consuelo,Manolov,cmanolov5d@hostgator.com,VP Marketing,7106,1133,8239
10992,Odie,Guisler,oguisler5e@mozilla.com,Geologist II,9329,1903,11232
10336,Henderson,Fenty,hfenty5g@linkedin.com,Recruiter,6635,646,7281
10453,Carlin,Matushevitz,cmatushevitz5i@dmoz.org,Programmer Analyst IV,7411,1624,9035
10351,Chicky,Kellogg,ckellogg5k@msn.com,Geologist IV,1459,1172,2631
10004,Seline,McCarlich,smccarlich5l@feedburner.com,Product Engineer,8847,638,9485
10452,Hieronymus,Blazy,hblazy5m@freewebs.com,Database Administrator III,8004,1432,9436
10932,Art,Tarquini,atarquini5n@lycos.com,VP Sales,6798,724,7522
10780,Madeline,Stait,mstait5o@last.fm,Electrical Engineer,2755,1298,4053
10635,Florian,Caw,fcaw5q@uol.com.br,GIS Technical Architect,5211,1322,6533
10374,Dannel,Collymore,dcollymore5r@huffingtonpost.com,Accountant IV,8007,1563,9570
10909,Salomone,Giorgetti,sgiorgetti5s@typepad.com,Programmer II,1865,686,2551
10645,Lindsey,Dollar,ldollar5t@independent.co.uk,Staff Scientist,5243,295,5538
10816,Geordie,Stanton,gstanton5u@blogspot.com,Associate Professor,8243,1992,10235
10887,Ruggiero,Peabody,rpeabody5v@diigo.com,Human Resources Assistant II,2051,390,2441
10826,Jyoti,Braime,jbraime5w@foxnews.com,Business Systems Development Analyst,6630,680,7310
10297,Pet,Fagan,pfagan5x@skype.com,Recruiter,9593,917,10510
10401,Patricio,Ohanessian,pohanessian60@arizona.edu,Clinical Specialist,5128,1169,6297
10628,Karlens,Copozio,kcopozio62@dailymail.co.uk,Clinical Specialist,4909,1813,6722
10392,Dimitri,Wrenn,dwrenn63@digg.com,Environmental Specialist,2187,1922,4109
10848,Tom,Scrange,tscrange64@ezinearticles.com,Programmer IV,2250,1815,4065
10064,Marieann,Greathead,mgreathead65@netvibes.com,Electrical Engineer,3524,510,4034
10476,Rafaelita,Mansuer,rmansuer66@google.co.jp,Accountant IV,9408,269,9677
10095,Jemima,Neesham,jneesham67@globo.com,Account Representative III,5269,1222,6491
10959,Kerwinn,Hachette,khachette68@moonfruit.com,Physical Therapy Assistant,4883,240,5123
10427,Letti,Rubens,lrubens69@sohu.com,Registered Nurse,8898,1146,10044
10184,Erny,Enterle,eenterle6a@jiathis.com,Occupational Therapist,8314,324,8638
10641,Brooke,Shalcras,bshalcras6b@mayoclinic.com,Administrative Assistant III,1029,1462,2491
10698,Basilio,McKag,bmckag6c@yellowpages.com,Health Coach IV,2525,1836,4361
10013,Mano,Igglesden,migglesden6d@jalbum.net,Technical Writer,2069,1955,4024
10123,Thea,Dreakin,tdreakin6e@blinklist.com,Financial Advisor,3517,483,4000
10398,Belvia,Chicotti,bchicotti6f@howstuffworks.com,Information Systems Manager,1092,400,1492
10618,Andrej,Folkerd,afolkerd6g@europa.eu,VP Marketing,7253,1784,9037
10281,West,Longfellow,wlongfellow6h@go.com,Assistant Manager,9510,855,10365
10938,Kort,Wynes,kwynes6j@cargocollective.com,Biostatistician III,5207,830,6037
10449,Susette,Filipputti,sfilipputti6l@booking.com,Design Engineer,4580,986,5566
10211,Webb,Orritt,worritt6m@exblog.jp,Junior Executive,4371,1140,5511
10320,Gaylene,Guisler,gguisler6n@sbwire.com,Web Developer III,7525,1725,9250
10787,Marleah,Vineall,mvineall6q@creativecommons.org,Senior Financial Analyst,9264,1438,10702
10990,Riordan,Abercrombie,rabercrombie6r@sourceforge.net,Engineer III,3243,603,3846
10331,Aloysia,Eivers,aeivers6s@youku.com,Analyst Programmer,4953,1889,6842
10098,Rivkah,Aubry,raubry6u@shutterfly.com,Financial Analyst,2898,1713,4611
10286,Holly-anne,Latter,hlatter6v@people.com.cn,Graphic Designer,1324,1050,2374
10355,Ford,Abrehart,fabrehart6w@ustream.tv,GIS Technical Architect,8254,547,8801
10447,Charmane,Swidenbank,cswidenbank6x@a8.net,VP Accounting,8194,1998,10192
10907,Tina,Daymond,tdaymond6y@topsy.com,Software Engineer I,7800,225,8025
10855,Alane,Brettoner,abrettoner6z@pen.io,Social Worker,5523,1122,6645
10505,Lia,Malkie,lmalkie71@scientificamerican.com,Project Manager,7147,954,8101
10450,Niall,Steedman,nsteedman73@umn.edu,Statistician II,1061,1301,2362
10679,Newton,Pearman,npearman74@hhs.gov,Senior Cost Accountant,8332,536,8868
10579,Adelaide,Luberto,aluberto75@mayoclinic.com,Sales Representative,2710,499,3209
10697,Juanita,Itzhayek,jitzhayek76@springer.com,Database Administrator II,2773,1907,4680
10473,Traci,Cracker,tcracker77@weibo.com,Speech Pathologist,1737,816,2553
10114,Meridel,Cluney,mcluney78@fotki.com,Senior Developer,6911,1707,8618
10764,Guenna,O'Coskerry,gocoskerry7a@dell.com,VP Quality Control,8284,1526,9810
10922,Jules,Gothard,jgothard7b@usda.gov,Product Engineer,8658,1490,10148
10087,Tessie,Oakhill,toakhill7c@canalblog.com,Data Coordiator,5201,1968,7169
10555,Idalia,Dulton,idulton7g@miitbeian.gov.cn,Community Outreach Specialist,1282,1096,2378
10509,Cele,Mussington,cmussington7h@rakuten.co.jp,Legal Assistant,6525,366,6891
10347,Timothy,Linnemann,tlinnemann7i@cafepress.com,Legal Assistant,4567,1155,5722
10637,Julietta,Bauduccio,jbauduccio7j@shutterfly.com,Engineer III,5343,1154,6497
10167,Karoline,Hammerson,khammerson7k@yellowpages.com,Health Coach IV,6049,1456,7505
10830,Dee,Hanney,dhanney7l@google.co.uk,Computer Systems Analyst III,3832,483,4315
10185,Caitrin,Tewkesbury,ctewkesbury7m@squidoo.com,VP Product Management,3551,1847,5398
10556,Cos,Hebdon,chebdon7n@cmu.edu,Software Consultant,3675,950,4625
10565,Marlo,Mogenot,mmogenot7o@google.com,Food Chemist,5206,1205,6411
10540,Juana,Collyer,jcollyer7p@hatena.ne.jp,General Manager,4273,987,5260
10215,Ailene,Bumford,abumford7q@telegraph.co.uk,Web Developer III,4585,486,5071
10792,Faydra,Schutt,fschutt7r@elpais.com,Budget/Accounting Analyst I,4892,1640,6532
10393,Emmett,Ivanenkov,eivanenkov7s@buzzfeed.com,Project Manager,4594,623,5217
10160,Elisabetta,Crutcher,ecrutcher7u@tamu.edu,Sales Associate,8768,1238,10006
10642,Skippie,Wardrop,swardrop7w@geocities.com,Professor,3997,531,4528
10209,Kathryne,Lacheze,klacheze7x@patch.com,Social Worker,6871,1230,8101
10399,Lorenzo,Wiggins,lwiggins7y@about.me,Staff Scientist,1976,1886,3862
10849,Collen,Winsor,cwinsor7z@slashdot.org,Associate Professor,2164,834,2998
10063,Roxanna,Doxsey,rdoxsey80@examiner.com,VP Product Management,1661,1538,3199
10327,Peyter,Vignaux,pvignaux83@dailymotion.com,Assistant Professor,5584,1259,6843
10162,Malena,Castano,mcastano84@bing.com,Design Engineer,7380,1434,8814
10712,Kermy,Fosserd,kfosserd85@usatoday.com,Web Designer IV,3225,1272,4497
10621,Iona,Foffano,ifoffano86@oracle.com,Data Coordiator,2840,1816,4656
10615,Jameson,Linbohm,jlinbohm88@zdnet.com,Recruiting Manager,6991,1299,8290
10061,Giovanna,Reavell,greavell89@apache.org,Quality Control Specialist,8730,602,9332
10620,Waylen,Poschel,wposchel8a@unc.edu,Dental Hygienist,3233,1608,4841
10315,Glory,Allcock,gallcock8b@linkedin.com,Account Coordinator,3838,1082,4920
10677,Farleigh,Smooth,fsmooth8c@ebay.co.uk,Senior Quality Engineer,8767,372,9139
10634,Silas,Veracruysse,sveracruysse8d@sakura.ne.jp,Project Manager,1524,1542,3066
10692,Elmore,Zannini,ezannini8e@a8.net,Accountant II,5350,643,5993
10852,Adrian,Heugle,aheugle8f@photobucket.com,Librarian,3151,637,3788
10566,Alverta,Kinastan,akinastan8g@statcounter.com,Statistician I,5972,779,6751
10283,Man,Tellett,mtellett8i@fastcompany.com,Programmer Analyst III,9129,589,9718
10704,Darrin,Merriott,dmerriott8k@webs.com,Structural Engineer,2817,733,3550
10238,Sasha,Saurat,ssaurat8l@livejournal.com,Community Outreach Specialist,9721,502,10223
10166,Buffy,McCloy,bmccloy8o@nih.gov,Librarian,4207,1897,6104
10081,De,Mainwaring,dmainwaring8p@parallels.com,Chemical Engineer,8019,1870,9889
10377,Kassia,Biggins,kbiggins8s@oaic.gov.au,Sales Representative,9553,1105,10658
10300,Merrielle,Verden,mverden8t@sakura.ne.jp,VP Quality Control,3161,520,3681
10249,Amity,Miles,amiles8u@businessinsider.com,Software Consultant,6825,1373,8198
10436,Matelda,Scrange,mscrange8w@reddit.com,Physical Therapy Assistant,2422,898,3320
10513,Raddy,Elliman,relliman8x@whitehouse.gov,Social Worker,1766,838,2604
10993,Ashlee,Dews,adews8y@plala.or.jp,Product Engineer,2156,888,3044
10053,Thain,Goldhawk,tgoldhawk8z@chronoengine.com,Analog Circuit Design manager,5112,1451,6563
10030,Hobey,Thumim,hthumim91@tripadvisor.com,Marketing Assistant,2411,384,2795
10313,Olia,Shottin,oshottin92@freewebs.com,Data Coordiator,3786,1285,5071
10253,Jennifer,Tothacot,jtothacot93@edublogs.org,General Manager,4025,1728,5753
10497,Alida,Mundwell,amundwell96@umn.edu,Project Manager,3425,1226,4651
10632,Tan,Valois,tvalois99@blinklist.com,Help Desk Operator,3377,237,3614
10332,Nicolle,Northfield,nnorthfield9a@howstuffworks.com,Structural Engineer,6728,1237,7965
10856,Emalee,Zoppie,ezoppie9d@youtu.be,VP Marketing,9982,1004,10986
10298,Fionna,Iscowitz,fiscowitz9e@google.com.au,Sales Representative,6915,670,7585
10225,Gilles,Pohlak,gpohlak9f@google.com.hk,Environmental Specialist,6674,1887,8561
10574,Kacey,Pavy,kpavy9g@go.com,Physical Therapy Assistant,7226,1488,8714
10508,Fredric,Benner,fbenner9i@sun.com,Recruiting Manager,2247,1399,3646
10781,Hercule,Gapper,hgapper9j@skype.com,Office Assistant II,8517,1621,10138
10389,Tobiah,Measor,tmeasor9m@prnewswire.com,Technical Writer,2431,1353,3784
10194,Ellene,McParlin,emcparlin9n@infoseek.co.jp,Clinical Specialist,1134,1844,2978
10475,Lezley,Forte,lforte9o@latimes.com,Senior Developer,6016,813,6829
10251,Skye,Flisher,sflisher9p@cdbaby.com,Legal Assistant,8572,469,9041
10195,Marabel,Wylder,mwylder9r@timesonline.co.uk,Civil Engineer,3217,1686,4903
10090,Benny,Chopy,bchopy9s@theglobeandmail.com,Nurse Practicioner,9721,310,10031
10754,Roselle,Glading,rglading9u@boston.com,Statistician II,8330,1181,9511
10705,Iolanthe,Benka,ibenka9v@ehow.com,Executive Secretary,4057,449,4506
10425,Dimitri,Lavallie,dlavallie9w@privacy.gov.au,Executive Secretary,4770,351,5121
10602,Rowe,Castagne,rcastagne9x@theglobeandmail.com,Media Manager II,7056,1017,8073
10927,Julio,Fildes,jfildes9y@usa.gov,Editor,9783,610,10393
10350,Anatol,Amies,aamiesa0@digg.com,Staff Accountant II,6788,1337,8125
10379,Alfie,Frayling,afraylinga1@guardian.co.uk,Quality Engineer,5169,1567,6736
10756,Fonsie,Vidineev,fvidineeva2@google.nl,Technical Writer,4068,1973,6041
10149,Cary,Yerborn,cyerborna4@imdb.com,Research Nurse,1857,1978,3835
10813,Lisle,Ventom,lventoma5@tripod.com,Information Systems Manager,5834,1307,7141
10161,Giulia,Varne,gvarnea7@t-online.de,Structural Analysis Engineer,2082,1034,3116
10603,Gnni,Aupol,gaupola9@feedburner.com,Analog Circuit Design manager,5998,736,6734
10291,Bert,Scarr,bscarrab@rambler.ru,Geologist II,7717,1780,9497
10881,Lorelei,McKeran,lmckeranac@163.com,Web Designer II,4429,1319,5748
10626,Donnell,McNabb,dmcnabbad@woothemes.com,Director of Sales,8278,461,8739
10696,Brooke,Tallis,btallisae@shinystat.com,Environmental Specialist,7165,343,7508
10700,Gratiana,Penhaligon,gpenhaligonaf@ifeng.com,Developer I,8323,1094,9417
10371,Ynes,Perham,yperhamag@netscape.com,Software Test Engineer I,1885,1862,3747
10444,Bridgette,Nan Carrow,bnancarrowah@webeden.co.uk,VP Accounting,6425,1889,8314
10462,Gideon,Keene,gkeeneaj@chron.com,Human Resources Assistant II,8489,787,9276
10761,Amerigo,Jerman,ajermanal@google.it,Staff Scientist,8291,1646,9937
10905,Errol,Stivani,estivaniam@bloglovin.com,Social Worker,2405,555,2960
10943,Margaretta,Baselio,mbaselioao@themeforest.net,Professor,8605,300,8905
10547,Seth,McKeighen,smckeighenap@blogspot.com,Assistant Media Planner,2301,396,2697
10419,Siana,Gathercoal,sgathercoalaq@myspace.com,Assistant Professor,8129,441,8570
10749,Karylin,Cohalan,kcohalanar@pagesperso-orange.fr,Environmental Specialist,7779,1591,9370
10383,Gill,Hoff,ghoffas@squidoo.com,Biostatistician IV,1028,1678,2706
10820,Sonja,Lorey,sloreyat@va.gov,Accounting Assistant III,5712,1090,6802
10726,Suzann,Kilalea,skilaleaau@mapy.cz,Staff Accountant IV,5462,1419,6881
10817,Mohammed,Gerrish,mgerrishaw@stumbleupon.com,Clinical Specialist,2128,1852,3980
10451,Justino,Huleatt,jhuleattax@instagram.com,Legal Assistant,4781,1397,6178
10014,Suzi,Mallaby,smallabyay@jalbum.net,Health Coach I,1736,676,2412
10706,Reade,Belone,rbeloneaz@issuu.com,Desktop Support Technician,2191,1407,3598
10324,Calv,Apfelmann,capfelmannb1@nationalgeographic.com,Developer III,9964,859,10823
10951,Hayes,Ducroe,hducroeb3@diigo.com,Assistant Professor,9465,1005,10470
10102,Thaxter,Gamil,tgamilb4@mashable.com,Administrative Assistant III,6363,1014,7377
10111,Abram,Belsey,abelseyb5@vkontakte.ru,Executive Secretary,3866,530,4396
10341,Emmalee,Donneely,edonneelyb6@flickr.com,Sales Associate,1481,1689,3170
10751,Vanni,Sweeny,vsweenyb7@abc.net.au,Project Manager,6002,1774,7776
10117,Julietta,Gotter,jgotterb8@a8.net,Quality Engineer,1826,1839,3665
10295,Galven,Ilbert,gilbertb9@1und1.de,Safety Technician IV,6392,509,6901
10314,Lanie,Gadeaux,lgadeauxba@digg.com,Professor,9547,823,10370
10843,Nahum,McClenaghan,nmcclenaghanbb@qq.com,Administrative Assistant IV,3259,861,4120
10815,Feodor,Clawsley,fclawsleybd@scientificamerican.com,Research Nurse,5598,1605,7203
10722,Jed,Pardue,jparduebe@hostgator.com,Accountant II,6443,292,6735
10994,Brennan,Dorbin,bdorbinbh@wikia.com,Statistician I,7471,830,8301
10041,Electra,Lease,eleasebj@craigslist.org,Design Engineer,7413,1219,8632
10028,Darsie,Samuel,dsamuelbk@sourceforge.net,Staff Scientist,9209,1805,11014
10530,Roseanna,Issacoff,rissacoffbl@infoseek.co.jp,Cost Accountant,5040,1884,6924
10479,Nickey,Moorrud,nmoorrudbn@infoseek.co.jp,Sales Associate,6350,462,6812
10847,Ruthanne,Bride,rbridebr@amazon.co.uk,Marketing Assistant,7043,1045,8088
10026,Harli,Huband,hhubandbs@google.de,Nuclear Power Engineer,5365,859,6224
10610,Leone,Warry,lwarrybu@webeden.co.uk,Developer III,1558,949,2507
10586,Guillemette,Jerrans,gjerransbv@networkadvertising.org,Clinical Specialist,6394,1666,8060
10424,Jeffie,Fleote,jfleotebw@furl.net,Financial Analyst,1164,1093,2257
10744,Karl,Philo,kphiloby@lycos.com,Programmer Analyst I,9182,1746,10928
10517,Parrnell,Obal,pobalbz@youtube.com,Help Desk Technician,4446,804,5250
10729,Florencia,McCartney,fmccartneyc0@google.com.hk,Tax Accountant,8314,628,8942
10391,Winona,Arnoult,warnoultc1@biglobe.ne.jp,Geological Engineer,4393,1053,5446
10926,Hugues,Broune,hbrounec2@pinterest.com,Social Worker,2282,426,2708
10572,Bord,Hugueville,bhuguevillec5@vinaora.com,Health Coach I,5402,1761,7163
10667,Kaiser,Urquhart,kurquhartc6@dedecms.com,Operator,8825,220,9045
10617,Koren,Serchwell,kserchwellc8@artisteer.com,Software Engineer I,5234,1351,6585
10777,Herb,Venable,hvenablec9@smugmug.com,Assistant Manager,9646,691,10337
10275,Mandy,Dreghorn,mdreghornca@scribd.com,Design Engineer,6633,1527,8160
10980,Reina,Raggett,rraggettcb@bloglines.com,Mechanical Systems Engineer,3676,1860,5536
10495,Gaby,Matevosian,gmatevosiancc@npr.org,General Manager,5597,1701,7298
10785,Haley,Fairbairn,hfairbairnce@mediafire.com,Librarian,8053,792,8845
10428,Sylas,Reignolds,sreignoldscf@hibu.com,VP Sales,6192,1286,7478
10069,Tiphanie,Taylor,ttaylorcg@hugedomains.com,Geologist II,8047,468,8515
10311,Cull,Alliston,callistonch@flavors.me,VP Sales,5448,819,6267
10940,Dianemarie,Rapier,drapierci@people.com.cn,Nurse Practicioner,6564,1749,8313
10964,Hanson,Pegden,hpegdencj@thetimes.co.uk,Pharmacist,2918,1347,4265
10738,Bentley,Danilchev,bdanilchevck@imageshack.us,Structural Engineer,9632,1231,10863
10468,Nikoletta,Farquarson,nfarquarsoncl@discuz.net,Recruiter,9652,405,10057
10791,Lezley,Stickels,lstickelscn@chicagotribune.com,Environmental Specialist,8745,1559,10304
10917,Maressa,Urvoy,murvoyct@weebly.com,Registered Nurse,4684,491,5175
10078,Susannah,Lambrechts,slambrechtscu@prnewswire.com,Internal Auditor,9345,1306,10651
10212,Hansiain,Meikle,hmeiklecw@4shared.com,Legal Assistant,7033,1729,8762
10835,Hetty,Mityashev,hmityashevcx@fda.gov,Senior Editor,8054,569,8623
10230,Ezri,Grinsted,egrinstedcy@stanford.edu,Operator,6494,552,7046
10442,Andres,Dutch,adutchd0@sourceforge.net,Sales Associate,7899,1050,8949
10965,Ransell,Wolpert,rwolpertd2@t.co,Health Coach IV,2038,737,2775
10284,Bari,Kasbye,bkasbyed3@1688.com,Occupational Therapist,9559,1150,10709
10888,Holly,Grane,hgraned6@shareasale.com,Health Coach I,7579,712,8291
10734,Adamo,Francklyn,afrancklynd7@tumblr.com,Librarian,2834,1103,3937
10052,Maisie,Top,mtopd8@sourceforge.net,Software Engineer IV,9160,1438,10598
10092,Rawley,Roake,rroakeda@netscape.com,Environmental Specialist,3593,738,4331
10437,Saw,Hartnell,shartnelldb@youku.com,Chemical Engineer,4985,1476,6461
10775,Verene,Lourenco,vlourencodd@behance.net,Senior Sales Associate,2080,1901,3981
10796,Benton,Vasovic,bvasovicde@sciencedaily.com,Budget/Accounting Analyst I,3264,460,3724
10719,Sigismund,Anney,sanneydg@forbes.com,Environmental Specialist,4066,585,4651
10859,Bernita,Frift,bfriftdh@addthis.com,Occupational Therapist,4398,1778,6176
10129,Tobie,Vanyatin,tvanyatindi@gmpg.org,Paralegal,4547,696,5243
10150,Gaynor,Bramhall,gbramhalldk@printfriendly.com,Registered Nurse,1321,1386,2707
10299,Elva,Guiso,eguisodm@comsenz.com,VP Sales,1841,1010,2851
10376,Ranna,Kolak,rkolakdp@dailymail.co.uk,Design Engineer,4161,1447,5608
10908,Danya,Kinastan,dkinastandq@xrea.com,Professor,4480,1448,5928
10534,Davidde,Titmus,dtitmusdr@reuters.com,Help Desk Operator,3867,1881,5748
10352,Sansone,Willicott,swillicottdu@issuu.com,Executive Secretary,2556,879,3435
10107,Odette,Thornebarrow,othornebarrowdw@who.int,Junior Executive,5386,959,6345
10640,Viv,Barfoot,vbarfoote3@intel.com,Senior Developer,6478,454,6932
10841,Dasha,Jenkins,djenkinse4@twitter.com,Analog Circuit Design manager,5643,1159,6802
10106,Odilia,O'Dyvoie,oodyvoiee7@freewebs.com,Biostatistician IV,3750,549,4299
10921,Nalani,Kirkebye,nkirkebyee9@bigcartel.com,Analyst Programmer,7840,1859,9699
10741,Rochester,Enoch,renochea@csmonitor.com,Associate Professor,8409,536,8945
10482,Neda,Hynson,nhynsoneb@sitemeter.com,Electrical Engineer,6066,1218,7284
10086,Neysa,Burgwin,nburgwinec@webmd.com,Senior Sales Associate,9816,729,10545
10776,Joyous,Cundy,jcundyed@google.pl,Associate Professor,1313,1130,2443
10558,Reggy,Stroulger,rstroulgeree@netvibes.com,Mechanical Systems Engineer,8421,1916,10337
10360,Keslie,Blune,kbluneef@mac.com,Senior Cost Accountant,8999,1240,10239
10974,Kay,Hewins,khewinseg@eventbrite.com,GIS Technical Architect,8903,836,9739
10395,Greggory,Blow,gblowej@discuz.net,Analog Circuit Design manager,1420,1234,2654
10171,Woodrow,Barette,wbaretteel@vistaprint.com,Help Desk Operator,5050,1421,6471
10154,Kevon,Szymon,kszymonem@github.com,Technical Writer,7952,415,8367
10753,Lainey,MacDonough,lmacdonougheo@fotki.com,Biostatistician I,7276,655,7931
10559,Tobe,Merrgan,tmerrganep@i2i.jp,Accountant I,3432,373,3805
10681,Danyette,Monnelly,dmonnellyeq@123-reg.co.uk,Human Resources Manager,4150,472,4622
10840,Cordi,Cobbled,ccobbledet@sfgate.com,Technical Writer,2960,958,3918
10190,Dulcy,Gulland,dgullandeu@blogger.com,Media Manager I,3044,636,3680
10724,Drake,Sparling,dsparlingez@delicious.com,Physical Therapy Assistant,9842,289,10131
10918,Arlan,Ricioppo,aricioppof3@intel.com,Quality Engineer,8806,1299,10105
10806,Kandace,Knevet,kknevetf5@google.com.hk,Environmental Specialist,1194,233,1427
10289,Rubetta,Shapiro,rshapirof7@dailymotion.com,Software Engineer IV,8571,260,8831
10006,Lorianne,Mamwell,lmamwellf8@studiopress.com,Compensation Analyst,3683,1450,5133
10235,Natassia,Pinsent,npinsentfb@flavors.me,Programmer Analyst I,3681,389,4070
10466,Seth,Pirrie,spirriefc@vkontakte.ru,Structural Analysis Engineer,3390,610,4000
10916,Willetta,Yarnold,wyarnoldff@rediff.com,Human Resources Assistant I,7626,1697,9323
10587,Vassili,Fidelli,vfidellifh@blogtalkradio.com,Tax Accountant,5352,509,5861
10417,Frankie,Poile,fpoilefn@mysql.com,Librarian,1075,643,1718
10933,Gussi,Child,gchildfp@go.com,Senior Quality Engineer,9760,1383,11143
10652,Claire,Kornyakov,ckornyakovft@quantcast.com,Director of Sales,6890,209,7099
10629,Mendie,Larenson,mlarensonfu@ow.ly,Chemical Engineer,6568,1403,7971
10067,Kissee,Tirkin,ktirkinfz@telegraph.co.uk,Environmental Tech,5160,227,5387
10246,Roshelle,McCome,rmccomeg0@meetup.com,Research Nurse,4345,538,4883
10819,Cati,Hallihan,challihang1@sphinn.com,Research Assistant III,8666,1516,10182
10173,Tedie,Smetoun,tsmetoung2@princeton.edu,Sales Representative,2293,408,2701
10987,Cloris,Martijn,cmartijng3@google.co.jp,Structural Engineer,5560,1360,6920
10378,Chase,McLeish,cmcleishg6@netvibes.com,VP Accounting,8216,284,8500
10226,Chiquita,McWilliams,cmcwilliamsg8@time.com,Assistant Professor,6722,1809,8531
10260,Valentine,Stannislawski,vstannislawskig9@webnode.com,Computer Systems Analyst II,7363,1117,8480
10089,Donelle,Pinn,dpinnga@cnn.com,Administrative Assistant III,1530,1804,3334
10515,Nicky,Terrelly,nterrellygb@reddit.com,Administrative Assistant IV,1435,884,2319
10457,Darrell,Scarsbrick,dscarsbrickgd@google.co.uk,Research Assistant III,4879,1515,6394
10198,Callean,Kuhndel,ckuhndelge@blogspot.com,Senior Quality Engineer,7610,1594,9204
10042,Daryl,Haddeston,dhaddestongg@usnews.com,Senior Sales Associate,2553,213,2766
10301,Jesse,Jordon,jjordongl@typepad.com,Account Representative IV,6775,1942,8717
10957,Clement,Dibble,cdibblegm@flickr.com,Operator,6191,930,7121
10223,Nap,Cordero,ncorderogn@constantcontact.com,Electrical Engineer,3556,1985,5541
10330,Dorolisa,Furbank,dfurbankgo@nymag.com,Help Desk Technician,8754,1683,10437
10651,Cordi,Rosenberg,crosenberggp@dropbox.com,Account Coordinator,1466,1815,3281
10575,Eadith,Enocksson,eenockssongq@google.com,Chemical Engineer,4368,1193,5561
10083,Zora,Milbank,zmilbankgr@drupal.org,Office Assistant III,8357,474,8831
10762,Gerhardine,Spelman,gspelmangs@blog.com,Senior Quality Engineer,2501,437,2938
10588,Tiphany,McKerlie,tmckerliegt@walmart.com,Teacher,9913,410,10323
10269,Hyacinth,Callaway,hcallawaygv@typepad.com,Data Coordiator,1855,1306,3161
10972,Juieta,Meneur,jmeneurgw@privacy.gov.au,Media Manager II,3636,1942,5578
10760,Silvia,Botwood,sbotwoodgy@list-manage.com,Account Representative IV,8106,1701,9807
10590,Olimpia,Jubert,ojuberth0@blinklist.com,Legal Assistant,1857,1753,3610
10043,Cora,Kalewe,ckaleweh2@icio.us,Marketing Assistant,7986,1190,9176
10948,Burnard,Dunphie,bdunphieh3@weather.com,Structural Analysis Engineer,3223,1754,4977
10242,Nanete,Daveridge,ndaveridgeh4@boston.com,Software Engineer IV,6654,402,7056
10584,Kristy,Clapperton,kclappertonh5@gnu.org,Engineer I,4049,588,4637
10976,Haroun,Reveland,hrevelandh6@slashdot.org,Software Engineer III,1833,727,2560
10767,Hagen,Filip,hfiliph7@ed.gov,Civil Engineer,3579,1532,5111
10459,Frederick,Westmore,fwestmoreh8@deviantart.com,Senior Sales Associate,4107,1167,5274
10423,Timmie,De Maine,tdemainehb@guardian.co.uk,Technical Writer,3578,964,4542
10362,Shanan,Ducker,sduckerhe@time.com,VP Sales,3390,1400,4790
10165,Dorelia,Liddyard,dliddyardhg@cornell.edu,Social Worker,6526,678,7204
10248,Christoforo,Eglese,ceglesehh@wunderground.com,Product Engineer,4182,318,4500
10139,Hoebart,Marzelle,hmarzellehi@yellowbook.com,Biostatistician III,6936,764,7700
10846,Tanhya,Kennally,tkennallyhk@hao123.com,VP Marketing,1248,1788,3036
10280,Isiahi,Fortoun,ifortounhm@edublogs.org,Staff Scientist,2792,1380,4172
10711,Idette,McCathy,imccathyhr@utexas.edu,Software Test Engineer I,4119,884,5003
10471,Victoria,Bunney,vbunneyhx@tripadvisor.com,Research Associate,4372,810,5182
10486,Claire,Ferruzzi,cferruzzihy@slideshare.net,Programmer IV,7974,962,8936
10727,Una,Hanwright,uhanwrighti2@cdbaby.com,Sales Associate,7247,1690,8937
10713,Efrem,Henner,ehenneri4@photobucket.com,Software Test Engineer IV,6035,1129,7164
10322,Shandra,Domoni,sdomonii6@github.com,Sales Associate,4038,1481,5519
10973,Ashleigh,Cescotti,acescottii8@wordpress.com,Research Nurse,1385,367,1752
10518,Eartha,Ivimy,eivimyia@army.mil,Human Resources Assistant I,3641,1581,5222
10773,Francklin,Cuphus,fcuphusii@dailymail.co.uk,Structural Analysis Engineer,2127,423,2550
10094,Hugues,Dingle,hdingleim@cloudflare.com,VP Product Management,6601,1667,8268
10305,Nerta,Vazquez,nvazquezio@tumblr.com,Sales Representative,1932,617,2549
10233,Tierney,Antonomolii,tantonomoliiip@weather.com,Data Coordiator,1288,493,1781
10047,Caralie,Abrashkov,cabrashkovir@hp.com,Systems Administrator I,5052,1788,6840
10623,Isidore,Patise,ipatiseiv@dell.com,Business Systems Development Analyst,3483,921,4404
10867,Ulrica,Izod,uizodiz@alexa.com,Registered Nurse,1913,1245,3158
10027,Jeralee,Basindale,jbasindalej0@dedecms.com,Graphic Designer,9662,483,10145
10038,Rosalind,Gomm,rgommj3@ning.com,Web Designer I,3982,765,4747
10361,Marji,Gerauld,mgerauldjd@yolasite.com,Sales Representative,5613,1123,6736
10962,Don,Sedgmond,dsedgmondje@mediafire.com,Human Resources Manager,2291,618,2909
10523,Kermie,Gariff,kgariffjf@unicef.org,Software Test Engineer III,4492,1431,5923
10309,Fulvia,Pleasance,fpleasancejg@nydailynews.com,Occupational Therapist,6817,443,7260
10958,Jacquelyn,Sultan,jsultanjh@samsung.com,Community Outreach Specialist,9010,1087,10097
10809,Konrad,Offord,koffordjj@java.com,Financial Analyst,6005,483,6488
10243,Maggi,Ferronet,mferronetjk@comsenz.com,Statistician II,9469,1859,11328
10668,Chloris,Wackley,cwackleyjl@yellowpages.com,Internal Auditor,6903,1716,8619
10710,Bili,Baytrop,bbaytropjm@utexas.edu,Marketing Manager,3911,1313,5224
10002,Monah,Tayspell,mtayspelljn@com.com,Technical Writer,9487,1856,11343
10989,Myrtie,Longbottom,mlongbottomjr@yellowbook.com,Human Resources Assistant IV,3694,214,3908
10228,Ronica,Blaxlande,rblaxlandejs@sogou.com,Financial Advisor,6991,286,7277
10770,Valina,Camble,vcamblejv@dedecms.com,Mechanical Systems Engineer,1563,1944,3507
10902,Roma,Palle,rpallejw@ca.gov,Nuclear Power Engineer,6754,1667,8421
10367,Franchot,Margeram,fmargeramjy@imgur.com,Registered Nurse,8672,1120,9792
10967,Wendell,Shackleton,wshackletonjz@ucoz.com,Senior Editor,2637,1860,4497
10176,Bax,Gippes,bgippesk1@ning.com,Community Outreach Specialist,9621,1496,11117
10821,Alleyn,Pauley,apauleyk6@clickbank.net,Health Coach III,3428,1649,5077
10752,Julie,Sloper,jsloperk8@chron.com,Analog Circuit Design manager,9294,327,9621
10520,Gregory,Loughren,gloughrenka@google.ru,VP Quality Control,4792,1267,6059
10467,Bartie,Osman,bosmankb@mozilla.com,Director of Sales,1613,1510,3123
10925,Ros,Barbosa,rbarbosakg@deviantart.com,Speech Pathologist,8620,1806,10426
10571,Maggie,Peirpoint,mpeirpointkh@who.int,Research Assistant IV,4392,255,4647
10671,Perl,Clayden,pclaydenkj@csmonitor.com,Internal Auditor,9561,606,10167
10851,Licha,Laughrey,llaughreykl@princeton.edu,Environmental Specialist,9793,248,10041
10335,Benedick,Yakuntsov,byakuntsovkm@so-net.ne.jp,Staff Accountant IV,6457,1036,7493
10999,Babb,Leyninye,bleyninyekn@narod.ru,Assistant Professor,8324,1390,9714
10550,Kariotta,Corsar,kcorsarko@amazon.co.uk,Account Representative III,3931,763,4694
10016,Rayshell,Appleyard,rappleyardkq@adobe.com,Accountant III,3921,1861,5782
10057,Georgette,Bann,gbannks@tuttocitta.it,VP Quality Control,6434,557,6991
10953,Odelle,Shepherdson,oshepherdsonkt@mapy.cz,Developer III,7850,1594,9444
10456,Elfie,Crocetti,ecrocettikw@ocn.ne.jp,Research Nurse,1169,746,1915
10872,Cinnamon,Clowsley,cclowsleykz@time.com,Legal Assistant,5962,1205,7167
10970,Biddy,Gramer,bgramerl1@wp.com,Administrative Assistant II,1780,311,2091
10464,Candide,Osbiston,cosbistonl2@cargocollective.com,Civil Engineer,5608,1757,7365
10956,Jeni,Emblin,jemblinl3@barnesandnoble.com,Research Assistant IV,6451,1587,8038
10265,Niels,Lathleiff,nlathleiffl5@un.org,Chief Design Engineer,1176,488,1664
10890,Abagael,Pauluzzi,apauluzzil6@army.mil,Help Desk Technician,2609,1573,4182
10803,Thomas,Maytum,tmaytuml7@earthlink.net,Technical Writer,4012,1924,5936
10397,Rosemaria,Bonnavant,rbonnavantl9@princeton.edu,Civil Engineer,2692,1488,4180
10893,Ianthe,Wheelan,iwheelanla@usgs.gov,Marketing Manager,3645,251,3896
10511,Carmelia,Booy,cbooyld@miibeian.gov.cn,Senior Quality Engineer,4899,419,5318
10730,Gris,Verecker,gvereckerle@nyu.edu,Registered Nurse,2944,458,3402
10743,Ryan,Fumagall,rfumagalllg@phoca.cz,Chemical Engineer,8418,361,8779
10728,Miriam,Kleehuhler,mkleehuhlerlj@cnet.com,Engineer III,8462,755,9217
10155,Joyce,Saby,jsabylk@webeden.co.uk,Operator,5894,1472,7366
10998,Carie,Perrat,cperratln@loc.gov,Software Test Engineer II,9540,442,9982
10971,Florentia,Kidney,fkidneylr@elegantthemes.com,Compensation Analyst,4895,1256,6151
10216,Wrennie,Danskine,wdanskinels@xrea.com,Assistant Media Planner,5400,351,5751
10489,Keane,McGinny,kmcginnylu@msu.edu,Safety Technician IV,3795,556,4351
10720,Gayler,Varns,gvarnslw@issuu.com,Help Desk Technician,4217,1946,6163
10005,Arabela,Bangley,abangleyly@blog.com,Human Resources Manager,5252,521,5773
10040,Batsheva,Papes,bpapesm1@phpbb.com,Electrical Engineer,2225,1592,3817
10326,Violette,Corney,vcorneym2@technorati.com,Quality Engineer,1693,1609,3302
10386,Benetta,Hallgate,bhallgatem7@narod.ru,Technical Writer,2287,1177,3464
10296,Barth,Brazil,bbrazilmb@typepad.com,Budget/Accounting Analyst I,9069,910,9979
10836,Adler,Gilling,agillingmc@sina.com.cn,Clinical Specialist,7865,675,8540
10678,Trevor,Maltman,tmaltmanmg@goo.ne.jp,Analyst Programmer,3768,998,4766
10920,Dionisio,Ansty,danstymh@woothemes.com,Editor,6174,1942,8116
10961,Talya,Calyton,tcalytonmj@hugedomains.com,Compensation Analyst,6587,1136,7723
10408,Debera,Casali,dcasalimk@home.pl,Senior Financial Analyst,5551,645,6196
10850,Charissa,Deavin,cdeavinml@is.gd,Engineer IV,3415,1794,5209
10412,Towney,Jephson,tjephsonmn@technorati.com,Chemical Engineer,2566,309,2875
10187,Nichole,Thoma,nthomamr@chronoengine.com,Programmer Analyst IV,7203,1658,8861
10034,Homere,Brownsett,hbrownsettmw@w3.org,Nurse Practicioner,3204,1021,4225
10151,Kissee,Driffill,kdriffillmy@arstechnica.com,Senior Cost Accountant,8452,1489,9941
10406,Melitta,Ellingham,mellinghammz@adobe.com,Food Chemist,6295,1181,7476
10604,Errol,Eveque,eevequen1@jalbum.net,Junior Executive,5622,1171,6793
10945,Jelene,Tanman,jtanmann4@cloudflare.com,Occupational Therapist,3525,1513,5038
10833,Paten,Ranvoise,pranvoisen5@symantec.com,Graphic Designer,5657,231,5888
10825,Ermin,Pattison,epattisonna@house.gov,Accountant I,6215,786,7001
10950,Elwyn,Jakubovitch,ejakubovitchnf@symantec.com,Chief Design Engineer,6409,1755,8164
10074,Christi,Marval,cmarvalng@virginia.edu,Media Manager I,1657,486,2143
10823,Mina,Rickeard,mrickeardnk@harvard.edu,Automation Specialist IV,3793,1672,5465
10213,Tania,Fairley,tfairleyno@quantcast.com,VP Sales,6311,1069,7380
10065,Julianne,Thunnercliff,jthunnercliffnq@example.com,Media Manager I,8156,1808,9964
10844,Elaine,Tansley,etansleynr@craigslist.org,Tax Accountant,8013,382,8395
10465,Barton,Kenworth,bkenworthnv@acquirethisname.com,Desktop Support Technician,2548,1669,4217
10448,Adrien,Wringe,awringenw@ucsd.edu,GIS Technical Architect,8963,230,9193
10882,Yankee,Djokic,ydjokicnz@seesaa.net,Senior Financial Analyst,3289,1416,4705
10353,Ethelyn,Bourdel,ebourdelo1@sphinn.com,Programmer II,2222,639,2861
10701,Myriam,Fessby,mfessbyo2@toplist.cz,Sales Representative,3008,1717,4725
10394,Derron,Suerz,dsuerzo5@surveymonkey.com,Web Designer III,8481,1986,10467
10685,Cloris,Boog,cboogo7@networkadvertising.org,Programmer IV,8874,698,9572
10182,Susi,Sharer,ssharero9@1und1.de,Mechanical Systems Engineer,5909,473,6382
10071,Colas,Rillett,crillettoc@sohu.com,Human Resources Assistant I,2726,1303,4029
10252,Imogene,Ellson,iellsonoj@wp.com,Recruiting Manager,7335,960,8295
10903,Mindy,Helleker,mhellekerok@elegantthemes.com,VP Marketing,5499,1027,6526
10869,Arabel,Goodspeed,agoodspeedoo@marketwatch.com,Structural Engineer,6846,1963,8809
10601,Amaleta,Froud,afroudop@pagesperso-orange.fr,Programmer Analyst III,4910,633,5543
10541,Nanni,Warhurst,nwarhurstor@ezinearticles.com,Help Desk Operator,6326,798,7124
10221,Licha,Church,lchurchos@edublogs.org,Programmer Analyst III,4076,1899,5975
10533,Catharine,Hutt,chuttow@geocities.jp,Dental Hygienist,9549,1244,10793
10674,Salim,Peoples,speoplesoz@buzzfeed.com,VP Accounting,3415,813,4228
10201,Rosalia,Cubberley,rcubberleyp2@nasa.gov,Sales Associate,2863,1800,4663
10158,Eugine,Farrear,efarrearp8@bandcamp.com,VP Marketing,5841,1634,7475
10008,Wandie,McCome,wmccomepf@nyu.edu,Staff Scientist,2918,946,3864
10080,Hernando,Boobier,hboobierpn@mayoclinic.com,Occupational Therapist,5913,783,6696
10585,Ebony,Ilson,eilsonpo@microsoft.com,Geological Engineer,4850,416,5266
10119,Cal,Bohler,cbohlerpq@simplemachines.org,Analog Circuit Design manager,4052,1705,5757
10657,Bridgette,Cobbold,bcobboldps@google.com.au,VP Marketing,1950,1190,3140
10210,Margery,Roffe,mroffepz@php.net,Cost Accountant,8897,267,9164
10091,Chancey,Elmhurst,celmhurstq0@comcast.net,Sales Associate,4326,304,4630
10319,Rodolfo,Woodage,rwoodageq2@slate.com,Graphic Designer,8398,1399,9797
10633,Elfrida,Dracey,edraceyq4@comcast.net,VP Accounting,6597,1974,8571
10136,Jeromy,Barttrum,jbarttrumq9@nifty.com,Clinical Specialist,4064,1214,5278
10941,Valene,Davidoff,vdavidoffqd@google.cn,Marketing Assistant,5524,1861,7385
10229,Wittie,Verchambre,wverchambreqe@who.int,Technical Writer,7969,725,8694
10018,Jefferey,Tibald,jtibaldqg@mayoclinic.com,Financial Advisor,8245,1375,9620
10898,Aurie,Colloff,acolloffqk@netvibes.com,Account Coordinator,1596,836,2432
10308,Ezri,Finnie,efinnieql@sphinn.com,Sales Representative,2058,1243,3301
10666,Bill,Keene,bkeeneqn@xing.com,Associate Professor,3221,1064,4285
10015,Bryce,Tout,btoutqp@tumblr.com,Staff Accountant IV,9456,705,10161
10814,Lurline,Besset,lbessetqr@51.la,Programmer Analyst II,8711,1319,10030
10810,Marilee,Wandless,mwandlessqu@earthlink.net,Technical Writer,2045,1981,4026
10348,Siobhan,Aris,sarisqv@gravatar.com,Payment Adjustment Coordinator,5734,1210,6944
10237,Tallulah,Crowter,tcrowterqy@dailymail.co.uk,Account Executive,4873,598,5471
10256,Aime,Rieme,ariemeqz@comcast.net,Help Desk Technician,3848,705,4553
10660,Pierce,de Bullion,pdebullionr2@globo.com,Tax Accountant,7790,1223,9013
10219,Merridie,Roggero,mroggeror3@github.com,Senior Developer,1933,906,2839
10800,Garold,Fratczak,gfratczakr6@51.la,Technical Writer,2243,567,2810
10146,Lisbeth,Desson,ldessonrf@istockphoto.com,Account Executive,4325,1600,5925
10164,Creigh,Rickaby,crickabyrl@yolasite.com,Business Systems Development Analyst,9269,1139,10408
10694,Eb,Cogar,ecogarrm@alibaba.com,Recruiting Manager,5295,250,5545
10439,Stephani,Byfford,sbyffordrp@gov.uk,Junior Executive,2815,1283,4098
10662,Aretha,Drynan,adrynanrr@oaic.gov.au,Accounting Assistant III,5040,1331,6371
11386,Tristan,Rubertis,trubertis0@sina.com.cn,Administrative Officer,8315,1626,9941
11683,Corny,Tremmil,ctremmil1@wikipedia.org,Business Systems Development Analyst,4668,1110,5778
11988,Westley,Jervis,wjervis2@surveymonkey.com,Food Chemist,2774,1749,4523
11872,Laurie,Buzza,lbuzza3@hexun.com,Quality Control Specialist,5683,436,6119
11883,Almeria,Drewitt,adrewitt4@usnews.com,General Manager,4786,1650,6436
11624,Joana,Filipovic,jfilipovic5@linkedin.com,Business Systems Development Analyst,5045,1559,6604
11316,Kelley,Whyard,kwhyard6@eepurl.com,Financial Analyst,9175,591,9766
11789,Amalle,Legges,alegges7@1688.com,Nurse,1957,1786,3743
11982,Giselbert,Gianolo,ggianolo8@vimeo.com,Legal Assistant,2083,287,2370
11597,Dorotea,Leet,dleet9@marketwatch.com,Community Outreach Specialist,2545,299,2844
11142,Halsy,Magauran,hmagaurana@usatoday.com,GIS Technical Architect,8580,426,9006
11430,Terrie,Kik,tkikb@macromedia.com,Senior Quality Engineer,6834,811,7645
11260,Basilio,Yarranton,byarrantonc@behance.net,Physical Therapy Assistant,5570,1180,6750
11941,Moss,Carnaman,mcarnamand@ow.ly,Editor,2013,1970,3983
11532,Atalanta,Artingstall,aartingstalle@tmall.com,Chief Design Engineer,6920,909,7829
11931,Kordula,Oty,kotyf@cam.ac.uk,Payment Adjustment Coordinator,3383,1097,4480
11910,Julianne,Sloan,jsloang@samsung.com,Actuary,5326,1772,7098
11566,Finlay,Corbishley,fcorbishleyh@ucla.edu,Media Manager III,5491,1527,7018
11626,Daron,Blazewicz,dblazewiczi@epa.gov,Desktop Support Technician,5614,1656,7270
11220,Trish,Storie,tstoriej@discuz.net,Developer I,1166,1762,2928
11852,Halette,Killbey,hkillbeyk@nymag.com,Senior Financial Analyst,5716,1758,7474
11916,Carce,Redhills,credhillsl@nature.com,Pharmacist,2184,1107,3291
11770,Floria,Dozdill,fdozdillm@alibaba.com,VP Product Management,2339,1750,4089
11571,Scarface,Pahler,spahlern@sun.com,Senior Developer,1124,1206,2330
11944,Jabez,Tebbs,jtebbso@seattletimes.com,Executive Secretary,7228,1686,8914
11375,Earle,Decker,edeckerp@spotify.com,Senior Quality Engineer,5141,1017,6158
11269,Marchall,Fidelli,mfidelliq@cornell.edu,VP Quality Control,4522,868,5390
11659,Merralee,Dillicate,mdillicater@ocn.ne.jp,Budget/Accounting Analyst I,1074,1520,2594
11627,Bartholomeus,Votier,bvotiers@wordpress.org,Chemical Engineer,5471,1500,6971
11402,Bertrando,Jahnig,bjahnigt@cnn.com,Legal Assistant,6715,932,7647
11860,Zaccaria,McHale,zmchaleu@nbcnews.com,Developer IV,2610,1139,3749
11022,Flint,Hanigan,fhaniganv@china.com.cn,Sales Associate,2783,701,3484
11056,Saul,Cattermull,scattermullw@oaic.gov.au,Desktop Support Technician,7611,211,7822
11735,Iorgo,Keuning,ikeuningx@census.gov,Administrative Assistant IV,8794,1972,10766
11663,Caitrin,Minguet,cminguety@cyberchimps.com,Mechanical Systems Engineer,9244,638,9882
11538,Benjamin,Corrado,bcorradoz@squidoo.com,Director of Sales,3235,1025,4260
11600,Ynes,Hadwen,yhadwen10@army.mil,Software Consultant,2073,1699,3772
11072,Addy,Gittus,agittus11@istockphoto.com,Information Systems Manager,9879,1318,11197
11756,Mill,Cusick,mcusick12@seattletimes.com,Nurse Practicioner,4676,1870,6546
11038,Aron,Sandy,asandy13@baidu.com,Project Manager,9837,1132,10969
11238,Britta,Watkiss,bwatkiss14@who.int,Community Outreach Specialist,2624,1651,4275
11881,Johnna,Purdey,jpurdey15@edublogs.org,Financial Analyst,4798,755,5553
11476,Lindsay,Cantor,lcantor16@archive.org,Editor,8039,1103,9142
11215,Horatia,Beldom,hbeldom17@lulu.com,Financial Analyst,4685,411,5096
11804,Patton,Tratton,ptratton19@marriott.com,Associate Professor,4963,1711,6674
11549,Morgen,Jarret,mjarret1a@comsenz.com,Research Associate,5817,1256,7073
11324,Gwyn,Genny,ggenny1b@thetimes.co.uk,Marketing Manager,8209,1871,10080
11196,Yvonne,McMeeking,ymcmeeking1c@reuters.com,Human Resources Manager,1912,776,2688
11235,Hollyanne,Windress,hwindress1d@g.co,Recruiting Manager,2527,1166,3693
11116,Elisabet,Lettley,elettley1e@trellian.com,Cost Accountant,8407,989,9396
11228,Corri,Woolpert,cwoolpert1f@loc.gov,Analog Circuit Design manager,4687,1133,5820
11962,Herculie,Brend,hbrend1g@woothemes.com,Legal Assistant,5370,907,6277
11644,Carlen,Backes,cbackes1h@wp.com,Software Engineer I,2054,923,2977
11516,Davy,Simpkin,dsimpkin1i@jiathis.com,Software Test Engineer II,5575,1504,7079
11167,Lindsay,Vittore,lvittore1j@paypal.com,Automation Specialist I,1351,1999,3350
11648,Ulrica,Crates,ucrates1l@twitter.com,Marketing Manager,1942,1960,3902
11884,Cyrus,Clemence,cclemence1m@mit.edu,Engineer I,7825,1468,9293
11569,Lammond,O' Quirk,loquirk1n@google.com.hk,VP Product Management,5326,1217,6543
11996,Ann,Deaville,adeaville1o@google.ca,Geological Engineer,3666,1461,5127
11114,Jone,Staniford,jstaniford1p@independent.co.uk,Recruiting Manager,6545,593,7138
11917,Saunder,Grigolon,sgrigolon1q@microsoft.com,Staff Scientist,7457,1954,9411
11422,Aloise,Renneke,arenneke1r@usatoday.com,Account Executive,1707,1386,3093
11802,Anastassia,Brizland,abrizland1s@slate.com,Assistant Manager,3212,485,3697
11414,Ailsun,Jerson,ajerson1t@wp.com,Programmer I,5026,1302,6328
11491,Nonah,Tupling,ntupling1u@yale.edu,Senior Cost Accountant,3054,1195,4249
11441,Roselia,Adelsberg,radelsberg1v@slideshare.net,Director of Sales,2717,698,3415
11077,Jaynell,Blunsden,jblunsden1w@domainmarket.com,Business Systems Development Analyst,3654,519,4173
11254,Melamie,Tchaikovsky,mtchaikovsky1x@indiatimes.com,Research Assistant I,9992,1397,11389
11293,Edita,Humbert,ehumbert1y@xrea.com,Developer II,8525,790,9315
11205,Beverlie,Mattiessen,bmattiessen1z@reference.com,Senior Quality Engineer,9670,253,9923
11553,Nathaniel,Pennells,npennells20@deliciousdays.com,Environmental Tech,6923,824,7747
11418,Corri,Heatherington,cheatherington21@nasa.gov,Technical Writer,3789,687,4476
11363,Florina,Haswell,fhaswell22@sfgate.com,Clinical Specialist,7096,1661,8757
11867,Brook,Burfield,bburfield23@yale.edu,Assistant Media Planner,5759,806,6565
11652,Claudia,Vurley,cvurley24@e-recht24.de,Statistician I,3621,1062,4683
11862,Reagen,Colbron,rcolbron25@storify.com,Analyst Programmer,7659,1593,9252
11262,Jeni,Simounet,jsimounet26@xing.com,Quality Engineer,4361,1696,6057
11330,Samantha,Voce,svoce29@yale.edu,Software Engineer III,7400,964,8364
11451,Danice,Simanek,dsimanek2a@blogs.com,Electrical Engineer,3779,324,4103
11816,Amelita,Pyett,apyett2b@godaddy.com,Senior Financial Analyst,3579,218,3797
11401,Paco,Lambkin,plambkin2c@ustream.tv,Developer IV,1941,501,2442
11536,Hewitt,Creser,hcreser2d@dailymail.co.uk,Analyst Programmer,9614,618,10232
11391,Timmie,Fawlks,tfawlks2g@over-blog.com,Biostatistician III,8726,887,9613
11902,Ronny,Aldis,raldis2h@google.co.jp,Mechanical Systems Engineer,1802,1859,3661
11761,Jana,Kealy,jkealy2i@independent.co.uk,Electrical Engineer,3847,1459,5306
11428,Aleece,Allbut,aallbut2j@sakura.ne.jp,Software Test Engineer IV,8420,363,8783
11846,Mercie,Maynard,mmaynard2l@ocn.ne.jp,Research Assistant I,1527,326,1853
11408,Sapphire,Bygraves,sbygraves2m@netvibes.com,Nurse Practicioner,2995,1764,4759
11703,Mitzi,Paton,mpaton2n@facebook.com,Programmer III,7680,1642,9322
11517,Merridie,Pettigrew,mpettigrew2o@lulu.com,Statistician IV,7588,544,8132
11158,Curt,Bellanger,cbellanger2p@livejournal.com,Staff Accountant II,3756,1074,4830
11241,Carleton,Silvers,csilvers2q@linkedin.com,Structural Analysis Engineer,7448,717,8165
11103,Kimberly,Rice,krice2r@globo.com,Executive Secretary,9762,1755,11517
11289,Orren,Sivorn,osivorn2s@clickbank.net,Web Designer II,3273,254,3527
11312,Garrot,Canniffe,gcanniffe2t@youtu.be,Developer III,6433,1816,8249
11280,Yankee,Rayment,yrayment2u@jigsy.com,Speech Pathologist,4966,1793,6759
11747,Margret,Radsdale,mradsdale2v@va.gov,Geologist II,6357,1135,7492
11522,Agathe,Chafney,achafney2w@reverbnation.com,Financial Advisor,1414,469,1883
11110,Donalt,Messam,dmessam2x@freewebs.com,Recruiting Manager,5652,743,6395
11483,Marya,Petroff,mpetroff2z@quantcast.com,Senior Cost Accountant,7912,1772,9684
11250,Whittaker,Fearon,wfearon30@java.com,Software Test Engineer I,9738,722,10460
11899,Mirabelle,Irdale,mirdale31@comcast.net,Software Test Engineer IV,6301,470,6771
11218,Peggi,Renn,prenn32@pcworld.com,Speech Pathologist,8592,299,8891
11714,Haywood,Durdle,hdurdle33@a8.net,VP Product Management,3535,607,4142
11112,Albina,Farnsworth,afarnsworth34@flickr.com,Marketing Assistant,9163,1984,11147
11607,Lemuel,Schneidar,lschneidar36@sogou.com,Desktop Support Technician,2960,860,3820
11655,Katlin,Lees,klees37@google.nl,Editor,6153,748,6901
11443,Leonelle,Larmouth,llarmouth38@washington.edu,Environmental Tech,8779,413,9192
11176,Horten,Notley,hnotley3a@twitpic.com,Teacher,9878,311,10189
11723,Randie,Sporrij,rsporrij3b@elegantthemes.com,Paralegal,7078,755,7833
11999,Jenilee,Addicott,jaddicott3c@homestead.com,Internal Auditor,2424,1046,3470
11275,Koo,Skade,kskade3d@cdc.gov,General Manager,5192,703,5895
11544,Maxy,Harnes,mharnes3e@yolasite.com,Civil Engineer,6402,633,7035
11738,Mata,Rowthorne,mrowthorne3f@surveymonkey.com,Registered Nurse,4062,598,4660
11259,Mick,Peaseman,mpeaseman3g@imageshack.us,Product Engineer,8824,769,9593
11863,Mischa,Linthead,mlinthead3h@ning.com,VP Sales,7118,1930,9048
11344,Koressa,Kauscher,kkauscher3j@exblog.jp,Social Worker,3036,1687,4723
11097,Allx,Loughren,aloughren3k@uiuc.edu,Business Systems Development Analyst,3659,643,4302
11162,Dmitri,Glandon,dglandon3m@narod.ru,Dental Hygienist,6080,1306,7386
11531,Lilllie,St Leger,lstleger3n@themeforest.net,Community Outreach Specialist,6011,828,6839
11608,Nathanial,Jorn,njorn3o@unesco.org,Nurse,4950,1217,6167
11533,Nerissa,Farrans,nfarrans3p@storify.com,Senior Developer,6494,1088,7582
11301,Adora,Newbury,anewbury3q@desdev.cn,Accounting Assistant I,9355,1326,10681
11561,Purcell,Cragg,pcragg3r@youtube.com,Information Systems Manager,9904,1177,11081
11904,Maribel,Presswell,mpresswell3s@ca.gov,Senior Quality Engineer,5352,406,5758
11666,Johnna,Flucks,jflucks3t@flickr.com,Assistant Professor,5395,632,6027
11076,Jayme,Marcham,jmarcham3u@shutterfly.com,Web Designer I,3417,1036,4453
11822,Ferdy,Mercik,fmercik3v@timesonline.co.uk,General Manager,8239,1956,10195
11040,Myer,Dibnah,mdibnah3w@nytimes.com,Budget/Accounting Analyst III,4589,440,5029
11841,Welsh,Tembey,wtembey3x@unicef.org,Executive Secretary,9219,600,9819
11814,Claribel,Lawty,clawty3z@vimeo.com,Physical Therapy Assistant,8435,1709,10144
11067,Myrilla,Torritti,mtorritti40@altervista.org,Senior Editor,6376,318,6694
11826,Leonelle,Bradder,lbradder41@surveymonkey.com,General Manager,8603,428,9031
11489,Hamil,Spillman,hspillman42@goo.gl,Senior Financial Analyst,3527,1413,4940
11008,Sanderson,Allcorn,sallcorn44@umn.edu,Financial Advisor,4987,425,5412
11838,Desmund,Aucott,daucott45@squidoo.com,Technical Writer,4917,1096,6013
11079,Binny,Spiller,bspiller47@google.de,Database Administrator II,3605,1065,4670
11211,Linnell,Haydock,lhaydock48@businesswire.com,Staff Accountant I,1578,1967,3545
11462,Desmund,Rase,drase49@github.io,Systems Administrator III,8635,263,8898
11327,Teirtza,Jacobsohn,tjacobsohn4a@tripadvisor.com,Media Manager III,6822,1542,8364
11625,Bernadette,Keates,bkeates4b@omniture.com,Financial Advisor,6908,576,7484
11456,Tracee,Bissiker,tbissiker4d@dagondesign.com,Structural Engineer,1619,573,2192
11340,Adrianna,Kindread,akindread4e@prweb.com,Speech Pathologist,1349,303,1652
11677,Conny,Shoebottom,cshoebottom4f@mapy.cz,Junior Executive,1644,210,1854
11292,Hansiain,Forrestill,hforrestill4g@japanpost.jp,Assistant Media Planner,1643,1833,3476
11345,Crystie,Ivashechkin,civashechkin4h@state.gov,Environmental Tech,8236,1291,9527
11674,Brett,MacCague,bmaccague4i@ovh.net,Engineer III,5184,604,5788
11866,Bernadina,Korda,bkorda4k@house.gov,Librarian,5422,845,6267
11967,Rosalinde,Dagger,rdagger4l@yellowpages.com,Geologist I,4610,1597,6207
11710,Cozmo,Ten Broek,ctenbroek4o@parallels.com,Recruiting Manager,4684,305,4989
11557,August,Baptie,abaptie4p@t.co,Sales Representative,7135,1992,9127
11897,Jen,Canedo,jcanedo4r@senate.gov,Data Coordiator,3947,785,4732
11513,Jessamyn,Cassel,jcassel4s@hatena.ne.jp,Librarian,2682,856,3538
11484,Lucien,Probetts,lprobetts4t@fc2.com,Administrative Assistant II,4286,1922,6208
11879,Amabelle,Lander,alander4v@smh.com.au,Developer III,1712,380,2092
11031,Shirlee,Boulde,sboulde4w@histats.com,Community Outreach Specialist,4700,1721,6421
11166,Annabelle,Tirrell,atirrell4x@aol.com,Environmental Tech,2407,1163,3570
11628,Ches,Greenley,cgreenley4z@statcounter.com,Environmental Tech,8111,1469,9580
11471,Anatollo,Gowdie,agowdie50@blogtalkradio.com,Junior Executive,1688,1891,3579
11043,Carmina,Dominy,cdominy51@telegraph.co.uk,Engineer IV,1134,1530,2664
11803,Angelico,Raubheim,araubheim52@ted.com,Product Engineer,1460,1138,2598
11711,Collie,Postians,cpostians53@shareasale.com,Help Desk Technician,4277,200,4477
11890,Addi,Chadd,achadd54@wp.com,Actuary,5290,804,6094
11876,Rora,Roberson,rroberson55@cargocollective.com,Geologist III,9372,355,9727
11672,Fredericka,Mallatratt,fmallatratt57@irs.gov,Account Executive,8088,592,8680
11861,Bruce,Pieche,bpieche58@163.com,Developer III,2249,228,2477
11439,Tuck,Korpolak,tkorpolak59@desdev.cn,Human Resources Manager,2586,201,2787
11933,Blaire,McLaren,bmclaren5a@arstechnica.com,Paralegal,2640,1101,3741
11728,Lindsy,Barcke,lbarcke5d@chronoengine.com,VP Sales,2890,1497,4387
11688,Tobey,Harower,tharower5e@wp.com,Physical Therapy Assistant,8660,599,9259
11819,Priscilla,De Bruijn,pdebruijn5f@soup.io,Environmental Tech,3320,334,3654
11900,Ailbert,Lepick,alepick5g@soup.io,VP Sales,4851,1968,6819
11100,Kennith,Duplock,kduplock5h@weibo.com,Editor,8871,546,9417
11237,Stephana,Bricksey,sbricksey5j@chron.com,Marketing Assistant,1135,859,1994
11485,Chlo,Stirrup,cstirrup5k@cisco.com,Occupational Therapist,4006,727,4733
11718,Knox,Haughey,khaughey5l@lulu.com,Statistician I,8012,1264,9276
11993,Doe,De Benedictis,ddebenedictis5n@moonfruit.com,Nurse,4118,1592,5710
11952,Gwenore,Scad,gscad5o@soundcloud.com,Account Representative III,7054,1109,8163
11128,Meade,Brotherhead,mbrotherhead5q@people.com.cn,Operator,2519,728,3247
11520,Margret,Keedy,mkeedy5r@wikia.com,Software Engineer II,5697,921,6618
11198,Kristien,Lawles,klawles5s@youtu.be,Chemical Engineer,7437,1077,8514
11616,Eva,Griggs,egriggs5t@soup.io,Biostatistician III,4150,456,4606
11185,Humbert,Rosenbusch,hrosenbusch5u@time.com,Analog Circuit Design manager,7980,1631,9611
11698,Basilio,Farebrother,bfarebrother5v@whitehouse.gov,Desktop Support Technician,4501,896,5397
11690,Milka,Hollier,mhollier5w@ameblo.jp,Food Chemist,4827,1016,5843
11914,Cari,Henden,chenden5x@technorati.com,Actuary,8933,1600,10533
11587,Nadya,Durman,ndurman5y@youku.com,Data Coordiator,9837,1430,11267
11508,Nellie,Bracchi,nbracchi5z@hexun.com,Research Associate,9567,463,10030
11793,Antoni,Retallick,aretallick60@tmall.com,Product Engineer,5215,1736,6951
11387,Haily,Gerretsen,hgerretsen61@cdbaby.com,Financial Advisor,4637,1228,5865
11979,Danila,Langeren,dlangeren63@independent.co.uk,Recruiter,5094,1730,6824
11921,Leone,Grewcock,lgrewcock64@purevolume.com,Help Desk Technician,5177,541,5718
11366,Neely,Maykin,nmaykin65@parallels.com,Payment Adjustment Coordinator,1674,1755,3429
11014,Thedric,Dondon,tdondon66@tinyurl.com,Community Outreach Specialist,4026,1895,5921
11024,Feodor,Daddow,fdaddow67@baidu.com,Analyst Programmer,9174,1872,11046
11943,Jdavie,Daykin,jdaykin69@rambler.ru,Editor,9080,208,9288
11122,Brandi,Cuseick,bcuseick6a@nymag.com,Compensation Analyst,6806,1065,7871
11653,Melany,Kern,mkern6b@latimes.com,Software Test Engineer I,2044,1161,3205
11721,Evangelin,Mallam,emallam6c@qq.com,VP Product Management,9222,735,9957
11390,Kinsley,Wheatley,kwheatley6d@gnu.org,Director of Sales,2612,982,3594
11984,Arel,Laban,alaban6e@economist.com,Systems Administrator IV,2558,258,2816
11619,Marielle,Ephson,mephson6f@feedburner.com,Occupational Therapist,2288,1421,3709
11466,Hartwell,Braga,hbraga6g@seesaa.net,Mechanical Systems Engineer,8590,570,9160
11417,Tades,Beesley,tbeesley6h@zimbio.com,Pharmacist,8331,1123,9454
11322,Allie,Gilderoy,agilderoy6i@timesonline.co.uk,Registered Nurse,1007,1063,2070
11829,Kamillah,Wilstead,kwilstead6j@clickbank.net,Human Resources Assistant I,3771,1653,5424
11576,Stacee,Tregona,stregona6k@sfgate.com,Data Coordiator,3710,648,4358
11526,Hadley,Saffle,hsaffle6m@salon.com,Professor,3055,1711,4766
11473,Sidoney,Talbot,stalbot6n@samsung.com,Senior Cost Accountant,1608,1295,2903
11037,Berri,Kausche,bkausche6o@phoca.cz,Clinical Specialist,9927,1309,11236
11183,Abbie,Fulstow,afulstow6p@apache.org,Executive Secretary,8861,665,9526
11832,Loria,Hecks,lhecks6q@eventbrite.com,VP Marketing,9951,728,10679
11945,Adria,Barcke,abarcke6t@geocities.com,Financial Advisor,5934,1141,7075
11909,Rance,Jouhan,rjouhan6u@nsw.gov.au,Research Assistant IV,3790,805,4595
11603,Baillie,Crayker,bcrayker6v@slate.com,Media Manager I,5546,1481,7027
11152,Kathrine,Cluckie,kcluckie6w@dagondesign.com,Staff Accountant II,2418,674,3092
11155,Alejandra,McCuis,amccuis6x@tinypic.com,Staff Accountant I,4480,1888,6368
11435,Babita,Clendennen,bclendennen6y@microsoft.com,Health Coach II,4745,905,5650
11023,Lorry,Saddler,lsaddler6z@youtube.com,Nurse Practicioner,8579,624,9203
11319,King,Corteney,kcorteney70@163.com,Electrical Engineer,3377,601,3978
11736,Christy,Foad,cfoad71@nifty.com,Analog Circuit Design manager,6453,1084,7537
11239,Llewellyn,Tessyman,ltessyman72@yale.edu,Administrative Assistant IV,7705,747,8452
11179,Dannel,Gaitskell,dgaitskell73@etsy.com,Engineer II,4753,670,5423
11276,Frankie,Chasemoore,fchasemoore74@dot.gov,Human Resources Manager,7351,1765,9116
11989,Karol,Grieswood,kgrieswood75@macromedia.com,Information Systems Manager,6233,1659,7892
11682,Fey,Blanque,fblanque76@booking.com,Quality Engineer,7937,861,8798
11646,Alexandra,Kennedy,akennedy77@ow.ly,Senior Developer,7943,1391,9334
11084,Olenolin,Lord,olord78@mozilla.com,Project Manager,8411,1696,10107
11126,Marin,Schellig,mschellig79@usatoday.com,Business Systems Development Analyst,5121,750,5871
11501,Elisha,Curling,ecurling7a@posterous.com,Web Designer I,7226,352,7578
11016,Bartholomew,Worpole,bworpole7b@si.edu,Account Coordinator,9115,1547,10662
11089,Cesaro,Fransseni,cfransseni7c@hexun.com,Assistant Professor,6142,1422,7564
11354,Mireille,Coyish,mcoyish7d@japanpost.jp,Senior Financial Analyst,8286,619,8905
11726,Aimil,Kupker,akupker7f@youtu.be,Senior Financial Analyst,8018,332,8350
11907,Gale,Whitely,gwhitely7g@sciencedaily.com,Tax Accountant,7517,1130,8647
11986,Bendix,Leynton,bleynton7h@google.pl,Technical Writer,9062,1458,10520
11947,Carolee,Anglish,canglish7i@google.com,Accountant I,8745,1279,10024
11369,Riane,Ostick,rostick7k@seattletimes.com,Senior Quality Engineer,8993,1098,10091
11948,Trip,Lorente,tlorente7l@earthlink.net,Occupational Therapist,3685,577,4262
11481,Paulie,Letertre,pletertre7m@businesswire.com,Internal Auditor,5454,929,6383
11199,Niel,Dumingo,ndumingo7o@scientificamerican.com,Pharmacist,3186,1114,4300
11364,Jerrie,Lowell,jlowell7r@moonfruit.com,Nurse Practicioner,6103,1445,7548
11420,Diane-marie,Mucillo,dmucillo7s@redcross.org,VP Sales,9106,1136,10242
11480,Christophe,Foulger,cfoulger7u@usgs.gov,Staff Scientist,7687,302,7989
11194,Fran,Skinn,fskinn7v@theguardian.com,Chief Design Engineer,1731,1699,3430
11636,Dorey,Rickesies,drickesies7w@telegraph.co.uk,Financial Analyst,9330,649,9979
11864,Buddy,Hards,bhards7x@g.co,Senior Quality Engineer,9861,1499,11360
11859,Ambrosius,Tarpey,atarpey7y@seattletimes.com,Sales Associate,9440,1319,10759
11450,Toddy,Rabson,trabson7z@ycombinator.com,Financial Analyst,8290,493,8783
11995,Rustie,Bottell,rbottell80@about.me,VP Quality Control,7965,525,8490
11634,Danica,Bendix,dbendix83@ibm.com,VP Product Management,2646,1609,4255
11467,Phaidra,Wenn,pwenn84@ebay.co.uk,Assistant Manager,2401,1362,3763
11202,Sandi,Dogg,sdogg85@hugedomains.com,Systems Administrator IV,4283,431,4714
11699,Gray,Gemmell,ggemmell86@furl.net,Software Consultant,5151,750,5901
11601,Kimmy,Aloway,kaloway88@mapy.cz,Administrative Officer,3438,1435,4873
11230,Torrin,Marchbank,tmarchbank89@omniture.com,Professor,7804,1668,9472
11773,Shay,Mignot,smignot8a@google.com.br,Actuary,1023,881,1904
11151,Garek,Franek,gfranek8b@webnode.com,Associate Professor,1007,1618,2625
11558,Sandor,McAlarney,smcalarney8e@goo.ne.jp,Financial Analyst,6567,1050,7617
11817,Coretta,Tremollet,ctremollet8f@bizjournals.com,VP Marketing,7878,1462,9340
11511,Remington,Saggs,rsaggs8g@instagram.com,Biostatistician III,1329,1065,2394
11623,Gleda,Creffield,gcreffield8i@foxnews.com,Electrical Engineer,4058,989,5047
11244,Swen,Cicero,scicero8k@usda.gov,Editor,5672,1270,6942
11968,Ethelind,Brumhead,ebrumhead8m@arizona.edu,Systems Administrator IV,6645,1039,7684
11410,Any,Newton,anewton8n@foxnews.com,Environmental Tech,6590,1152,7742
11298,Danice,Mico,dmico8o@twitter.com,Geologist I,5947,1088,7035
11764,Morty,Bierton,mbierton8p@abc.net.au,Editor,3365,625,3990
11281,Erna,Burwell,eburwell8q@oracle.com,Professor,9068,1053,10121
11575,Adolf,McGoon,amcgoon8r@europa.eu,Statistician I,4321,470,4791
11052,Catrina,Mattisssen,cmattisssen8s@com.com,Senior Quality Engineer,8423,696,9119
11567,Rachelle,Witheford,rwitheford8t@addthis.com,Systems Administrator IV,8993,1921,10914
11247,Dennet,Duffus,dduffus8w@dagondesign.com,Engineer II,4900,1563,6463
11621,Hilary,Belmont,hbelmont8x@wp.com,Systems Administrator I,1066,1354,2420
11585,Lemmy,Tynan,ltynan8z@arstechnica.com,Social Worker,4195,876,5071
11081,Flint,Beggs,fbeggs90@salon.com,Developer I,1181,1914,3095
11396,Costanza,Maliffe,cmaliffe94@reference.com,Senior Cost Accountant,3839,860,4699
11727,Dillie,Sclater,dsclater96@altervista.org,Chemical Engineer,1538,782,2320
11025,Moshe,Kevern,mkevern97@plala.or.jp,Paralegal,9497,1520,11017
11277,Jack,Owers,jowers9a@webnode.com,Senior Cost Accountant,7967,1256,9223
11012,Erminia,Dawdary,edawdary9b@dell.com,Data Coordiator,5295,566,5861
11496,Brock,Fauning,bfauning9d@hatena.ne.jp,Senior Editor,1112,234,1346
11992,Margit,Massot,mmassot9e@lulu.com,Account Representative I,6399,1149,7548
11506,Jarib,Breedy,jbreedy9h@cnet.com,Tax Accountant,4478,1510,5988
11195,Netta,Seamark,nseamark9j@wisc.edu,Pharmacist,8332,623,8955
11694,Rhonda,Chartres,rchartres9l@theatlantic.com,Assistant Professor,8122,1640,9762
11882,Fae,Cammack,fcammack9m@naver.com,Physical Therapy Assistant,4572,457,5029
11870,Garnette,Saffen,gsaffen9n@weebly.com,Administrative Officer,2211,1589,3800
11874,Hobart,Worthing,hworthing9o@smugmug.com,Clinical Specialist,9459,726,10185
11478,Lay,Pendlebery,lpendlebery9q@sun.com,Quality Engineer,1174,464,1638
11693,Eulalie,Garfitt,egarfitt9r@yandex.ru,Statistician IV,9983,1235,11218
11361,Tamqrah,Partner,tpartner9s@ed.gov,Environmental Tech,3192,918,4110
11740,Modestine,Birchner,mbirchner9u@yale.edu,Professor,4476,1902,6378
11438,Fancy,Eddowes,feddowes9v@vistaprint.com,Help Desk Operator,1195,1480,2675
11680,Joela,Wilkowski,jwilkowski9w@github.io,Graphic Designer,8443,1648,10091
11314,Daveta,Pittson,dpittson9x@uol.com.br,Financial Advisor,2508,1370,3878
11950,Harlie,Banghe,hbanghe9y@naver.com,Chief Design Engineer,4698,206,4904
11847,Nolly,Fayre,nfayrea0@a8.net,Help Desk Operator,3945,551,4496
11409,Noach,Chettle,nchettlea1@clickbank.net,Nuclear Power Engineer,1841,1880,3721
11053,Laurens,Sexton,lsextona2@berkeley.edu,Electrical Engineer,3523,782,4305
11811,Adan,Blackadder,ablackaddera4@hao123.com,Automation Specialist III,7388,613,8001
11606,Louisa,Bamborough,lbamborougha5@lycos.com,Occupational Therapist,4735,738,5473
11842,Bobbee,Brothwell,bbrothwella6@purevolume.com,Help Desk Technician,1937,543,2480
11186,Astrix,Krier,akrierab@earthlink.net,Civil Engineer,6381,533,6914
11351,Leola,Maher,lmaherac@netlog.com,Structural Analysis Engineer,1751,751,2502
11223,Barton,Rushbrook,brushbrookae@cbc.ca,Assistant Professor,9194,1157,10351
11383,Hurleigh,Vile,hvileaf@ovh.net,Cost Accountant,8441,1649,10090
11189,Ev,Jeakins,ejeakinsai@adobe.com,Account Representative III,4646,908,5554
11193,Nolan,Bater,nbaterak@eventbrite.com,Programmer II,2246,684,2930
11643,Earlie,Langstone,elangstoneam@ucla.edu,Compensation Analyst,3557,1719,5276
11190,Caddric,Burdoun,cburdounan@home.pl,Recruiter,3207,372,3579
11654,Allsun,Dyton,adytonao@illinois.edu,Software Engineer IV,2908,870,3778
11731,Agnesse,Cumber,acumberap@taobao.com,Clinical Specialist,3751,1016,4767
11572,Dyna,Swindlehurst,dswindlehurstar@slate.com,Automation Specialist I,4500,1289,5789
11470,Joice,Albertson,jalbertsonat@admin.ch,Quality Engineer,8087,773,8860
11461,Mamie,Gatenby,mgatenbyau@meetup.com,GIS Technical Architect,7416,423,7839
11297,Elise,Grey,egreyav@nationalgeographic.com,Cost Accountant,6142,556,6698
11094,Cicely,McInnery,cmcinneryaw@meetup.com,Statistician III,4424,1731,6155
11177,Niko,Joskovitch,njoskovitchax@cdbaby.com,Computer Systems Analyst III,6658,497,7155
11971,Liane,Spires,lspiresb0@blogtalkradio.com,Legal Assistant,1037,1679,2716
11934,Edeline,Dymock,edymockb2@ehow.com,Structural Analysis Engineer,4631,575,5206
11493,Pauly,Sutcliff,psutcliffb5@mashable.com,Account Executive,3679,1985,5664
11542,Eirena,Ghelarducci,eghelarduccib6@blogs.com,Compensation Analyst,4270,1836,6106
11315,Yolanda,Cejka,ycejkab8@bloomberg.com,Cost Accountant,5154,1048,6202
11521,Faber,Ledingham,fledinghamb9@rediff.com,Structural Analysis Engineer,6039,1714,7753
11754,Derwin,Scroggins,dscrogginsba@photobucket.com,Financial Analyst,7466,764,8230
11442,Osbert,Matten,omattenbc@yolasite.com,Marketing Assistant,1524,1276,2800
11743,Nathalia,Worshall,nworshallbd@wisc.edu,Technical Writer,6685,1987,8672
11006,Derril,Nolleau,dnolleaube@usda.gov,Teacher,7346,839,8185
11848,Fons,Duckfield,fduckfieldbf@craigslist.org,Registered Nurse,3982,1576,5558
11145,Boniface,Scurrer,bscurrerbg@jalbum.net,Product Engineer,2622,558,3180
11021,Sanford,McCanny,smccannybh@rakuten.co.jp,Senior Editor,7121,1338,8459
11784,Ronald,Arderne,rardernebi@phpbb.com,Recruiter,8160,832,8992
11494,Ivonne,Delafont,idelafontbk@delicious.com,Assistant Media Planner,6523,1137,7660
11454,Donalt,Cleife,dcleifebl@surveymonkey.com,Marketing Assistant,2780,212,2992
11113,Ringo,Crean,rcreanbm@nps.gov,Developer III,4189,1600,5789
11925,Saidee,Toor,stoorbo@addtoany.com,Recruiter,2219,1758,3977
11465,Annis,Stephen,astephenbp@answers.com,Social Worker,3137,583,3720
11011,Etan,Silcox,esilcoxbu@linkedin.com,VP Accounting,5024,719,5743
11437,Joeann,Wealleans,jwealleansbv@cocolog-nifty.com,Programmer I,1627,1846,3473
11406,Gloria,Sautter,gsautterbw@a8.net,Librarian,2160,1366,3526
11064,Nikki,Jahndel,njahndelbx@sakura.ne.jp,Senior Cost Accountant,2852,1803,4655
11232,Kirbee,Dorkins,kdorkinsby@mac.com,Database Administrator IV,1612,1703,3315
11885,Ardella,De Meyer,ademeyerbz@dion.ne.jp,Business Systems Development Analyst,7468,1902,9370
11127,Germana,Pontefract,gpontefractc0@rediff.com,Tax Accountant,5095,1133,6228
11078,Valentina,Overell,voverellc1@spiegel.de,Pharmacist,4892,1748,6640
11584,Anne-marie,Sandey,asandeyc2@google.cn,Senior Quality Engineer,3433,1504,4937
11505,Colin,Lampaert,clampaertc3@wiley.com,Media Manager IV,3821,1500,5321
11961,Toma,Ferrettini,tferrettinic4@accuweather.com,Environmental Specialist,7437,714,8151
11787,Audy,Afonso,aafonsoc5@businessweek.com,Civil Engineer,6101,318,6419
11722,Silvano,Love,slovec6@wikispaces.com,Research Associate,5220,1626,6846
11111,Marilyn,Mogie,mmogiec7@toplist.cz,VP Marketing,3315,1294,4609
11834,Deborah,Rysom,drysomc8@shinystat.com,Editor,4496,1715,6211
11767,Tripp,Hofner,thofnerc9@si.edu,Human Resources Manager,2330,613,2943
11431,Pammy,Iacovini,piacovinica@moonfruit.com,Electrical Engineer,5575,523,6098
11182,Terence,Ruppele,truppelecc@aol.com,Administrative Officer,5800,1988,7788
11144,Freida,Raraty,fraratycd@theglobeandmail.com,Web Developer IV,6609,319,6928
11716,Anatole,Hartmann,ahartmanncf@devhub.com,Paralegal,2474,1602,4076
11540,Olympie,Bourcq,obourcqch@hhs.gov,Cost Accountant,5336,285,5621
11169,Chuck,Lyster,clysterci@ask.com,Marketing Manager,6484,1049,7533
11855,Kimmy,Folk,kfolkcn@craigslist.org,Compensation Analyst,4712,1818,6530
11801,Andy,Fuge,afugecp@unblog.fr,Cost Accountant,2706,833,3539
11096,Ivie,Decayette,idecayettecq@pagesperso-orange.fr,Payment Adjustment Coordinator,2185,1501,3686
11844,Constancia,Stoner,cstonercr@kickstarter.com,Professor,4760,1976,6736
11416,Spense,Pray,spraycs@alibaba.com,Structural Analysis Engineer,1315,672,1987
11411,Alessandra,Feechum,afeechumct@dailymail.co.uk,Structural Engineer,6185,1929,8114
11323,Glendon,Jiruca,gjirucacu@w3.org,Software Engineer III,6504,632,7136
11807,Wynnie,Ferri,wferricv@wikispaces.com,General Manager,9575,1530,11105
11102,Gerhardt,Moneypenny,gmoneypennycy@shop-pro.jp,Programmer II,1186,282,1468
11926,Isadora,Rickeard,irickeardcz@senate.gov,Teacher,1953,1922,3875
11093,Elset,Stoneman,estonemand0@adobe.com,Financial Advisor,6205,1616,7821
11892,Joelle,Dumbell,jdumbelld2@jugem.jp,Cost Accountant,9901,1901,11802
11981,Lianna,Chidlow,lchidlowd3@youku.com,Developer I,8019,1534,9553
11706,Patsy,Tratton,ptrattond8@zimbio.com,Staff Accountant I,5562,1282,6844
11474,Hedy,Blakes,hblakesda@illinois.edu,Biostatistician I,7771,1011,8782
11563,Trever,Ficken,tfickendd@dailymotion.com,Registered Nurse,7481,529,8010
11684,Caesar,O'Loughnan,coloughnande@utexas.edu,Internal Auditor,9224,705,9929
11206,Nissa,Robke,nrobkedl@myspace.com,Tax Accountant,6340,1356,7696
11873,Cassie,Gunderson,cgundersondn@google.pl,Senior Developer,1766,974,2740
11419,Daron,Truggian,dtruggiando@japanpost.jp,Account Executive,1606,665,2271
11555,Deloria,Novak,dnovakdp@hostgator.com,Speech Pathologist,3849,442,4291
11444,Ramona,Caneo,rcaneodq@posterous.com,Graphic Designer,5307,1299,6606
11750,Ed,MacMaster,emacmasterdr@auda.org.au,Nurse Practicioner,7224,900,8124
11825,Scarlet,Pennuzzi,spennuzzidu@linkedin.com,Assistant Professor,1524,1638,3162
11055,Meredeth,Martinolli,mmartinollidv@google.co.uk,Assistant Manager,7154,1698,8852
11367,Kelly,Chandler,kchandlerdz@jugem.jp,Financial Analyst,5371,1244,6615
11261,Vance,Firk,vfirke0@over-blog.com,Electrical Engineer,3762,1338,5100
11304,Andros,Dotson,adotsone4@google.it,Analyst Programmer,5109,282,5391
11160,Cesaro,Jeskin,cjeskine6@booking.com,Structural Analysis Engineer,4826,1715,6541
11668,Hilda,Huge,hhugee8@sina.com.cn,Geologist I,9101,1166,10267
11222,Ashlen,Paulson,apaulsonea@domainmarket.com,Systems Administrator II,4472,833,5305
11820,Drucill,Reeman,dreemanee@webeden.co.uk,Senior Financial Analyst,1232,292,1524
11184,Geri,O'Lunny,golunnyeh@bloomberg.com,Quality Engineer,3695,832,4527
11395,Berna,Veschi,bveschiei@opera.com,VP Marketing,6514,516,7030
11257,Gwendolyn,Bedo,gbedoej@latimes.com,Programmer Analyst II,4731,1442,6173
11163,Sergio,Merrisson,smerrissonek@cornell.edu,Software Consultant,8228,395,8623
11350,Cyndia,Suttill,csuttillen@qq.com,Budget/Accounting Analyst II,6150,1637,7787
11955,Lancelot,Edgin,ledginep@live.com,Structural Analysis Engineer,4168,1332,5500
11720,Harmonia,Fleetwood,hfleetwoodeq@vkontakte.ru,Assistant Professor,9099,1958,11057
11702,Dodi,Lenton,dlentonet@studiopress.com,Compensation Analyst,2753,1956,4709
11027,Kristal,Kennermann,kkennermanneu@economist.com,Product Engineer,3794,746,4540
11602,Dion,Leyland,dleylandex@surveymonkey.com,Nurse Practicioner,5876,331,6207
11446,Rad,Ziems,rziemsey@odnoklassniki.ru,Professor,5599,956,6555
11664,Reggie,Craufurd,rcraufurdez@technorati.com,Research Nurse,3498,1972,5470
11226,Oliy,Harrismith,oharrismithf0@tmall.com,Mechanical Systems Engineer,1556,1897,3453
11338,Rocky,Pree,rpreef1@wiley.com,Assistant Manager,4796,1234,6030
11594,Dominique,Brideaux,dbrideauxf3@telegraph.co.uk,Social Worker,3002,445,3447
11812,Miranda,Clinton,mclintonf5@geocities.com,Help Desk Operator,4867,679,5546
11403,Rad,Balshaw,rbalshawf6@mit.edu,VP Marketing,2280,1718,3998
11772,Alexei,Clemot,aclemotf7@gov.uk,Office Assistant II,6215,1400,7615
11956,Dorthy,Kinsett,dkinsettf8@vinaora.com,Nurse Practicioner,4231,226,4457
11869,Matelda,Tapson,mtapsonf9@amazonaws.com,Registered Nurse,1003,247,1250
11296,Berti,Wiburn,bwiburnfc@latimes.com,Nurse,3567,1465,5032
11796,Noelani,Tuxwell,ntuxwellfd@tumblr.com,Financial Advisor,1374,661,2035
11368,Bernhard,Earney,bearneyfe@unesco.org,Research Associate,7287,1999,9286
11020,Jenn,Jilliss,jjillissff@utexas.edu,Nurse Practicioner,6318,394,6712
11757,Aigneis,Harvie,aharviefg@php.net,Programmer Analyst I,2691,1097,3788
11356,Rafa,Halford,rhalfordfj@nationalgeographic.com,Sales Associate,6961,1382,8343
11325,Justus,Bever,jbeverfk@dot.gov,Sales Associate,9775,1262,11037
11042,Ferdinanda,Downer,fdownerfm@e-recht24.de,Engineer IV,4858,1082,5940
11018,Bondon,Callery,bcalleryfo@miitbeian.gov.cn,Statistician I,6419,1396,7815
11732,Paula,Victory,pvictoryfr@google.com.hk,Nuclear Power Engineer,7652,889,8541
11670,Cicely,Szimon,cszimonfu@cmu.edu,Automation Specialist IV,7460,620,8080
11148,Kamilah,Tamblyn,ktamblynfv@e-recht24.de,Clinical Specialist,1377,1992,3369
11808,Lexy,Punton,lpuntonfy@fc2.com,Senior Cost Accountant,6509,1591,8100
11865,Halie,Baglin,hbaglinfz@stumbleupon.com,Librarian,7542,985,8527
11556,Desdemona,Ramm,drammg0@360.cn,Financial Advisor,6028,1262,7290
11088,Malynda,Casado,mcasadog2@state.tx.us,Safety Technician I,5703,329,6032
11117,Regan,Durrance,rdurranceg4@usgs.gov,Assistant Media Planner,3042,1778,4820
11229,Tymothy,Herculson,therculsong5@netscape.com,Software Engineer IV,7904,273,8177
11201,Gunther,Frazier,gfrazierg7@nydailynews.com,Professor,5947,634,6581
11487,Giustino,Wicher,gwichergb@tamu.edu,Account Representative I,2944,1706,4650
11253,Sheila,Siddele,ssiddelegd@hexun.com,Financial Advisor,3475,842,4317
11452,Mab,Slack,mslackge@yolasite.com,Payment Adjustment Coordinator,8608,619,9227
11236,Doria,Cornier,dcorniergf@soup.io,Staff Accountant II,5644,379,6023
11713,Bartholomeus,Liddicoat,bliddicoatgj@surveymonkey.com,Help Desk Operator,8684,1897,10581
11329,Vernen,Shatford,vshatfordgp@google.ca,Physical Therapy Assistant,4459,734,5193
11976,Ricky,Slayny,rslaynygr@wisc.edu,Assistant Manager,7722,1154,8876
11991,Alfi,Cansdale,acansdalegv@ehow.com,Design Engineer,5838,1650,7488
11051,Nickolas,Gyurko,ngyurkogx@google.de,Office Assistant IV,1167,688,1855
11629,Almeria,Fuente,afuentegy@miitbeian.gov.cn,Programmer Analyst IV,3559,1209,4768
11278,Connor,Blaase,cblaasegz@tripod.com,Systems Administrator II,5393,1553,6946
11492,Kale,Chander,kchanderh0@goo.ne.jp,Marketing Assistant,5486,1147,6633
11213,Modesty,Rubinek,mrubinekh1@state.gov,VP Marketing,6389,268,6657
11334,Corrie,Grunwald,cgrunwaldh5@ehow.com,Civil Engineer,3773,533,4306
11546,Gweneth,Tomich,gtomichh7@arizona.edu,Software Engineer II,3667,958,4625
11759,Romeo,Steiner,rsteinerh9@japanpost.jp,Senior Editor,9024,1935,10959
11515,Petronella,Manilove,pmaniloveha@desdev.cn,Software Consultant,7352,1326,8678
11191,Ferris,Kennagh,fkennaghhf@homestead.com,Marketing Assistant,4680,759,5439
11458,Cullie,Gedney,cgedneyhi@slate.com,Assistant Manager,8956,1053,10009
11321,Merlina,Blundel,mblundelhj@hibu.com,Community Outreach Specialist,8581,1887,10468
11032,Banky,Slee,bsleehl@epa.gov,VP Marketing,9998,1990,11988
11413,Kenn,Perham,kperhamhn@businessweek.com,VP Marketing,8760,1492,10252
11026,Claretta,Bastiman,cbastimanho@seesaa.net,Recruiting Manager,6262,1908,8170
11615,Leon,Law,llawhp@mlb.com,Dental Hygienist,2491,1772,4263
11216,Karil,MacCarter,kmaccarterhq@sourceforge.net,Senior Developer,7399,633,8032
11763,Charisse,Dows,cdowsht@cnn.com,Community Outreach Specialist,8839,1350,10189
11332,Frayda,Feeham,ffeehamhv@tripod.com,Assistant Professor,7057,1552,8609
11815,Bev,Brisco,bbriscohx@google.nl,Payment Adjustment Coordinator,2009,1472,3481
11039,Matthieu,Chesshyre,mchesshyrei1@fastcompany.com,Programmer Analyst II,9279,1847,11126
11781,Waldo,Grimm,wgrimmi2@mozilla.com,Graphic Designer,9704,1567,11271
11739,Lars,Tatton,ltattoni4@umn.edu,Business Systems Development Analyst,1984,1901,3885
11005,Anitra,Cordeiro,acordeiroi5@so-net.ne.jp,Account Executive,8744,1132,9876
11425,Reggie,Bern,rberni6@disqus.com,Accountant III,8651,1974,10625
11613,Marlin,Schrieves,mschrievesi8@twitpic.com,Editor,5380,1637,7017
11003,Kellia,Gricks,kgricksi9@smh.com.au,Marketing Assistant,8506,986,9492
11913,Anette,Flanaghan,aflanaghania@sphinn.com,Environmental Tech,1696,824,2520
11765,Kayle,Fyrth,kfyrthic@google.ca,Structural Analysis Engineer,1630,1552,3182
11617,Eadith,Loody,eloodyid@arstechnica.com,Help Desk Technician,5788,447,6235
11896,Cari,McMylor,cmcmylorie@vk.com,Engineer IV,1133,426,1559
11614,Loree,Odhams,lodhamsig@printfriendly.com,Quality Engineer,9351,1369,10720
11448,Licha,Keppy,lkeppyii@google.com,Account Coordinator,1092,1543,2635
11472,Ardine,Newvell,anewvellil@51.la,Administrative Assistant I,1959,1197,3156
11758,Shandee,Torrie,storrieim@bloomberg.com,Geologist III,9489,473,9962
11530,Shirl,Clayden,sclaydenin@patch.com,Office Assistant IV,3734,1859,5593
11347,Sheri,Klimek,sklimekiq@alexa.com,Engineer I,2707,1868,4575
11346,Gillie,Moscone,gmosconeir@liveinternet.ru,Accountant III,1173,1975,3148
11676,Abran,Upham,auphamis@washington.edu,Biostatistician IV,1642,1896,3538
11010,Eden,Cowp,ecowpiu@lycos.com,Nuclear Power Engineer,6494,542,7036
11577,Whitby,Copley,wcopleyiv@livejournal.com,VP Quality Control,6676,1122,7798
11104,Kaspar,Brandone,kbrandoneix@booking.com,Information Systems Manager,2693,478,3171
11308,Kizzee,Kirrage,kkirrageiy@accuweather.com,Product Engineer,3050,901,3951
11748,Emmalynn,Hawick,ehawickj0@umn.edu,Software Engineer I,9031,1919,10950
11106,Tully,Joll,tjollj1@booking.com,VP Accounting,3867,594,4461
11891,Desmund,Swain,dswainj3@mashable.com,Civil Engineer,6756,1778,8534
11912,Rozele,Corroyer,rcorroyerj4@edublogs.org,Physical Therapy Assistant,9442,571,10013
11559,Janean,Akeherst,jakeherstj7@berkeley.edu,Operator,5386,1150,6536
11783,Georgeanna,Cochrane,gcochranej8@theglobeandmail.com,Project Manager,5962,1759,7721
11266,Vasili,Longwood,vlongwoodj9@guardian.co.uk,Nurse,5550,1459,7009
11949,Clarke,Olerenshaw,colerenshawja@nasa.gov,VP Accounting,2912,422,3334
11953,Haywood,Overton,hovertonjb@shinystat.com,Director of Sales,3998,452,4450
11712,Matty,Gallemore,mgallemorejd@smugmug.com,Analog Circuit Design manager,7923,1108,9031
11915,Danette,Limeburner,dlimeburnerje@wikia.com,Occupational Therapist,7741,376,8117
11642,Jelene,Nickels,jnickelsjf@marriott.com,Business Systems Development Analyst,6801,1730,8531
11541,Loella,Hasel,lhaseljg@goodreads.com,Programmer IV,9421,1849,11270
11433,Lindsay,Jeduch,ljeduchjh@sun.com,Quality Engineer,8461,286,8747
11092,Alameda,Dewi,adewijj@nature.com,Senior Cost Accountant,8815,1436,10251
11500,Walther,Mathan,wmathanjk@gravatar.com,Human Resources Manager,8926,1766,10692
11405,Timothee,Lehenmann,tlehenmannjl@yellowpages.com,Web Designer I,7914,223,8137
11799,Duky,Doncaster,ddoncasterjm@upenn.edu,Administrative Officer,9835,702,10537
11358,Ricoriki,Moreno,rmorenojn@infoseek.co.jp,Environmental Tech,7932,238,8170
11994,Catharine,Goundrill,cgoundrilljp@hubpages.com,Data Coordiator,8313,1027,9340
11681,Odell,Gonsalvez,ogonsalvezjs@sakura.ne.jp,Accountant I,2612,979,3591
11341,June,Zappel,jzappeljt@netlog.com,Chief Design Engineer,8312,1789,10101
11154,Calv,Episcopi,cepiscopiju@fda.gov,Legal Assistant,7813,1159,8972
11060,Ernaline,Jeavon,ejeavonk0@princeton.edu,Analyst Programmer,9270,939,10209
11373,Kelby,Cockle,kcocklek4@bloglovin.com,GIS Technical Architect,4553,1635,6188
11310,Alexis,Bartlosz,abartloszk5@cargocollective.com,Senior Quality Engineer,8998,1084,10082
11245,Jessie,Mazillius,jmazilliusk6@wired.com,Cost Accountant,6287,1453,7740
11353,Curtis,Bridgestock,cbridgestockk8@sfgate.com,Senior Editor,1204,730,1934
11181,Cristionna,Battin,cbattink9@tamu.edu,Recruiting Manager,6240,1200,7440
11895,Beatrisa,Launchbury,blaunchburyka@exblog.jp,Community Outreach Specialist,5335,542,5877
11242,Budd,Sirkett,bsirkettkb@nymag.com,Engineer III,8496,457,8953
11598,Salli,Blincko,sblinckokd@squidoo.com,Budget/Accounting Analyst II,5023,1171,6194
11823,Titus,Flatt,tflattke@imdb.com,Assistant Manager,2463,1189,3652
11647,Kathi,Milkeham,kmilkehamkn@bloglovin.com,Dental Hygienist,4210,1754,5964
11407,Danit,Fosken,dfoskenkv@last.fm,Physical Therapy Assistant,8777,1469,10246
11997,Bab,Das,bdaskx@hexun.com,Teacher,9614,1230,10844
11797,Torrey,Marcham,tmarchamky@desdev.cn,Internal Auditor,9183,1901,11084
11751,Gabriella,Vaneev,gvaneevkz@geocities.com,Staff Scientist,4696,1712,6408
11857,Dur,Burgne,dburgnel4@sina.com.cn,Associate Professor,9631,1094,10725
11274,Odetta,Towler,otowlerl5@unblog.fr,Staff Accountant III,7496,386,7882
11686,Cornie,Thompsett,cthompsettl7@samsung.com,Community Outreach Specialist,1922,529,2451
11286,Silvanus,Arbon,sarbonl8@purevolume.com,Community Outreach Specialist,6777,986,7763
11835,Nikolos,Rossiter,nrossiterl9@columbia.edu,Nurse,6100,748,6848
11550,Gladys,Runsey,grunseyla@google.es,Nurse,3501,1814,5315
11343,Virgie,Eyrl,veyrllh@narod.ru,Registered Nurse,7374,1257,8631
11524,Jessalyn,Croft,jcroftlk@bandcamp.com,Automation Specialist III,7221,1910,9131
11519,Lorne,Blune,lblunelm@360.cn,Systems Administrator II,8664,1242,9906
11695,Elissa,Waslin,ewaslinlo@java.com,Director of Sales,4788,951,5739
11231,Florian,Eymor,feymorlp@ca.gov,Product Engineer,4699,446,5145
11827,Sigismundo,Keeton,skeetonls@arstechnica.com,Clinical Specialist,4893,1965,6858
11564,Cheston,Eate,ceatelt@google.com,Graphic Designer,7285,866,8151
11285,Andra,Imeson,aimesonlu@mozilla.org,Senior Cost Accountant,7527,1872,9399
11288,Christos,Possek,cposseklv@ebay.com,Product Engineer,8446,1008,9454
11156,Jenifer,Scrange,jscrangelw@sourceforge.net,Senior Financial Analyst,1309,1796,3105
11657,Mattheus,Batrick,mbatrickly@ebay.co.uk,Nurse Practicioner,7456,915,8371
11219,Petronilla,Chateau,pchateaulz@census.gov,Marketing Assistant,5801,847,6648
11551,Bax,Lahy,blahym0@netscape.com,Senior Quality Engineer,3672,1375,5047
11582,Minnnie,Belfit,mbelfitm1@un.org,Safety Technician II,3780,501,4281
11453,James,Leyninye,jleyninyem5@oaic.gov.au,Software Engineer IV,2680,1033,3713
11543,Poul,De Cristofalo,pdecristofalom9@comcast.net,Computer Systems Analyst IV,9672,1397,11069
11924,Faythe,Gentile,fgentilemb@chicagotribune.com,General Manager,1001,984,1985
11878,Beret,Coole,bcoolemc@nydailynews.com,VP Accounting,1721,1556,3277
11320,Baldwin,Burkman,bburkmanmd@ucla.edu,Analog Circuit Design manager,6700,436,7136
11412,Tiffani,Tender,ttenderme@hc360.com,Associate Professor,9199,1211,10410
11252,Daisie,Pehrsson,dpehrssonmh@thetimes.co.uk,Chemical Engineer,3868,1244,5112
11447,Sayre,Couronne,scouronnemm@themeforest.net,Structural Analysis Engineer,2769,353,3122
11047,Aimil,Cadigan,acadiganmo@unc.edu,Budget/Accounting Analyst IV,8239,1514,9753
11192,Adena,Yurin,ayurinmp@homestead.com,Executive Secretary,5470,788,6258
11233,Ursuline,Hobson,uhobsonmq@yahoo.co.jp,Nurse,1595,684,2279
11287,Rikki,MacNess,rmacnessmr@comsenz.com,Geologist III,1416,501,1917
11775,Tadd,Brosio,tbrosioms@fc2.com,Developer II,9382,1180,10562
11095,Calhoun,Rupprecht,crupprechtmw@storify.com,Automation Specialist II,9606,1175,10781
11837,Shanon,Pitkin,spitkinn0@twitter.com,Assistant Manager,4891,1542,6433
11029,Travus,Duxbury,tduxburyn2@altervista.org,Data Coordiator,6085,1823,7908
11583,Karee,Paule,kpaulena@blogger.com,Tax Accountant,3291,1378,4669
11475,Dael,Gilby,dgilbynb@mapy.cz,Associate Professor,2786,1579,4365
11622,Kennedy,Rawnsley,krawnsleynf@weibo.com,Help Desk Operator,9483,220,9703
11632,Holli,Tours,htoursni@ifeng.com,Web Developer IV,2895,1207,4102
11258,Nefen,Wassung,nwassungnj@yahoo.com,Administrative Assistant II,1594,1936,3530
11888,Cosette,Monument,cmonumentnk@elpais.com,Software Test Engineer II,3246,295,3541
11744,Jo-ann,Ivanyukov,jivanyukovno@thetimes.co.uk,Financial Advisor,2268,1946,4214
11983,Franciska,Rosetti,frosettins@cocolog-nifty.com,Senior Editor,2058,561,2619
11059,Stevana,MacElroy,smacelroynt@squarespace.com,VP Product Management,8726,362,9088
11778,Bordie,Klug,bklugnu@deliciousdays.com,Project Manager,5056,229,5285
11592,Jon,Flintoffe,jflintoffenv@devhub.com,Professor,7340,1958,9298
11180,Katina,Duligall,kduligallnw@salon.com,Web Designer I,7930,641,8571
11224,Norry,Gurnett,ngurnettnx@tuttocitta.it,Senior Sales Associate,3384,337,3721
11065,Bary,Tithecote,btithecotenz@nbcnews.com,Community Outreach Specialist,1028,1474,2502
11581,Zach,Freda,zfredao0@joomla.org,General Manager,3463,1655,5118
11313,Marcelia,Mulleary,mmullearyo1@nationalgeographic.com,Software Test Engineer I,5808,1497,7305
11769,Deirdre,Sarge,dsargeo2@sciencedaily.com,Software Test Engineer IV,3709,1731,5440
11013,Georgianna,Snarr,gsnarro3@sciencedirect.com,Help Desk Technician,3213,1268,4481
11875,Ron,Sayce,rsayceo6@noaa.gov,Desktop Support Technician,8625,413,9038
11973,Travers,McCumskay,tmccumskayo7@kickstarter.com,Senior Quality Engineer,5918,1624,7542
11753,Zebedee,Goodsall,zgoodsallo8@yandex.ru,Technical Writer,2909,376,3285
11486,Lyn,Erley,lerleyo9@netscape.com,Statistician III,2837,512,3349
11335,Rubia,Sobczak,rsobczakoa@topsy.com,Product Engineer,9725,1975,11700
11588,Eliza,Cutchee,ecutcheeob@deliciousdays.com,Systems Administrator II,4702,1429,6131
11510,Bettine,Formie,bformieof@mlb.com,Biostatistician II,7061,859,7920
11066,Ardelia,Hurche,ahurcheoh@fastcompany.com,Systems Administrator I,1941,528,2469
11911,Tandi,Bream,tbreamop@hostgator.com,Software Test Engineer II,2108,1379,3487
11667,Carroll,Cassey,ccasseyor@census.gov,Quality Control Specialist,9159,792,9951
11365,Mayor,Barkly,mbarklyos@blogs.com,Civil Engineer,8271,1978,10249
11268,Melisande,Itzkov,mitzkovou@mlb.com,Chemical Engineer,4378,282,4660
11143,Kelsey,Aiskovitch,kaiskovitchp1@adobe.com,Desktop Support Technician,7703,1833,9536
11044,Justina,Minchin,jminchinp2@odnoklassniki.ru,Environmental Specialist,1167,1084,2251
11938,Aleta,Josland,ajoslandp6@cornell.edu,Office Assistant I,2191,823,3014
11697,Alex,Janodet,ajanodetp8@earthlink.net,Help Desk Technician,3397,568,3965
11393,Selena,Pfiffer,spfifferpc@businesswire.com,Payment Adjustment Coordinator,8860,660,9520
11965,Emalee,Collins,ecollinspd@oracle.com,Occupational Therapist,8914,1761,10675
11376,Josepha,Capnor,jcapnorpg@mozilla.org,Data Coordiator,5032,1509,6541
11977,Othella,Danelet,odaneletph@amazon.co.uk,Physical Therapy Assistant,3618,1013,4631
11352,Gianna,McKibbin,gmckibbinpj@newsvine.com,Nurse,4646,771,5417
11028,Ilka,Boodell,iboodellpk@wufoo.com,Marketing Assistant,2067,957,3024
11131,Caz,Sciacovelli,csciacovellipm@harvard.edu,Research Assistant IV,1060,1082,2142
11836,Marris,Splevins,msplevinspn@jiathis.com,Administrative Officer,2974,374,3348
11774,Deborah,Tumielli,dtumiellipp@tinypic.com,Mechanical Systems Engineer,7577,726,8303
11798,Molly,Trusse,mtrussepq@clickbank.net,Nurse Practicioner,8479,1892,10371
11590,Sherye,Aulsford,saulsfordpr@cornell.edu,Cost Accountant,4601,1743,6344
11779,Donnell,Shingles,dshinglesps@oracle.com,General Manager,5964,238,6202
11457,Augustin,Rampage,arampagepz@apache.org,Social Worker,7400,524,7924
11894,Shanon,Summerell,ssummerellq0@ning.com,Biostatistician IV,9843,1484,11327
11459,Alick,Pinwell,apinwellq1@meetup.com,Operator,7071,526,7597
11295,Orly,Snoddon,osnoddonq5@mlb.com,Nurse Practicioner,4777,1952,6729
11488,Dyna,Kemet,dkemetq7@rambler.ru,Human Resources Manager,7991,1119,9110
11041,Chrisy,Lingfoot,clingfootq8@thetimes.co.uk,Data Coordiator,9283,1791,11074
11085,Bonny,Van't Hoff,bvanthoffq9@mac.com,Internal Auditor,3190,1502,4692
11818,Sallee,Groger,sgrogerqf@oakley.com,Budget/Accounting Analyst I,6327,755,7082
11389,Tomkin,Gonin,tgoninqg@gov.uk,Community Outreach Specialist,4654,1583,6237
11960,Odie,Connell,oconnellqm@europa.eu,Business Systems Development Analyst,9617,1972,11589
11650,Vivi,Baxstair,vbaxstairqn@tripadvisor.com,Statistician II,1609,994,2603
11742,Bernhard,MacCulloch,bmaccullochqu@discuz.net,Clinical Specialist,1024,1509,2533
11850,Anthea,Marzelle,amarzeller0@irs.gov,Engineer I,4141,1393,5534
11149,Bryna,Daughton,bdaughtonr6@spiegel.de,Professor,8553,780,9333
11547,Guy,Haylor,ghaylorr9@ted.com,Design Engineer,8262,788,9050
11929,Ruthanne,Chastelain,rchastelainra@furl.net,Chief Design Engineer,6648,829,7477
11985,Devi,Gecke,dgeckerc@ow.ly,Nurse,7365,855,8220
11136,Mufi,Lusher,mlusherrd@state.gov,Account Executive,7403,941,8344
11119,Ira,Pogosian,ipogosianre@tmall.com,Computer Systems Analyst IV,9548,1003,10551
11645,Harman,Lafont,hlafontrj@amazon.de,Human Resources Manager,5546,977,6523
11019,Pernell,Stanton,pstantonrl@alexa.com,Geological Engineer,8209,353,8562
11752,Raimund,Cowitz,rcowitzrn@usatoday.com,Statistician III,6856,938,7794
11840,Arlinda,Bellas,abellasrp@sbwire.com,Payment Adjustment Coordinator,7454,1934,9388
11635,Alisander,Bartolijn,abartolijnrr@liveinternet.ru,Research Assistant I,9868,1767,11635
30462,Chaddy,Lassen,classen0@cocolog-nifty.com,Physical Therapy Assistant,7958,1502,9460
30563,Clarine,Denerley,cdenerley1@blogger.com,Senior Developer,9024,816,9840
30312,Christina,Geroldini,cgeroldini2@ca.gov,Occupational Therapist,5476,1252,6728
30449,Royall,Juza,rjuza3@nationalgeographic.com,Editor,5380,1821,7201
30826,Alaster,Bidnall,abidnall4@indiatimes.com,Data Coordiator,3171,1070,4241
30284,Athene,Rock,arock6@dell.com,Cost Accountant,4265,456,4721
30264,Aguistin,Soltan,asoltan7@google.de,Media Manager I,4122,939,5061
30995,Derron,Elsbury,delsbury8@a8.net,Nurse Practicioner,7492,1758,9250
30289,Obed,Androsik,oandrosik9@taobao.com,Senior Cost Accountant,5324,850,6174
30006,Alric,Scraggs,ascraggsa@state.gov,Recruiter,6328,1058,7386
30761,Keefe,But,kbutb@dedecms.com,Technical Writer,7256,759,8015
30348,Poul,Stonuary,pstonuaryc@answers.com,Developer II,9581,1732,11313
30068,Hewet,Grigs,hgrigsd@stumbleupon.com,Tax Accountant,7488,1677,9165
30403,Elfreda,Dormand,edormande@freewebs.com,Web Developer I,3149,549,3698
30304,Theresa,Mains,tmainsf@canalblog.com,Actuary,4181,472,4653
30371,Merrie,Collingworth,mcollingworthg@sina.com.cn,Community Outreach Specialist,4787,1577,6364
30637,Andeee,Martinetto,amartinettoh@sciencedirect.com,Speech Pathologist,2401,1132,3533
30263,Artemas,Kenrat,akenrati@free.fr,Occupational Therapist,5812,616,6428
30696,Harlan,Orchart,horchartj@va.gov,Registered Nurse,1741,1438,3179
30475,Charisse,Mulvin,cmulvink@berkeley.edu,Environmental Tech,8353,1658,10011
30999,Genvieve,Kaye,gkayel@cbsnews.com,Environmental Tech,7028,1971,8999
30901,Violante,Hauch,vhauchm@livejournal.com,Cost Accountant,2787,1948,4735
30367,Claribel,Geldert,cgeldertn@dedecms.com,Human Resources Manager,4259,1314,5573
30581,Ranna,Torrance,rtorranceo@zdnet.com,Nurse,3244,458,3702
30487,Vania,Wasling,vwaslingp@howstuffworks.com,Software Consultant,6509,603,7112
30118,Merralee,Phettis,mphettisq@skyrock.com,Web Designer III,4476,1082,5558
30751,Josiah,Goodbairn,jgoodbairnr@1688.com,Account Coordinator,2032,1559,3591
30817,Edyth,Grumley,egrumleys@army.mil,Account Executive,1122,1789,2911
30744,Correna,Oades,coadest@hao123.com,Senior Editor,4941,1332,6273
30948,Rois,Olivier,rolivieru@cdbaby.com,Civil Engineer,7870,697,8567
30557,Grantham,Lickorish,glickorishv@rambler.ru,Help Desk Operator,4310,1057,5367
30710,Pandora,Drowsfield,pdrowsfieldw@typepad.com,Programmer IV,7884,919,8803
30529,Gretna,Patshull,gpatshullx@indiatimes.com,Sales Representative,3825,782,4607
30682,Matthaeus,Verring,mverringy@nhs.uk,Developer I,2169,1998,4167
30555,Tamiko,Roseman,trosemanz@xrea.com,Media Manager I,8040,663,8703
30883,Gipsy,Tapin,gtapin10@chron.com,Account Coordinator,2610,1781,4391
30219,Yard,O'Kielt,yokielt11@alexa.com,VP Accounting,3357,415,3772
30161,Estevan,Badby,ebadby12@issuu.com,Analog Circuit Design manager,7273,1342,8615
30800,Florry,Bellson,fbellson13@rambler.ru,Food Chemist,9279,1965,11244
30535,Latisha,Parrot,lparrot14@netlog.com,Environmental Specialist,5028,305,5333
30547,Ashton,Murtell,amurtell15@fema.gov,Teacher,4316,323,4639
30221,Aura,Filyukov,afilyukov16@theguardian.com,Financial Analyst,1981,1117,3098
30765,Cherin,MacLese,cmaclese17@livejournal.com,Junior Executive,8230,1608,9838
30737,Romy,Langhor,rlanghor18@techcrunch.com,Nuclear Power Engineer,4983,894,5877
30706,Freedman,Becke,fbecke19@facebook.com,Librarian,2305,1977,4282
30217,Mirilla,Loughlin,mloughlin1a@baidu.com,Quality Engineer,8494,1232,9726
30525,Gerek,Tomaszewski,gtomaszewski1b@blogspot.com,General Manager,1629,517,2146
30649,Silvie,Livock,slivock1c@digg.com,Teacher,5948,969,6917
30700,Stanly,Gartan,sgartan1d@twitter.com,Executive Secretary,9072,1876,10948
30197,Hercules,Luciano,hluciano1e@seesaa.net,Information Systems Manager,1016,1787,2803
30294,Quinn,Scutchings,qscutchings1f@statcounter.com,VP Marketing,3263,888,4151
30111,Haven,Hedan,hhedan1g@dell.com,Help Desk Technician,5961,685,6646
30773,Amberly,Serfati,aserfati1h@merriam-webster.com,Product Engineer,6717,584,7301
30309,Lil,Fitchen,lfitchen1i@ed.gov,Quality Engineer,1580,212,1792
30977,Cherry,Lingfoot,clingfoot1k@opera.com,Senior Editor,5316,458,5774
30978,Roldan,Batty,rbatty1l@netlog.com,Media Manager IV,1848,1049,2897
30695,Yehudit,MacQuarrie,ymacquarrie1m@biglobe.ne.jp,Research Nurse,2728,1159,3887
30052,Doloritas,Flacknell,dflacknell1o@squarespace.com,Computer Systems Analyst I,8698,1747,10445
30323,Alfons,Pople,apople1p@prlog.org,Legal Assistant,1712,367,2079
30849,Abe,Chrismas,achrismas1q@imgur.com,Clinical Specialist,7043,277,7320
30334,Dionisio,Pettie,dpettie1r@plala.or.jp,Quality Control Specialist,8183,839,9022
30545,Gherardo,Dewdeny,gdewdeny1s@newsvine.com,Analog Circuit Design manager,1555,454,2009
30680,Jenna,Jessep,jjessep1u@tinyurl.com,Analyst Programmer,7096,1873,8969
30441,Stevana,Fadian,sfadian1v@yelp.com,Health Coach IV,7534,1622,9156
30627,Camile,Hancox,chancox1w@apple.com,Teacher,2907,379,3286
30372,Ardelis,Kirke,akirke1x@disqus.com,Legal Assistant,8205,1490,9695
30379,Regine,Whitty,rwhitty1y@altervista.org,Pharmacist,8198,1477,9675
30466,Jocelyn,Collinge,jcollinge1z@privacy.gov.au,Nuclear Power Engineer,6336,1911,8247
30614,Genevieve,Doddrell,gdoddrell20@ameblo.jp,Assistant Professor,6545,1808,8353
30713,Sherman,Sherburn,ssherburn21@nytimes.com,Food Chemist,6641,1995,8636
30828,Nicol,Haslum,nhaslum22@salon.com,Senior Editor,6140,1998,8138
30303,Sharl,Ledward,sledward23@jimdo.com,Analog Circuit Design manager,8883,1843,10726
30913,Urson,Rowcastle,urowcastle25@list-manage.com,Computer Systems Analyst III,1542,373,1915
30325,Dyan,Sings,dsings26@zimbio.com,Statistician I,2992,1383,4375
30664,Godiva,Buckby,gbuckby27@ucoz.com,Recruiting Manager,3692,1182,4874
30705,Loren,Vellacott,lvellacott28@blog.com,Help Desk Technician,9959,358,10317
30854,Aidan,Lindback,alindback29@prweb.com,Research Assistant I,2505,761,3266
30154,Sybilla,Balstone,sbalstone2a@examiner.com,Sales Representative,8939,248,9187
30228,Elise,D'Ambrosi,edambrosi2b@hibu.com,Environmental Tech,4506,471,4977
30532,Celie,Enterlein,centerlein2c@angelfire.com,Data Coordiator,1782,1442,3224
30182,Kim,Jachtym,kjachtym2d@si.edu,Senior Developer,4146,1718,5864
30622,Nikolas,Fardon,nfardon2e@disqus.com,Sales Associate,7110,635,7745
30717,Muffin,Yacobsohn,myacobsohn2f@goo.ne.jp,Administrative Assistant III,4898,1833,6731
30151,Maggy,Fisk,mfisk2g@tripod.com,Human Resources Manager,6293,298,6591
30805,Elbertine,Shufflebotham,eshufflebotham2h@census.gov,Design Engineer,5086,1337,6423
30421,Merrie,Skerm,mskerm2i@gravatar.com,Human Resources Manager,6308,1247,7555
30345,Brigida,Maylour,bmaylour2j@sun.com,Account Coordinator,1789,899,2688
30225,Alonzo,Extal,aextal2k@oakley.com,Help Desk Operator,9504,887,10391
30819,Christian,Grouvel,cgrouvel2l@wikia.com,VP Quality Control,6701,1918,8619
30231,Valma,Simecek,vsimecek2n@over-blog.com,Account Representative III,6499,1272,7771
30970,My,Pirson,mpirson2o@gravatar.com,Marketing Manager,2281,875,3156
30912,Fran,Capron,fcapron2p@chronoengine.com,Internal Auditor,5643,710,6353
30291,Tonye,Ormston,tormston2q@foxnews.com,Help Desk Technician,2389,1639,4028
30224,Ellerey,Stretton,estretton2r@livejournal.com,Developer IV,4448,1379,5827
30248,Dedra,Eshelby,deshelby2s@washington.edu,Legal Assistant,5306,267,5573
30200,Lorena,Duthy,lduthy2t@businessweek.com,Senior Financial Analyst,8932,257,9189
30698,Adolf,Trask,atrask2u@tiny.cc,Senior Quality Engineer,2544,1107,3651
30128,Wendel,Hendrichs,whendrichs2v@nih.gov,Human Resources Assistant I,9277,1427,10704
30297,Fayth,Robe,frobe2w@fastcompany.com,Environmental Tech,2099,1291,3390
30082,Daisy,Koschke,dkoschke2x@pen.io,Senior Quality Engineer,3524,1269,4793
30017,Celinka,Tavernor,ctavernor2y@census.gov,Automation Specialist I,1366,529,1895
30198,Royall,Youngman,ryoungman2z@skype.com,Web Developer II,7932,1591,9523
30955,Michal,Pleasance,mpleasance30@admin.ch,Quality Control Specialist,3316,1098,4414
30645,Ferrell,Attenbrough,fattenbrough32@istockphoto.com,Administrative Assistant III,4131,1948,6079
30900,Miles,Sall,msall34@com.com,Associate Professor,5220,304,5524
30832,Darcie,Havik,dhavik35@comcast.net,Business Systems Development Analyst,5489,1991,7480
30865,Dru,Heatly,dheatly36@java.com,Web Designer I,1726,347,2073
30936,Karlotte,McMennum,kmcmennum37@e-recht24.de,Dental Hygienist,1536,796,2332
30943,Vanya,Yearn,vyearn38@slashdot.org,Senior Sales Associate,2655,783,3438
30513,Miriam,Firmager,mfirmager39@umich.edu,VP Accounting,7759,629,8388
30693,Archie,Fomichyov,afomichyov3a@umich.edu,Editor,4647,1879,6526
30137,Johann,Wooller,jwooller3b@patch.com,VP Marketing,4218,1080,5298
30585,Rockey,Hayles,rhayles3d@nymag.com,Electrical Engineer,5456,1344,6800
30100,Even,Yakobovitz,eyakobovitz3e@google.com.hk,Developer I,1601,537,2138
30445,Kiele,Egdal,kegdal3f@mozilla.org,Developer II,5663,1437,7100
30414,Dottie,Martellini,dmartellini3g@prnewswire.com,Chief Design Engineer,6935,1519,8454
30687,Marsiella,Ferrarotti,mferrarotti3h@slideshare.net,Cost Accountant,2559,804,3363
30130,Grace,Bruyet,gbruyet3i@buzzfeed.com,Recruiter,3160,740,3900
30721,Candis,Dobrovsky,cdobrovsky3j@wix.com,Cost Accountant,9333,1325,10658
30515,Randi,Eggins,reggins3k@newyorker.com,Payment Adjustment Coordinator,6274,339,6613
30259,Bartolemo,Deeley,bdeeley3l@hp.com,Biostatistician II,8893,1794,10687
30549,Heinrik,Dunning,hdunning3m@whitehouse.gov,Quality Engineer,8150,766,8916
30859,Blaire,McGowan,bmcgowan3n@eventbrite.com,Automation Specialist III,9242,230,9472
30660,Goraud,Geekin,ggeekin3o@goo.ne.jp,Analog Circuit Design manager,3153,946,4099
30679,Regen,Lowater,rlowater3p@google.com,Senior Developer,1351,1946,3297
30804,Flo,Rossey,frossey3q@goo.ne.jp,Assistant Professor,7099,1787,8886
30720,Lauryn,Shegog,lshegog3r@ftc.gov,Help Desk Technician,1256,1630,2886
30927,Kata,Waite,kwaite3s@ihg.com,Tax Accountant,4115,1562,5677
30514,Arlen,Andrag,aandrag3t@freewebs.com,Actuary,4629,1752,6381
30424,Bancroft,Bilbrooke,bbilbrooke3u@ow.ly,Programmer Analyst IV,5473,714,6187
30063,Netti,Eckh,neckh3v@sogou.com,Health Coach I,9659,763,10422
30056,Donal,Blucher,dblucher3w@prlog.org,Sales Representative,9774,1261,11035
30673,Carmelia,Beslier,cbeslier3x@taobao.com,Senior Cost Accountant,9456,1661,11117
30452,Saleem,Marshal,smarshal3y@house.gov,Senior Quality Engineer,6276,1464,7740
30605,Hildagarde,Kern,hkern3z@studiopress.com,Web Designer IV,9015,582,9597
30262,Malissia,Byart,mbyart40@studiopress.com,Research Assistant II,5832,1278,7110
30957,Risa,Willicott,rwillicott41@goo.gl,Nurse Practicioner,7926,1071,8997
30722,Dominique,Fashion,dfashion42@reddit.com,Systems Administrator I,1537,209,1746
30565,Emanuel,Charville,echarville43@plala.or.jp,Statistician III,5780,1596,7376
30770,Sallyann,Kitteman,skitteman44@reverbnation.com,Recruiter,9389,565,9954
30370,Rina,Favel,rfavel45@mayoclinic.com,Marketing Assistant,2877,1334,4211
30792,Philippine,Coundley,pcoundley46@deliciousdays.com,Computer Systems Analyst II,6605,822,7427
30480,Ladonna,Suttill,lsuttill48@cbc.ca,Recruiting Manager,4619,552,5171
30745,Sonny,McGaugey,smcgaugey49@webmd.com,Sales Associate,7053,908,7961
30648,Teresa,Sjollema,tsjollema4a@scientificamerican.com,Human Resources Assistant II,7534,1505,9039
30098,Ellery,Comins,ecomins4b@csmonitor.com,GIS Technical Architect,6607,1477,8084
30526,Madelene,Yitzhak,myitzhak4c@hubpages.com,Structural Analysis Engineer,1781,911,2692
30703,Herbert,Thurner,hthurner4d@hubpages.com,Engineer IV,8852,305,9157
30374,Nicholle,Helstrom,nhelstrom4e@accuweather.com,Office Assistant I,9175,1282,10457
30725,Dotti,Lathey,dlathey4f@google.ru,GIS Technical Architect,4367,918,5285
30546,Darcey,Greggs,dgreggs4g@adobe.com,Quality Control Specialist,1161,210,1371
30650,Ardeen,Cullingworth,acullingworth4h@ibm.com,Software Consultant,8031,1813,9844
30258,Sibeal,Stayte,sstayte4i@umich.edu,Software Consultant,1523,900,2423
30123,Anson,Von Salzberg,avonsalzberg4j@nih.gov,Accounting Assistant IV,8414,485,8899
30872,Lind,Issett,lissett4k@cam.ac.uk,Operator,1618,512,2130
30183,Burnard,Dawbery,bdawbery4m@360.cn,Financial Analyst,6130,309,6439
30351,Korney,Challin,kchallin4n@sciencedirect.com,Engineer II,7693,1673,9366
30409,Kay,Dalliwater,kdalliwater4o@fema.gov,Senior Financial Analyst,6801,660,7461
30209,Antonella,Elms,aelms4p@mapy.cz,Physical Therapy Assistant,3907,1249,5156
30168,Whitney,Higounet,whigounet4r@cyberchimps.com,Administrative Officer,2332,920,3252
30942,Alejandrina,Mussington,amussington4t@telegraph.co.uk,Food Chemist,5582,949,6531
30328,Kevin,Redfield,kredfield4u@gravatar.com,Administrative Officer,9875,1538,11413
30296,Edsel,Tulloch,etulloch4v@hibu.com,Software Consultant,2776,950,3726
30497,Row,Hanssmann,rhanssmann4w@gravatar.com,Data Coordiator,4168,950,5118
30669,Obed,Treppas,otreppas4x@hatena.ne.jp,Media Manager I,2524,542,3066
30697,Sibylla,Copcott,scopcott4y@cnet.com,Editor,3812,1135,4947
30643,Kimmie,Nafzger,knafzger4z@yolasite.com,VP Sales,7940,1304,9244
30748,Reggi,Colam,rcolam50@g.co,Geological Engineer,1432,439,1871
30237,Von,Winspear,vwinspear51@webeden.co.uk,Clinical Specialist,4228,339,4567
30907,Lukas,Anselm,lanselm52@omniture.com,Recruiting Manager,9554,585,10139
30260,Kaia,Vidyapin,kvidyapin53@squarespace.com,Information Systems Manager,9629,947,10576
30889,Walther,Koppeck,wkoppeck54@loc.gov,Senior Editor,9744,1341,11085
30834,Stephana,Scotts,sscotts56@hostgator.com,Actuary,4295,1321,5616
30271,Carolyne,Osmon,cosmon57@dmoz.org,Teacher,4603,359,4962
30249,Lonnie,Josefovic,ljosefovic58@archive.org,Accounting Assistant III,9117,1429,10546
30685,Verina,Morten,vmorten59@dedecms.com,Community Outreach Specialist,5749,685,6434
30436,Carmela,Rentz,crentz5a@odnoklassniki.ru,Mechanical Systems Engineer,1067,1905,2972
30699,Marian,Marflitt,mmarflitt5b@google.pl,Geologist I,7344,1805,9149
30735,Lincoln,Lernihan,llernihan5c@ibm.com,Director of Sales,8499,1471,9970
30047,Marlin,Candey,mcandey5d@umn.edu,Computer Systems Analyst III,8029,1928,9957
30576,Georgeanne,Holdron,gholdron5e@lulu.com,Librarian,2622,1162,3784
30234,Ede,Dunstall,edunstall5f@studiopress.com,Actuary,7307,783,8090
30240,Whitby,Macey,wmacey5g@cbc.ca,Accountant IV,2563,1423,3986
30495,Bil,Flanders,bflanders5i@cdbaby.com,Director of Sales,1318,1411,2729
30780,Timothee,Alfuso,talfuso5k@aol.com,Internal Auditor,8380,1885,10265
30641,Myriam,Fever,mfever5l@oakley.com,Software Consultant,7181,1431,8612
30282,Gwyneth,Beaby,gbeaby5m@mozilla.org,Executive Secretary,1370,1419,2789
30824,Burk,Le Fevre,blefevre5n@psu.edu,Staff Accountant III,4485,239,4724
30937,Sam,Ownsworth,sownsworth5o@sfgate.com,Occupational Therapist,5555,1667,7222
30028,Amelita,Pickle,apickle5p@themeforest.net,Product Engineer,1089,952,2041
30076,Sapphire,Viant,sviant5r@mashable.com,Statistician IV,8830,998,9828
30318,Alexandre,Shakshaft,ashakshaft5t@feedburner.com,Compensation Analyst,9258,992,10250
30429,Riordan,Pavolillo,rpavolillo5u@icq.com,Nurse Practicioner,9910,1990,11900
30929,Andonis,Tatchell,atatchell5v@springer.com,Social Worker,7219,1088,8307
30096,Mohammed,Pendlebury,mpendlebury5w@xrea.com,Recruiting Manager,9486,393,9879
30863,Emylee,Govini,egovini60@princeton.edu,Senior Cost Accountant,2282,1286,3568
30382,Paolina,Tuff,ptuff61@ucoz.com,Programmer I,7200,951,8151
30084,Mayer,Allaway,mallaway62@epa.gov,Design Engineer,4421,1190,5611
30386,Felicdad,Astbury,fastbury63@studiopress.com,Librarian,7468,763,8231
30062,Tilly,Crop,tcrop64@prweb.com,Programmer Analyst I,2070,1119,3189
30418,Sacha,Olechnowicz,solechnowicz67@twitpic.com,Nuclear Power Engineer,9697,1320,11017
30960,Corby,Whymark,cwhymark68@sbwire.com,Structural Analysis Engineer,4123,1455,5578
30930,Bria,Dalgleish,bdalgleish69@over-blog.com,VP Accounting,4580,559,5139
30126,Cicely,Lindelof,clindelof6b@cpanel.net,Sales Representative,7784,905,8689
30277,Joelly,Milne,jmilne6c@ehow.com,Business Systems Development Analyst,8284,1051,9335
30145,Carver,Uridge,curidge6d@wikipedia.org,Legal Assistant,9578,1298,10876
30453,Foss,Pudden,fpudden6e@gmpg.org,VP Product Management,5963,1981,7944
30906,Barry,Karadzas,bkaradzas6i@soup.io,Senior Developer,9540,1459,10999
30548,Ernst,Baptiste,ebaptiste6j@rakuten.co.jp,Research Associate,7970,377,8347
30615,Sandi,Colmer,scolmer6k@dropbox.com,Staff Scientist,4744,806,5550
30517,Aguie,Faire,afaire6l@prlog.org,Marketing Assistant,5471,1059,6530
30987,Aubrette,Hewkin,ahewkin6m@webeden.co.uk,VP Sales,5957,1329,7286
30947,Eydie,Graveston,egraveston6n@fastcompany.com,Automation Specialist I,8028,312,8340
30932,Garry,Adamthwaite,gadamthwaite6o@un.org,Programmer IV,7447,884,8331
30267,Josee,Kelledy,jkelledy6q@acquirethisname.com,Financial Advisor,1845,1126,2971
30707,Tyrus,Roskruge,troskruge6u@github.io,Account Coordinator,6620,742,7362
30188,Staffard,Antal,santal6v@dailymotion.com,Senior Quality Engineer,4630,731,5361
30189,Cristina,Wards,cwards6w@opera.com,Environmental Specialist,4865,1167,6032
30750,Bonnie,Wincom,bwincom6y@hp.com,Automation Specialist IV,4125,817,4942
30127,Waldo,Fullom,wfullom6z@macromedia.com,Structural Analysis Engineer,7086,1398,8484
30573,Lelia,Ridler,lridler70@japanpost.jp,Senior Developer,7736,1641,9377
30862,Caddric,Battaille,cbattaille71@msu.edu,Nurse,2378,1163,3541
30762,Sherman,Parrett,sparrett72@4shared.com,Account Representative III,7219,1200,8419
30771,Eberhard,Isakson,eisakson73@vinaora.com,Structural Engineer,6836,693,7529
30152,Arlie,Borleace,aborleace75@whitehouse.gov,Clinical Specialist,5160,966,6126
30121,Dorie,Toe,dtoe76@wordpress.org,Speech Pathologist,6020,440,6460
30973,Fowler,Hancill,fhancill78@upenn.edu,Project Manager,4008,422,4430
30574,Jeremiah,Woodington,jwoodington79@gizmodo.com,Clinical Specialist,4929,237,5166
30810,Carmelina,Dukesbury,cdukesbury7a@webs.com,Chemical Engineer,7876,698,8574
30358,Cornie,Scading,cscading7b@abc.net.au,Junior Executive,6709,1668,8377
30946,Janie,Oleszcuk,joleszcuk7c@godaddy.com,Senior Financial Analyst,8732,1646,10378
30008,Tibold,Bremmer,tbremmer7d@123-reg.co.uk,Senior Quality Engineer,2527,579,3106
30199,Deni,Gasperi,dgasperi7e@wp.com,Tax Accountant,3035,1764,4799
30902,Frieda,MacNeill,fmacneill7g@clickbank.net,Speech Pathologist,4212,216,4428
30572,Carrissa,Spittall,cspittall7h@ibm.com,Account Executive,9421,1958,11379
30049,Rob,Barnsdall,rbarnsdall7i@photobucket.com,Help Desk Operator,9321,1234,10555
30272,Anjanette,Emmanuele,aemmanuele7k@skyrock.com,Human Resources Manager,4846,1563,6409
30917,Russ,Hagart,rhagart7l@gmpg.org,Desktop Support Technician,5436,428,5864
30406,Aurore,Teaze,ateaze7m@sbwire.com,General Manager,2405,1589,3994
30178,Dulce,Kinze,dkinze7o@businesswire.com,General Manager,4579,440,5019
30242,Geordie,Hadaway,ghadaway7s@indiatimes.com,Executive Secretary,9987,234,10221
30465,Bertie,Carlisso,bcarlisso7t@ucoz.com,Recruiter,7497,1945,9442
30089,Sebastiano,Worge,sworge7u@github.com,Geologist II,8425,605,9030
30396,John,Siuda,jsiuda7v@chicagotribune.com,Structural Engineer,4963,764,5727
30129,Cirilo,Farland,cfarland7w@ucoz.ru,Junior Executive,4501,1402,5903
30101,Creigh,Conboy,cconboy7x@php.net,Junior Executive,8774,973,9747
30630,Jonis,Haining,jhaining7y@statcounter.com,Office Assistant IV,7949,540,8489
30875,Dalenna,Tinsey,dtinsey80@google.it,Technical Writer,9830,364,10194
30843,Natasha,Scotchmer,nscotchmer83@liveinternet.ru,Help Desk Operator,6763,1687,8450
30195,Zahara,Jeske,zjeske86@technorati.com,Quality Engineer,4961,1820,6781
30985,Jasmina,Dundon,jdundon87@nydailynews.com,Financial Advisor,9857,234,10091
30617,Lorene,Basham,lbasham88@privacy.gov.au,Pharmacist,4426,1123,5549
30600,Tierney,Birkbeck,tbirkbeck89@oakley.com,Structural Engineer,2410,500,2910
30830,Rhetta,Tumulty,rtumulty8b@cocolog-nifty.com,Biostatistician II,7265,362,7627
30979,Diane,Ruf,druf8c@myspace.com,Teacher,2015,1643,3658
30718,Kimberlee,Thorington,kthorington8d@webmd.com,Desktop Support Technician,7737,1346,9083
30246,Giulia,Kitcatt,gkitcatt8e@google.pl,Community Outreach Specialist,8141,1825,9966
30852,Danette,Marty,dmarty8f@wikipedia.org,Geological Engineer,7144,1460,8604
30730,Dolly,Siebart,dsiebart8g@infoseek.co.jp,Senior Developer,8859,436,9295
30283,Elsi,Anscott,eanscott8h@reverbnation.com,Internal Auditor,1837,326,2163
30837,Dot,Twist,dtwist8i@intel.com,Analyst Programmer,6272,509,6781
30236,Trace,Dobsons,tdobsons8j@springer.com,Design Engineer,6699,1428,8127
30890,Scarlett,Vear,svear8k@cargocollective.com,Database Administrator II,8912,1445,10357
30347,Cris,Farbrace,cfarbrace8m@economist.com,Project Manager,9959,825,10784
30160,Waly,Pernell,wpernell8n@live.com,Account Executive,8503,1596,10099
30135,Mariquilla,Bertomieu,mbertomieu8o@dagondesign.com,Structural Engineer,1350,1218,2568
30787,Randall,Pickett,rpickett8p@google.co.jp,Legal Assistant,6100,895,6995
30341,Ludwig,Cases,lcases8r@facebook.com,Information Systems Manager,7036,1498,8534
30380,Winnie,Keeble,wkeeble8t@nasa.gov,Pharmacist,9421,824,10245
30628,Caryl,Trinkwon,ctrinkwon8u@bbc.co.uk,VP Product Management,4180,1742,5922
30739,Ashil,Delafoy,adelafoy8w@amazonaws.com,Senior Developer,7515,391,7906
30338,Kristel,Cantrill,kcantrill8x@businessinsider.com,Safety Technician II,5535,1402,6937
30369,Vonnie,Marikhin,vmarikhin8y@geocities.com,Research Associate,7339,1923,9262
30153,Leslie,Stuehmeier,lstuehmeier8z@cmu.edu,Editor,9519,1339,10858
30833,Nicolle,Fronzek,nfronzek90@cmu.edu,Structural Analysis Engineer,7056,1470,8526
30689,Sauveur,Fairhurst,sfairhurst91@cocolog-nifty.com,Office Assistant IV,6576,1640,8216
30059,Horatia,Sidry,hsidry92@deviantart.com,VP Marketing,7127,616,7743
30510,Binny,Charnick,bcharnick93@shareasale.com,Biostatistician IV,5824,990,6814
30326,Georgy,Wrate,gwrate95@github.com,Help Desk Technician,9536,1437,10973
30931,Lauren,Ondra,londra97@ovh.net,Nuclear Power Engineer,8931,580,9511
30945,Elana,Mix,emix98@gnu.org,Operator,4760,1453,6213
30684,Millisent,Thoms,mthoms99@loc.gov,Environmental Tech,4965,576,5541
30953,Cathi,Burd,cburd9a@howstuffworks.com,Sales Associate,3817,1079,4896
30148,Kimbra,Niaves,kniaves9c@ocn.ne.jp,VP Sales,5753,1624,7377
30011,Sheridan,Dimeloe,sdimeloe9d@cdc.gov,Budget/Accounting Analyst I,4803,1975,6778
30458,Agnese,Mascall,amascall9e@reverbnation.com,Clinical Specialist,8757,1388,10145
30704,Der,Wadman,dwadman9f@sfgate.com,Safety Technician IV,4484,1878,6362
30764,Jany,Mullany,jmullany9g@ebay.co.uk,Nuclear Power Engineer,7300,1289,8589
30265,Jaclyn,Windsor,jwindsor9i@nsw.gov.au,Software Engineer IV,2150,2000,4150
30543,Gonzales,Klimowicz,gklimowicz9j@skyrock.com,Web Designer I,5878,1519,7397
30619,Skipper,Busst,sbusst9m@phoca.cz,Librarian,6586,485,7071
30742,Ethelred,Crisell,ecrisell9o@bandcamp.com,Quality Control Specialist,5068,821,5889
30967,Stan,Sheach,ssheach9s@ucoz.com,Health Coach III,2663,1480,4143
30714,Tomasina,Khotler,tkhotler9t@squidoo.com,Assistant Manager,5479,288,5767
30860,Berkeley,Lumly,blumly9u@privacy.gov.au,Social Worker,1081,1995,3076
30104,Johna,Jaqueminet,jjaqueminet9v@blogspot.com,Web Designer III,1200,1719,2919
30993,Rodolfo,Pallent,rpallent9w@weibo.com,Help Desk Operator,5268,1944,7212
30053,Trev,Davidof,tdavidof9x@hao123.com,Structural Analysis Engineer,3581,1029,4610
30180,Karlie,Birchenough,kbirchenough9y@jugem.jp,Help Desk Technician,5332,595,5927
30974,Wallache,Hampstead,whampstead9z@google.es,Automation Specialist III,9053,1188,10241
30868,Nadean,Beesley,nbeesleya0@zdnet.com,Information Systems Manager,9352,654,10006
30290,Curry,McTaggart,cmctaggarta1@theglobeandmail.com,Web Developer II,3299,722,4021
30851,Edouard,Otter,eottera2@blogs.com,Assistant Media Planner,1894,961,2855
30274,Thurston,Baguley,tbaguleya3@wufoo.com,Registered Nurse,9621,285,9906
30030,Eduard,St. Aubyn,estaubyna4@facebook.com,Paralegal,1184,1201,2385
30194,Chucho,Luckcuck,cluckcucka5@msu.edu,Speech Pathologist,3585,1198,4783
30588,Osbourne,Fache,ofachea7@freewebs.com,Programmer IV,2830,1295,4125
30164,Rivy,Ulyat,rulyata9@phoca.cz,Safety Technician I,7996,1415,9411
30879,Vivyan,Reuven,vreuvenab@google.ca,Director of Sales,7449,468,7917
30165,Debra,Robardey,drobardeyac@yolasite.com,Chief Design Engineer,6638,1849,8487
30820,Arlette,Chestnut,achestnutad@studiopress.com,Product Engineer,5332,1513,6845
30996,Dottie,Gateley,dgateleyae@soup.io,Geologist II,1589,1125,2714
30841,Ritchie,Tresise,rtresiseag@newsvine.com,Help Desk Technician,6927,900,7827
30877,Enrika,Boutcher,eboutcherah@blogtalkradio.com,Programmer Analyst II,4877,1574,6451
30146,Kayla,Chivers,kchiversaj@salon.com,VP Product Management,7707,373,8080
30027,Thacher,Stiell,tstiellak@smh.com.au,Computer Systems Analyst III,4066,779,4845
30476,Daniel,Blackley,dblackleyal@shareasale.com,Desktop Support Technician,6805,1290,8095
30856,Magdalena,Hurcombe,mhurcombeam@fastcompany.com,VP Product Management,7813,1182,8995
30583,Brier,Rimmington,brimmingtonap@latimes.com,VP Sales,4665,573,5238
30018,Thomasa,Kildea,tkildeaaq@deliciousdays.com,Web Designer III,8479,239,8718
30147,Harriet,Salla,hsallaar@amazon.co.jp,Human Resources Manager,8759,1374,10133
30633,Bax,Yates,byatesau@eventbrite.com,Junior Executive,7855,1385,9240
30809,Lilian,Coghlin,lcoghlinav@answers.com,Media Manager IV,9578,746,10324
30005,Rhetta,Kleinholz,rkleinholzaw@google.com,Information Systems Manager,2102,915,3017
30490,Edgard,Weale,ewealeay@amazon.co.uk,Speech Pathologist,8338,624,8962
30233,Trent,Ringer,tringerb1@unesco.org,VP Sales,9415,1397,10812
30734,Junie,Deek,jdeekb2@wordpress.com,Administrative Assistant IV,5626,1655,7281
30656,Blinny,Tellenbach,btellenbachb4@icio.us,Registered Nurse,3526,1305,4831
30287,Jaimie,MacDowal,jmacdowalb5@google.co.uk,Quality Control Specialist,1773,1554,3327
30471,Chen,Garioch,cgariochb6@de.vu,Marketing Assistant,9317,1132,10449
30539,Nady,Durtnal,ndurtnalb8@sciencedirect.com,Payment Adjustment Coordinator,9794,1076,10870
30034,Donovan,Fragino,dfraginob9@go.com,Electrical Engineer,7188,1973,9161
30058,Kelley,Ivanishchev,kivanishchevba@shinystat.com,Pharmacist,7920,1303,9223
30855,Cherilyn,Pinney,cpinneybc@chicagotribune.com,Cost Accountant,5952,216,6168
30531,Horten,Aylen,haylenbd@globo.com,Software Consultant,7198,1284,8482
30881,Ursulina,Tickner,uticknerbf@people.com.cn,Editor,9242,532,9774
30417,Page,Creddon,pcreddonbg@constantcontact.com,Senior Cost Accountant,8321,1246,9567
30039,Dalt,Cicullo,dcicullobi@rediff.com,Help Desk Operator,9674,827,10501
30393,Padraig,Bedow,pbedowbk@wikimedia.org,Accountant I,9518,1030,10548
30302,Dorette,Lark,dlarkbl@t-online.de,Human Resources Assistant II,4086,1449,5535
30964,Willie,Duckers,wduckersbm@ftc.gov,Biostatistician III,3836,414,4250
30344,Monica,Tomkiss,mtomkissbn@java.com,Sales Associate,6282,340,6622
30397,Avie,Jovovic,ajovovicbo@homestead.com,Automation Specialist III,4151,1767,5918
30903,Amaleta,Dudmesh,adudmeshbp@godaddy.com,Structural Engineer,4656,1061,5717
30559,Seamus,Ingle,singlebq@github.io,Paralegal,8007,1708,9715
30618,Gwenette,Gerardi,ggerardibr@ning.com,Analog Circuit Design manager,4046,494,4540
30760,Ara,Gisby,agisbybt@ow.ly,VP Product Management,4796,1090,5886
30950,Nobie,Quiney,nquineybu@unesco.org,Budget/Accounting Analyst III,5647,1018,6665
30647,Kennie,Paddle,kpaddlebw@mozilla.com,Senior Developer,8225,1570,9795
30523,Nealy,Webley,nwebleybx@nps.gov,Social Worker,7984,706,8690
30874,Elaine,Millmoe,emillmoebz@yahoo.co.jp,Speech Pathologist,4314,1501,5815
30305,Justinian,Munby,jmunbyc0@unblog.fr,Legal Assistant,7410,967,8377
30511,Zondra,Agnolo,zagnoloc2@purevolume.com,VP Sales,9132,1139,10271
30921,Liz,Margerison,lmargerisonc6@epa.gov,VP Product Management,7814,1950,9764
30363,Rosco,Jeynes,rjeynesc7@nps.gov,Developer IV,8569,1743,10312
30230,Anne-corinne,Bacchus,abacchusc8@linkedin.com,Research Associate,9417,1988,11405
30733,Ashlen,Culleton,aculletonc9@marriott.com,Statistician IV,4355,780,5135
30477,Emlyn,Garbett,egarbettcb@mozilla.com,Marketing Assistant,5411,1083,6494
30767,Cleon,Linney,clinneycc@hugedomains.com,Electrical Engineer,2219,1002,3221
30681,Frants,Toye,ftoyecd@pagesperso-orange.fr,Help Desk Technician,5103,924,6027
30378,Inigo,Twelftree,itwelftreecg@epa.gov,Automation Specialist II,7238,420,7658
30908,Gaultiero,Carrack,gcarrackcl@people.com.cn,Mechanical Systems Engineer,7920,1042,8962
30691,Dorri,Insole,dinsolecn@google.ru,Technical Writer,8431,1151,9582
30252,Ara,Behrend,abehrendco@umich.edu,Graphic Designer,7584,1227,8811
30442,Bendix,Lambourne,blambournecp@example.com,Structural Analysis Engineer,4563,555,5118
30846,Trisha,Renac,trenaccq@trellian.com,Professor,3481,239,3720
30405,Abel,McCloughlin,amccloughlincr@skype.com,Financial Analyst,4588,896,5484
30797,Cathlene,MacFie,cmacfiect@blog.com,Food Chemist,4321,1188,5509
30350,Anderson,Killner,akillnercu@fc2.com,Senior Developer,5640,1968,7608
30652,Kimble,Feeham,kfeehamcv@yellowbook.com,Occupational Therapist,5084,1182,6266
30106,Leandra,Bebbington,lbebbingtoncw@tripod.com,Assistant Professor,9210,1871,11081
30604,Tonie,Alexandrescu,talexandrescucy@cbsnews.com,VP Quality Control,7475,769,8244
30092,Cecil,Laudham,claudhamcz@google.nl,Automation Specialist I,7768,1001,8769
30783,Floria,Petche,fpetched0@google.ru,Civil Engineer,4897,309,5206
30315,Kelcy,Lubman,klubmand3@indiatimes.com,Office Assistant I,5730,1833,7563
30091,Steffane,Edginton,sedgintond6@wired.com,Dental Hygienist,3314,1606,4920
30896,Man,Elfleet,melfleetd8@pagesperso-orange.fr,Payment Adjustment Coordinator,8670,474,9144
30413,Zsazsa,Petrasek,zpetrasekd9@buzzfeed.com,Mechanical Systems Engineer,6171,1151,7322
30501,Harold,Larmet,hlarmetdb@freewebs.com,Food Chemist,1584,1201,2785
30055,Ellen,Powles,epowlesdc@shareasale.com,VP Sales,1522,1175,2697
30423,Ford,Farquharson,ffarquharsondd@shareasale.com,Senior Financial Analyst,1986,1783,3769
30759,Petrina,Borrell,pborrellde@list-manage.com,Nurse Practicioner,6912,918,7830
30102,Ree,Fern,rferndg@over-blog.com,Account Coordinator,4006,882,4888
30811,Modesty,Reignolds,mreignoldsdi@wordpress.org,Business Systems Development Analyst,8120,274,8394
30708,Christophorus,Eassom,ceassomdk@behance.net,Operator,9848,1865,11713
30544,Rozele,Pinckney,rpinckneydl@europa.eu,Research Assistant III,1337,1545,2882
30332,Stoddard,Yglesias,syglesiasdn@canalblog.com,Technical Writer,7171,997,8168
30456,Garald,Strange,gstrangedo@weibo.com,Junior Executive,9270,1023,10293
30556,Donelle,Portinari,dportinaridq@ow.ly,Senior Cost Accountant,6669,1413,8082
30786,Jose,Keir,jkeirdr@narod.ru,Payment Adjustment Coordinator,6485,469,6954
30042,Alfreda,Castagnet,acastagnetdt@flavors.me,Civil Engineer,9725,1275,11000
30768,Hilda,Denerley,hdenerleydu@vkontakte.ru,Budget/Accounting Analyst III,2143,1005,3148
30196,Ilka,Gino,iginodv@ucla.edu,Marketing Assistant,2216,1373,3589
30077,Kelley,Jaffray,kjaffraydw@engadget.com,Health Coach II,2583,436,3019
30162,Ario,Diemer,adiemerdx@clickbank.net,Analyst Programmer,2797,748,3545
30493,Laney,Lethbury,llethburydy@plala.or.jp,Senior Editor,7223,1796,9019
30212,Winonah,Stenson,wstensondz@wsj.com,Environmental Specialist,7944,638,8582
30205,Carlina,Gyngell,cgyngelle0@bluehost.com,Librarian,4587,1623,6210
30331,Alejandrina,McGaugey,amcgaugeye3@eventbrite.com,VP Quality Control,7313,340,7653
30131,Elli,Lyon,elyone4@skype.com,Recruiter,2977,1737,4714
30245,Alfons,Gile,agilee5@seattletimes.com,Marketing Manager,7650,1474,9124
30709,Amelina,Weare,awearee6@jigsy.com,Research Assistant III,8028,652,8680
30163,Armando,Clemerson,aclemersone7@so-net.ne.jp,Safety Technician III,1631,1822,3453
30715,Jacquette,Ahrendsen,jahrendsenea@fema.gov,Analog Circuit Design manager,9277,347,9624
30534,Teddy,Lideard,tlideardeb@mediafire.com,Product Engineer,8641,325,8966
30506,Heinrik,Tremoille,htremoilleee@pen.io,Librarian,2715,768,3483
30597,Nyssa,Deaville,ndeavilleef@booking.com,Food Chemist,3704,1168,4872
30566,Eddy,Arnecke,earneckeeg@studiopress.com,Junior Executive,5686,1305,6991
30179,Jobina,Husset,jhussetej@indiatimes.com,Administrative Assistant I,5722,1125,6847
30353,Merrielle,Staynes,mstaynesel@fema.gov,Human Resources Manager,5998,563,6561
30324,Karee,Teasdale,kteasdaleem@webeden.co.uk,Teacher,1882,1167,3049
30895,Orelie,Lines,olinesen@example.com,Environmental Tech,7350,1264,8614
30086,Florenza,Ishak,fishakes@ft.com,Senior Editor,2340,825,3165
30220,Isabelle,Bayldon,ibayldoneu@blogspot.com,Senior Cost Accountant,7617,1978,9595
30524,Roderick,Leggen,rleggenev@e-recht24.de,Community Outreach Specialist,1174,458,1632
30124,Christel,Casetta,ccasettaew@accuweather.com,Software Test Engineer II,3984,201,4185
30670,Kerrill,Piken,kpikeney@storify.com,Product Engineer,5106,1730,6836
30558,Ginnie,Fitzroy,gfitzroyez@seattletimes.com,Analog Circuit Design manager,5106,1723,6829
30590,Belicia,Thurlow,bthurlowf0@amazon.co.uk,Actuary,5018,585,5603
30461,Neila,Brinsford,nbrinsfordf3@yahoo.co.jp,Human Resources Manager,5349,369,5718
30756,Sorcha,Conachy,sconachyf4@globo.com,Software Engineer III,8485,1985,10470
30963,Tersina,Artist,tartistf5@dell.com,Executive Secretary,3241,265,3506
30520,Yoshiko,Hallin,yhallinf6@nytimes.com,Operator,8451,1754,10205
30300,Leroi,Connechie,lconnechief7@dmoz.org,Statistician III,2843,1146,3989
30155,Ettore,Dangl,edanglf9@dedecms.com,Technical Writer,5323,459,5782
30939,Zelig,Falshaw,zfalshawfa@delicious.com,Analog Circuit Design manager,1418,1179,2597
30377,Angie,Sproston,asprostonfc@irs.gov,Registered Nurse,8123,941,9064
30954,Jethro,Boulds,jbouldsfe@nyu.edu,Assistant Manager,9136,1100,10236
30254,Emlen,Blay,eblayfg@latimes.com,Sales Representative,5930,1950,7880
30031,Kenna,Jarmain,kjarmainfh@devhub.com,Financial Analyst,7458,830,8288
30087,Lelia,Siddeley,lsiddeleyfi@chron.com,Clinical Specialist,5529,1203,6732
30002,Auberta,Greatrex,agreatrexfj@cbsnews.com,Associate Professor,1018,249,1267
30731,Doralin,Cartledge,dcartledgefk@wisc.edu,Electrical Engineer,7070,438,7508
30308,Andre,Mathes,amathesfl@webmd.com,Information Systems Manager,6910,860,7770
30437,Ash,Tollow,atollowfm@simplemachines.org,Actuary,8303,248,8551
30040,Somerset,Flacke,sflackefo@dailymotion.com,Project Manager,5935,1434,7369
30553,Lynnea,Gerbi,lgerbifp@admin.ch,Chemical Engineer,8605,1151,9756
30255,Egbert,Wotton,ewottonfr@goo.gl,Quality Control Specialist,6741,1674,8415
30014,Celestia,Gue,cguefs@domainmarket.com,Compensation Analyst,5238,1090,6328
30755,Odille,Pawels,opawelsfx@blogtalkradio.com,Cost Accountant,2193,902,3095
30489,Giffer,Ouldcott,gouldcottfy@google.ca,Sales Associate,6814,1100,7914
30173,Odo,Bignal,obignalg1@ucla.edu,Environmental Tech,6543,1203,7746
30389,Franzen,Davidavidovics,fdavidavidovicsg2@comsenz.com,Tax Accountant,8180,1384,9564
30046,Adda,Chansonne,achansonneg5@chronoengine.com,Senior Editor,3897,1307,5204
30211,Caryn,Arrighi,carrighig6@japanpost.jp,Human Resources Manager,6895,568,7463
30866,Juliette,Conan,jconang7@issuu.com,Automation Specialist IV,2638,1810,4448
30075,Pepito,Scrimshaw,pscrimshawga@typepad.com,Sales Associate,2797,1508,4305
30310,Rudiger,Giacomo,rgiacomogb@state.tx.us,Internal Auditor,6229,1339,7568
30663,Danella,Ekell,dekellgc@cdbaby.com,Administrative Officer,9740,1730,11470
30373,Rooney,Munslow,rmunslowgd@oaic.gov.au,Administrative Assistant I,6228,1006,7234
30119,Merry,Beckers,mbeckersgg@meetup.com,Web Designer IV,6656,1698,8354
30861,Terese,Sich,tsichgh@dyndns.org,Environmental Tech,6925,659,7584
30316,Luise,Robertucci,lrobertuccigi@google.nl,Web Designer IV,7070,1401,8471
30801,Heloise,Orsi,horsigj@dailymotion.com,Assistant Media Planner,5265,1937,7202
30508,Doro,Causer,dcausergk@icio.us,Senior Quality Engineer,3359,1399,4758
30799,Phil,Peter,ppetergm@blogtalkradio.com,Executive Secretary,2962,1487,4449
30747,Marijn,Danilov,mdanilovgo@icq.com,Office Assistant IV,2685,1626,4311
30044,Maryjo,Thandi,mthandigp@rambler.ru,Research Associate,2053,1093,3146
30655,Granny,Winskill,gwinskillgq@narod.ru,Chemical Engineer,6835,1957,8792
30041,Julie,Gini,jginigr@gmpg.org,Payment Adjustment Coordinator,9814,1219,11033
30894,Rancell,Cosstick,rcosstickgs@bigcartel.com,Geological Engineer,6790,1610,8400
30777,Raven,Berkely,rberkelygt@cnbc.com,VP Sales,6552,1468,8020
30149,Lilli,Burbidge,lburbidgegw@newyorker.com,Legal Assistant,9164,1686,10850
30384,Antonie,Duerden,aduerdengx@youtu.be,Research Nurse,4653,1251,5904
30171,Karin,Hercules,kherculesgy@omniture.com,Registered Nurse,5567,246,5813
30181,Mahmud,Chowne,mchownegz@weibo.com,Media Manager I,7867,1316,9183
30538,Nerta,Slegg,nsleggh0@bizjournals.com,Recruiting Manager,5127,1832,6959
30891,Goraud,Edelmann,gedelmannh3@paypal.com,Developer III,7659,482,8141
30626,Flossi,Ordidge,fordidgeh4@lycos.com,Data Coordiator,1465,1426,2891
30536,Cam,Di Lucia,cdiluciah7@amazon.de,Research Nurse,7284,1236,8520
30988,Harris,D'Angeli,hdangelih8@webnode.com,Product Engineer,7870,440,8310
30400,Jorrie,Eingerfield,jeingerfieldha@yandex.ru,Office Assistant I,2978,1873,4851
30491,Myrtice,Wartnaby,mwartnabyhd@quantcast.com,Business Systems Development Analyst,6144,549,6693
30920,Vally,Parnell,vparnellhf@wunderground.com,Electrical Engineer,6479,1483,7962
30222,Wylie,MacMurray,wmacmurrayhg@networkadvertising.org,Physical Therapy Assistant,5440,677,6117
30887,Ranee,Bonus,rbonushi@umich.edu,Mechanical Systems Engineer,8950,1717,10667
30024,Danie,Lammas,dlammashj@blog.com,GIS Technical Architect,6072,277,6349
30976,Bailie,Wasmuth,bwasmuthhk@youtube.com,Nuclear Power Engineer,1279,571,1850
30484,Sosanna,Voden,svodenhl@cpanel.net,Research Associate,9444,1249,10693
30886,Valentin,Gerraty,vgerratyhm@newsvine.com,Help Desk Technician,4044,1016,5060
30057,Taffy,Ebbetts,tebbettshn@google.de,Programmer Analyst III,6645,1083,7728
30109,Rheta,Domenichini,rdomenichinihp@princeton.edu,Senior Editor,6998,888,7886
30922,Glenn,Willan,gwillanhq@scribd.com,Recruiter,2341,1213,3554
30571,Warde,Wason,wwasonhs@telegraph.co.uk,Systems Administrator III,2314,1228,3542
30789,Carolyn,Schenfisch,cschenfischhu@prlog.org,Accountant I,7059,864,7923
30093,Guillema,Fleming,gfleminghv@wiley.com,Research Assistant II,2352,1415,3767
30048,Brigid,Cannaway,bcannawayhz@wsj.com,Food Chemist,7070,1798,8868
30060,Adolphe,Simounet,asimouneti3@webmd.com,Nurse Practicioner,9727,629,10356
30319,Myrah,Mattielli,mmattiellii7@smugmug.com,Senior Sales Associate,6028,448,6476
30736,Victor,Akroyd,vakroydia@usnews.com,GIS Technical Architect,6380,1732,8112
30404,Abbey,Fulham,afulhamie@reddit.com,Quality Control Specialist,4650,1011,5661
30298,Derrek,Connick,dconnickif@1688.com,Systems Administrator IV,3109,1296,4405
30207,Charity,McGann,cmcgannig@uiuc.edu,Design Engineer,3083,1545,4628
30158,Tildy,Sporgeon,tsporgeonih@booking.com,Assistant Media Planner,2702,1856,4558
30867,Karola,Cabral,kcabralij@ycombinator.com,Civil Engineer,2059,1788,3847
30440,Barbaraanne,Goudge,bgoudgeik@etsy.com,Data Coordiator,2948,889,3837
30094,Lauri,Collabine,lcollabineil@pinterest.com,VP Marketing,6980,431,7411
30847,Rhona,Hyman,rhymanim@booking.com,Chief Design Engineer,6739,1505,8244
30301,Jacinta,Sutch,jsutchip@msn.com,Structural Analysis Engineer,8169,1164,9333
30050,Patricio,Beert,pbeertiq@youtu.be,Human Resources Manager,6312,1090,7402
30893,Jeffrey,Benasik,jbenasikis@sakura.ne.jp,Payment Adjustment Coordinator,1372,1895,3267
30401,Demott,McCormick,dmccormickix@goo.gl,Financial Advisor,9562,689,10251
30635,Brandie,Mardee,bmardeeiz@nbcnews.com,Programmer I,4894,1507,6401
30114,Renaldo,Dami,rdamij0@drupal.org,Assistant Manager,1323,1081,2404
30376,Debora,Enoksson,denokssonj3@google.de,General Manager,1111,421,1532
30933,Gabbie,Goncaves,ggoncavesj8@hatena.ne.jp,Human Resources Manager,6227,371,6598
30858,Gilly,Battlestone,gbattlestoneja@uiuc.edu,Structural Analysis Engineer,3469,1087,4556
30871,Lucius,Trude,ltrudejc@devhub.com,Civil Engineer,3546,1194,4740
30402,Leanna,Matysiak,lmatysiakje@issuu.com,Associate Professor,6198,1586,7784
30864,Hyacinthe,Sooley,hsooleyjf@google.de,Operator,1043,1083,2126
30336,Harlie,Callen,hcallenjg@mediafire.com,Environmental Specialist,6496,1353,7849
30288,Edmund,MacPharlain,emacpharlainji@acquirethisname.com,Accounting Assistant III,3595,1560,5155
30395,Patricio,Maggs,pmaggsjk@canalblog.com,Senior Developer,4769,1512,6281
30919,Gallagher,Cornhill,gcornhilljl@about.com,Product Engineer,1448,643,2091
30138,Tammie,Ferns,tfernsjm@amazon.co.jp,General Manager,8231,921,9152
30090,Zonda,Schwartz,zschwartzjn@tripod.com,VP Product Management,1684,224,1908
30343,Hana,Mattityahou,hmattityahoujo@wikipedia.org,Help Desk Technician,6252,320,6572
30944,Kimberly,Ahrenius,kahreniusjp@ihg.com,Tax Accountant,5655,1803,7458
30869,Klaus,Yurocjhin,kyurocjhinjs@webmd.com,Senior Editor,2184,592,2776
30518,Dara,Genty,dgentyjt@simplemachines.org,Research Associate,9912,276,10188
30594,Benton,Wallenger,bwallengerjy@quantcast.com,Community Outreach Specialist,6248,475,6723
30467,Abbie,Valentinuzzi,avalentinuzzijz@ifeng.com,Senior Developer,4206,326,4532
30909,Joane,Gosby,jgosbyk0@cbc.ca,Environmental Tech,4419,1061,5480
30621,Eddy,Maskell,emaskellk3@examiner.com,Dental Hygienist,3827,1475,5302
30567,Dian,Salomon,dsalomonk4@constantcontact.com,Nurse,6040,506,6546
30503,Lamond,Trewman,ltrewmank5@mlb.com,Payment Adjustment Coordinator,6315,1680,7995
30766,Missy,Posvner,mposvnerka@statcounter.com,Human Resources Manager,3805,1012,4817
30853,Boonie,Weekland,bweeklandkd@1688.com,Computer Systems Analyst II,9652,769,10421
30701,Bernadine,Mintoft,bmintoftke@diigo.com,Office Assistant IV,9290,606,9896
30672,Irina,Charters,icharterskg@spiegel.de,Associate Professor,2301,1563,3864
30321,Marie-jeanne,Winchester,mwinchesterkj@ovh.net,Nurse,4674,1505,6179
30176,Broddie,Mitchelson,bmitchelsonkk@bizjournals.com,Electrical Engineer,2890,1514,4404
30375,Fitzgerald,Stych,fstychkm@topsy.com,Nurse Practicioner,8605,1177,9782
30457,Luisa,O'Lunny,lolunnykr@bluehost.com,Geological Engineer,3852,646,4498
30560,Agna,Bissatt,abissattks@ocn.ne.jp,Data Coordiator,7219,1835,9054
30839,Babette,Tzarkov,btzarkovku@house.gov,Sales Representative,2246,258,2504
30935,Gallard,Flacke,gflackel1@about.com,Web Developer III,4292,587,4879
30729,Deva,Ryhorovich,dryhorovichl2@networksolutions.com,Community Outreach Specialist,9250,473,9723
30562,Connie,Skyme,cskymel6@nyu.edu,Senior Cost Accountant,5741,1005,6746
30066,Arty,Ruppelin,aruppelinl8@istockphoto.com,Financial Advisor,4033,257,4290
30688,Calley,Derye-Barrett,cderyebarrettle@theatlantic.com,Marketing Manager,3308,1767,5075
30428,Stearne,Bediss,sbedisslg@pbs.org,Recruiting Manager,3601,1814,5415
30443,Dinny,Heyworth,dheyworthli@gov.uk,Product Engineer,7231,1996,9227
30646,Audre,Ilyas,ailyaslk@biblegateway.com,Quality Control Specialist,9922,343,10265
30279,Shena,Cordier,scordierln@vk.com,Sales Associate,2430,1402,3832
30537,Elvis,Ensten,eenstenlp@linkedin.com,Analyst Programmer,5062,663,5725
30857,Bobbie,Liven,blivenlr@kickstarter.com,Sales Associate,7738,1252,8990
30337,Fabian,Vasilik,fvasilikls@cloudflare.com,Web Designer II,7809,585,8394
30904,Ferris,Warham,fwarhamlu@geocities.jp,Engineer I,8475,288,8763
30072,Mellicent,Batchelour,mbatchelourlz@zimbio.com,Software Test Engineer IV,7669,307,7976
30980,Samaria,Axtens,saxtensm0@indiegogo.com,Analyst Programmer,1734,1385,3119
30915,Barton,Jakoviljevic,bjakoviljevicm2@virginia.edu,Office Assistant IV,6730,1301,8031
30140,Ly,Passingham,lpassinghamm3@apache.org,Environmental Specialist,8972,1758,10730
30923,Jaymee,Nezey,jnezeym4@businesswire.com,Account Coordinator,1516,218,1734
30479,Shela,Thorrold,sthorroldm5@weather.com,Assistant Professor,2419,1138,3557
30686,Rae,MacGillivrie,rmacgillivriem6@google.it,Nurse,1182,202,1384
30632,Ailey,Leed,aleedm8@acquirethisname.com,Community Outreach Specialist,2842,627,3469
30552,Norry,Stuehmeyer,nstuehmeyermf@pen.io,Database Administrator IV,9410,363,9773
30758,Fredric,Adran,fadranmg@sfgate.com,Cost Accountant,5304,1126,6430
30032,Dorella,Lilion,dlilionmo@reuters.com,Senior Cost Accountant,6086,1999,8085
30668,Sterne,Heinert,sheinertmp@arizona.edu,Marketing Assistant,5217,725,5942
30419,Judon,Tolman,jtolmanms@sina.com.cn,Assistant Media Planner,7095,1291,8386
30156,Shirlee,Freeth,sfreethmt@hubpages.com,Associate Professor,3367,1249,4616
30177,Estevan,Larmor,elarmormu@fastcompany.com,Paralegal,2643,619,3262
30778,Brinna,Drepp,bdreppmv@ow.ly,Safety Technician I,3605,1506,5111
30774,Rudiger,Darrigrand,rdarrigrandmz@washingtonpost.com,Electrical Engineer,4848,1466,6314
30870,Gabbey,Dunge,gdungen0@biblegateway.com,Pharmacist,2560,1383,3943
30636,Ettie,Korneluk,ekornelukn1@bandcamp.com,Product Engineer,5246,652,5898
30542,Betti,Chaffin,bchaffinn3@mashable.com,Human Resources Assistant IV,8407,1386,9793
30141,Forbes,Damiata,fdamiatan8@earthlink.net,Developer IV,9589,535,10124
30516,Den,Knightley,dknightleyn9@nbcnews.com,Project Manager,4512,1598,6110
30232,Ariella,Vickress,avickressna@wikimedia.org,Nurse,8399,629,9028
30112,Priscilla,Divisek,pdiviseknb@aboutads.info,Physical Therapy Assistant,3938,1698,5636
30678,Mattie,Rubinsztein,mrubinszteinnc@ibm.com,Product Engineer,4482,1879,6361
30570,Elisabeth,Juarez,ejuarezne@51.la,Recruiting Manager,1568,1676,3244
30115,Berty,Guidetti,bguidettinj@webs.com,Actuary,7965,1541,9506
30897,Sheelagh,Sinden,ssindennk@privacy.gov.au,Senior Developer,7398,1540,8938
30412,Vince,Gerhardt,vgerhardtno@dyndns.org,Geologist IV,7243,1850,9093
30410,Rayner,Polini,rpolininp@usda.gov,Senior Quality Engineer,8998,1854,10852
30432,May,Saulter,msaulternq@prweb.com,Data Coordiator,9543,1317,10860
30434,Jammal,Gregh,jgreghns@bigcartel.com,Office Assistant I,6688,567,7255
30238,Dani,Cockerell,dcockerellnt@ihg.com,Junior Executive,8627,302,8929
30460,Michel,Andrei,mandreinv@nps.gov,Staff Accountant I,2155,982,3137
30170,Amil,Gratton,agrattonny@indiegogo.com,Financial Analyst,6867,983,7850
30346,Tom,Argont,targonto0@omniture.com,Social Worker,7896,410,8306
30340,Lalo,Waddoups,lwaddoupso3@dion.ne.jp,Business Systems Development Analyst,3170,1357,4527
30961,Clarice,Northall,cnorthallo4@artisteer.com,Operator,9652,722,10374
30983,Rutter,Caskey,rcaskeyo5@hexun.com,Structural Engineer,5371,221,5592
30500,Rudy,Algie,ralgieo6@scientificamerican.com,Senior Cost Accountant,5840,1965,7805
30081,Jenilee,McCusker,jmccuskero8@sciencedaily.com,Electrical Engineer,7450,1844,9294
30190,Jennine,Muneely,jmuneelyo9@addthis.com,Statistician III,5356,1246,6602
30172,Giorgio,Dowty,gdowtyoa@ucoz.com,Help Desk Technician,2311,1645,3956
30598,Adriaens,Stanaway,astanawayod@tinypic.com,Engineer II,2895,1751,4646
30239,Stanford,Ingleton,singletonoe@microsoft.com,Database Administrator IV,7069,704,7773
30088,Katherina,Bitcheno,kbitchenoof@xrea.com,Food Chemist,4494,886,5380
30683,Livvy,Shilladay,lshilladayoh@theatlantic.com,Budget/Accounting Analyst II,9412,1195,10607
30642,Ondrea,Tabor,otaboroj@google.com.br,Engineer II,8449,1137,9586
30108,Deidre,Habergham,dhaberghamol@jiathis.com,Software Engineer IV,4640,1864,6504
30611,Vernor,Earthfield,vearthfieldon@tinyurl.com,Help Desk Technician,8624,649,9273
30949,Ellen,Beneteau,ebeneteauoq@berkeley.edu,Compensation Analyst,9751,1216,10967
30381,Alexi,Eustice,aeusticeot@dyndns.org,Environmental Specialist,7666,1958,9624
30362,Mendy,Halewood,mhalewoodoy@weather.com,Account Coordinator,6205,1612,7817
30020,Shirleen,Brotherhood,sbrotherhoodp1@sfgate.com,VP Quality Control,9423,313,9736
30612,Joe,Brownill,jbrownillp6@google.com,Graphic Designer,8057,1899,9956
30295,Rosalinda,Weson,rwesonp7@smugmug.com,Community Outreach Specialist,7376,1721,9097
30981,Emmalee,Durker,edurkerp8@edublogs.org,Information Systems Manager,5196,1322,6518
30174,Ardelia,Estable,aestablep9@cocolog-nifty.com,Computer Systems Analyst III,2614,1024,3638
30026,Lyndsay,Cumber,lcumberpb@rediff.com,Internal Auditor,1480,677,2157
30607,Brenn,Verdey,bverdeypg@github.io,Accountant IV,3963,1045,5008
30085,Jeffie,Lestor,jlestorph@amazon.co.uk,Programmer Analyst II,4084,960,5044
30439,Michele,Humbie,mhumbiepj@va.gov,Speech Pathologist,8175,1198,9373
30142,Eddi,Surmon,esurmonpl@techcrunch.com,Administrative Assistant IV,4164,459,4623
30779,Levin,Pauletti,lpaulettipt@about.com,Design Engineer,3478,1397,4875
30478,Gaspar,Sabban,gsabbanpw@parallels.com,Sales Representative,3843,1843,5686
30530,Adelice,Sowood,asowoodpy@github.io,Marketing Manager,8123,1783,9906
30352,Bondy,Suter,bsuterq9@t.co,Occupational Therapist,9153,1917,11070
30078,Tommie,Hugh,thughqb@utexas.edu,Food Chemist,6891,1946,8837
30793,Dayna,Ripon,driponqd@livejournal.com,Quality Engineer,4296,1006,5302
30416,Hewett,Robey,hrobeyqg@miitbeian.gov.cn,VP Quality Control,5959,221,6180
30069,Dale,Holliar,dholliarqq@usa.gov,Accounting Assistant IV,8262,1508,9770
30938,Christophe,Keld,ckeldqt@archive.org,Office Assistant II,9390,1154,10544
30639,Mil,Strange,mstrangequ@businessweek.com,Automation Specialist III,4260,954,5214
30840,Constantine,Ahrens,cahrensr0@moonfruit.com,Media Manager I,6483,1465,7948
30968,Giffy,Reina,greinar7@mail.ru,Nurse,5804,1277,7081
30448,Meg,Semon,msemonr8@biglobe.ne.jp,Computer Systems Analyst II,7774,346,8120
30492,Shandra,Jervis,sjervisrd@de.vu,Senior Cost Accountant,8740,1381,10121
30749,Kai,Fallowes,kfallowesre@usa.gov,Nurse Practicioner,2252,1571,3823
30361,Saleem,Siddele,ssiddelerj@pen.io,Administrative Officer,6283,365,6648
30431,L;urette,Clapson,lclapsonrk@wikimedia.org,Web Designer IV,5458,1422,6880
30975,Alair,Tottie,atottierp@moonfruit.com,Occupational Therapist,5706,645,6351
31200,Ricoriki,Minshall,rminshall0@si.edu,Teacher,3665,1471,5136
31256,Jaquenette,Whaley,jwhaley1@purevolume.com,Health Coach III,3652,609,4261
31540,Finley,O' Hanvey,fohanvey2@youtube.com,Legal Assistant,6947,1343,8290
31505,Shannah,Dunseath,sdunseath3@360.cn,Dental Hygienist,5479,1779,7258
31053,Norrie,Pountain,npountain4@techcrunch.com,Director of Sales,7557,1848,9405
31367,Basilius,Miguet,bmiguet5@example.com,Quality Control Specialist,8073,969,9042
31698,Peder,Stiller,pstiller6@earthlink.net,Chief Design Engineer,5080,833,5913
31352,Pierson,Rzehor,przehor7@bigcartel.com,Staff Accountant II,2303,1169,3472
31692,Amerigo,Liddiatt,aliddiatt8@miitbeian.gov.cn,Registered Nurse,4908,258,5166
31741,Oren,Wilkin,owilkin9@ed.gov,Account Executive,4080,1761,5841
31056,Ericha,Zellick,ezellicka@moonfruit.com,Food Chemist,8971,637,9608
31176,Fabe,Almak,falmakb@google.it,Food Chemist,2562,256,2818
31482,Renaud,Cockshott,rcockshottc@columbia.edu,Desktop Support Technician,5571,1828,7399
31986,Farleigh,Daleman,fdalemand@printfriendly.com,Software Engineer I,4148,1422,5570
31807,Mame,Teaze,mteazee@devhub.com,Senior Developer,2377,640,3017
31659,Byram,Truitt,btruittf@umn.edu,Nurse,8178,358,8536
31431,Clarie,Mardell,cmardellg@canalblog.com,VP Sales,1485,1009,2494
31036,Koenraad,Kilrow,kkilrowh@bloglines.com,Operator,5839,1987,7826
31228,Betsy,Bernth,bbernthi@technorati.com,Developer III,8268,1702,9970
31292,Nichols,Guise,nguisej@live.com,Civil Engineer,1825,1790,3615
31013,Susann,Abbys,sabbysk@japanpost.jp,Desktop Support Technician,4949,1185,6134
31294,Kessiah,Chieco,kchiecol@wikimedia.org,Nuclear Power Engineer,5826,390,6216
31571,Alexandre,Chicken,achickenm@wisc.edu,VP Quality Control,2354,1257,3611
31471,Neill,Kitteman,nkittemann@cnet.com,Sales Associate,7590,1723,9313
31535,Fanni,Gallemore,fgallemoreo@com.com,Associate Professor,9709,1849,11558
31031,Deanne,Vedekhov,dvedekhovp@jimdo.com,Research Assistant III,8205,433,8638
31321,Nevile,Grestye,ngrestyeq@google.cn,Junior Executive,7262,949,8211
31848,Jana,Grimley,jgrimleyr@prweb.com,Sales Associate,5211,1345,6556
31473,Wilmer,Sallinger,wsallingers@bigcartel.com,Environmental Specialist,1671,550,2221
31553,Buiron,Kirsz,bkirszt@hud.gov,Engineer IV,5944,1605,7549
31503,Ash,Trousdale,atrousdaleu@odnoklassniki.ru,Environmental Specialist,8407,1129,9536
31991,Lucila,Tebbe,ltebbev@blogtalkradio.com,Staff Scientist,5861,316,6177
31018,Gnni,Scripps,gscrippsw@stumbleupon.com,Sales Representative,1067,1926,2993
31132,Dominique,Fotherby,dfotherbyx@geocities.com,Marketing Assistant,9537,1721,11258
31143,Irena,Guilloton,iguillotony@tmall.com,VP Marketing,7883,381,8264
31854,Alon,Bangiard,abangiardz@skyrock.com,Project Manager,1648,1764,3412
31380,Kirstyn,Scimone,kscimone10@360.cn,Occupational Therapist,1106,1287,2393
31037,Shara,Burrill,sburrill11@si.edu,Design Engineer,8625,947,9572
31222,Bettina,Edscer,bedscer12@shinystat.com,Web Developer IV,8792,401,9193
31859,Osgood,Carney,ocarney13@tripod.com,Compensation Analyst,4172,813,4985
31452,Sheela,Gorvin,sgorvin14@vistaprint.com,Biostatistician III,6294,728,7022
31235,Mavra,Jannequin,mjannequin15@vkontakte.ru,Sales Associate,4541,507,5048
31844,Hadria,Chipps,hchipps16@nba.com,Design Engineer,9542,841,10383
31871,Mayer,Woolveridge,mwoolveridge17@360.cn,Pharmacist,3662,1897,5559
31135,Patrizia,Chesley,pchesley18@tripadvisor.com,Senior Financial Analyst,3427,1503,4930
31810,Dawn,Skeath,dskeath19@amazonaws.com,Paralegal,3824,1979,5803
31510,Junina,Such,jsuch1a@springer.com,Safety Technician IV,1363,1203,2566
31309,Tabb,Kilroy,tkilroy1b@bluehost.com,Physical Therapy Assistant,7298,801,8099
31806,Tove,Battams,tbattams1c@wired.com,Junior Executive,6182,1815,7997
31600,Demetri,Gurden,dgurden1d@uiuc.edu,Staff Accountant II,9416,1834,11250
31070,Ray,Yepiskov,ryepiskov1e@rambler.ru,Teacher,5665,1031,6696
31705,Lewiss,Alston,lalston1f@comcast.net,Data Coordiator,4559,202,4761
31035,Marquita,Corcut,mcorcut1g@nbcnews.com,VP Product Management,5606,288,5894
31855,Doug,Cossell,dcossell1h@sciencedirect.com,Nuclear Power Engineer,3934,1922,5856
31523,Northrop,Medhurst,nmedhurst1i@google.ca,Operator,1599,948,2547
31481,Hatti,Schoales,hschoales1j@hud.gov,Project Manager,4085,1804,5889
31908,Udall,Baggaley,ubaggaley1k@webs.com,Pharmacist,7811,981,8792
31079,Jaime,McFeate,jmcfeate1l@nps.gov,General Manager,9748,337,10085
31883,Nero,Rolland,nrolland1n@xing.com,Environmental Tech,7584,1070,8654
31977,Donica,Pattesall,dpattesall1o@stumbleupon.com,Internal Auditor,5862,438,6300
31555,Marice,Gyngyll,mgyngyll1q@t-online.de,Human Resources Manager,5111,1351,6462
31655,Hally,Bines,hbines1r@umich.edu,Help Desk Technician,2697,875,3572
31967,Sigvard,Naire,snaire1s@xing.com,Senior Editor,7917,1654,9571
31329,Yanaton,Serridge,yserridge1t@1688.com,Product Engineer,4950,520,5470
31262,Griswold,Habbijam,ghabbijam1u@bbc.co.uk,Human Resources Assistant IV,7424,839,8263
31786,Alyce,Atkins,aatkins1v@360.cn,Actuary,3554,997,4551
31229,Nelia,Agar,nagar1w@cocolog-nifty.com,Programmer III,3195,1320,4515
31049,Joana,Millberg,jmillberg1y@paypal.com,Electrical Engineer,5731,1666,7397
31832,Francesca,Bourton,fbourton1z@skyrock.com,GIS Technical Architect,5520,1692,7212
31763,Audry,Brackpool,abrackpool20@diigo.com,Accountant IV,8785,830,9615
31429,Barbabas,Zecchinelli,bzecchinelli21@purevolume.com,Librarian,4649,848,5497
31767,Freddy,MacFadzan,fmacfadzan22@forbes.com,Office Assistant III,1728,1527,3255
31271,Sandi,Gloy,sgloy23@ucoz.ru,Librarian,8041,727,8768
31496,Tove,Rubanenko,trubanenko24@phoca.cz,Associate Professor,5619,839,6458
31748,Salem,Saint,ssaint25@storify.com,Graphic Designer,8816,764,9580
31209,Mala,Meaden,mmeaden26@oakley.com,Product Engineer,3142,965,4107
31690,Kim,Cisland,kcisland27@eepurl.com,Web Developer III,2184,287,2471
31173,Haley,Otteridge,hotteridge28@ning.com,Biostatistician IV,3766,928,4694
31012,Ariana,Ciccarello,aciccarello29@linkedin.com,Junior Executive,9574,1526,11100
31327,Idette,Banville,ibanville2a@amazon.co.jp,Data Coordiator,4591,1523,6114
31034,Angelico,Fakes,afakes2b@booking.com,VP Product Management,3449,388,3837
31044,Ogdon,Stotherfield,ostotherfield2c@wordpress.org,Research Associate,2747,1209,3956
31582,Darcee,Dealtry,ddealtry2d@prlog.org,Associate Professor,3427,1883,5310
31295,Dalton,Bringloe,dbringloe2e@freewebs.com,Account Representative I,2436,208,2644
31008,Giraldo,Anneslie,ganneslie2f@gov.uk,Web Developer IV,2939,1719,4658
31680,Sherlocke,Pressman,spressman2g@parallels.com,Operator,5732,660,6392
31838,Edithe,Battin,ebattin2h@china.com.cn,Compensation Analyst,5425,1532,6957
31749,Nady,Lymer,nlymer2i@slate.com,Senior Sales Associate,5636,1404,7040
31941,Marabel,Tegler,mtegler2j@elpais.com,Software Engineer III,2480,917,3397
31817,Ilse,Rewcassell,irewcassell2k@tiny.cc,Executive Secretary,9282,861,10143
31753,Andriana,Jursch,ajursch2l@reuters.com,VP Product Management,3741,974,4715
31140,Alister,Egginton,aegginton2m@shareasale.com,Engineer III,5862,785,6647
31194,Catriona,Kemble,ckemble2n@angelfire.com,Senior Developer,3296,1281,4577
31965,Wolfy,Bohin,wbohin2o@who.int,Technical Writer,7863,1901,9764
31410,Baillie,Nurcombe,bnurcombe2p@trellian.com,Programmer IV,5087,1208,6295
31237,Glynnis,Smedley,gsmedley2q@hugedomains.com,VP Product Management,7431,293,7724
31442,Maressa,Eeles,meeles2r@dyndns.org,Financial Advisor,8839,861,9700
31999,Rina,Rentilll,rrentilll2s@businesswire.com,Quality Engineer,7924,490,8414
31660,Jeane,Busek,jbusek2t@intel.com,Help Desk Technician,8006,988,8994
31896,Allsun,Meegan,ameegan2u@odnoklassniki.ru,VP Sales,2735,1318,4053
31801,Gannie,Wescott,gwescott2v@typepad.com,Biostatistician I,4302,1613,5915
31400,Lilla,Kubiczek,lkubiczek2w@shop-pro.jp,Systems Administrator IV,8413,1779,10192
31048,Rollin,Kenryd,rkenryd2x@nbcnews.com,Administrative Assistant II,2803,1282,4085
31618,Tera,Evans,tevans2y@themeforest.net,Research Assistant I,9814,409,10223
31355,Kellyann,Fawks,kfawks30@qq.com,Human Resources Assistant IV,1359,906,2265
31109,Wilma,Beeswing,wbeeswing31@smh.com.au,Clinical Specialist,3005,469,3474
31105,Hammad,Jasiak,hjasiak32@amazon.co.jp,Structural Engineer,6016,1066,7082
31536,Brenda,Lorenzin,blorenzin34@yelp.com,Marketing Manager,4502,1208,5710
31992,Nathanial,Sawney,nsawney35@bloomberg.com,Assistant Manager,4766,332,5098
31027,Heddie,Veryard,hveryard36@yahoo.co.jp,VP Quality Control,2365,1281,3646
32000,Bruce,Clemoes,bclemoes37@slashdot.org,Pharmacist,8236,842,9078
31475,Ignazio,Gooly,igooly38@mapquest.com,Financial Analyst,4398,1436,5834
31324,Tarah,Thornewill,tthornewill39@ihg.com,Assistant Manager,4830,1697,6527
31982,Creight,Skacel,cskacel3a@upenn.edu,Office Assistant IV,9699,976,10675
31840,Jana,Palffrey,jpalffrey3c@twitter.com,Sales Representative,7773,917,8690
31277,Franny,Branscomb,fbranscomb3d@google.com.hk,Developer IV,6133,1090,7223
31068,Bone,Kiernan,bkiernan3e@dailymotion.com,Safety Technician II,2700,322,3022
31990,Baxter,Manes,bmanes3f@fda.gov,Account Representative I,1178,1290,2468
31970,Waiter,McKomb,wmckomb3g@weather.com,Librarian,7951,966,8917
31181,Clint,Lago,clago3h@sbwire.com,Geologist IV,4377,915,5292
31984,Kenyon,McCandie,kmccandie3i@ft.com,Software Test Engineer II,9888,1105,10993
31823,Vivienne,Cooch,vcooch3j@hc360.com,Information Systems Manager,6434,1630,8064
31426,Rafe,Tippett,rtippett3k@pen.io,Internal Auditor,4329,418,4747
31397,Theo,Botham,tbotham3l@marketwatch.com,Compensation Analyst,4928,832,5760
31405,Blondy,Biswell,bbiswell3m@cnn.com,Operator,2243,1143,3386
31845,Wenda,Crossland,wcrossland3n@patch.com,Compensation Analyst,8972,582,9554
31971,Marget,Stredwick,mstredwick3p@yolasite.com,Developer IV,4215,1364,5579
31224,Karlie,Yakobowitch,kyakobowitch3q@360.cn,Teacher,7588,1305,8893
31805,Frank,Folkerts,ffolkerts3r@craigslist.org,Financial Analyst,8868,1162,10030
31862,Jeramie,Montez,jmontez3s@china.com.cn,Assistant Media Planner,9274,361,9635
31005,Josefina,Wehden,jwehden3t@smh.com.au,Editor,3633,593,4226
31259,Merrick,Crebo,mcrebo3v@narod.ru,Registered Nurse,4206,557,4763
31729,Ricardo,Gloster,rgloster3x@businessinsider.com,Registered Nurse,6490,1386,7876
31045,Petronilla,Newing,pnewing3y@tmall.com,Financial Analyst,6143,1088,7231
31989,Myrtle,Fewtrell,mfewtrell3z@bigcartel.com,Product Engineer,3232,952,4184
31811,Miles,Portt,mportt40@yahoo.co.jp,Financial Advisor,4481,615,5096
31867,Dickie,Layton,dlayton42@typepad.com,Database Administrator I,5934,616,6550
31128,D'arcy,Fearne,dfearne43@aol.com,Senior Quality Engineer,3923,1634,5557
31343,Denver,Mabson,dmabson44@bloglovin.com,Programmer Analyst II,8112,576,8688
31071,Vilma,Emanueli,vemanueli45@bloglovin.com,Information Systems Manager,1131,1743,2874
31886,Cinderella,Shama,cshama46@facebook.com,Payment Adjustment Coordinator,1868,1220,3088
31926,Betta,Waddicor,bwaddicor47@com.com,Speech Pathologist,5243,1193,6436
31492,Renaldo,Berends,rberends48@auda.org.au,Biostatistician I,6676,1260,7936
31826,Patricio,McCutcheon,pmccutcheon49@unc.edu,Budget/Accounting Analyst I,3156,667,3823
31240,Pembroke,Beggio,pbeggio4a@arizona.edu,VP Sales,3172,636,3808
31328,Darrick,Sharrem,dsharrem4b@blinklist.com,Software Test Engineer III,2857,1534,4391
31668,Vernor,McCallum,vmccallum4c@amazon.co.jp,Community Outreach Specialist,3012,1663,4675
31101,Erl,Foote,efoote4e@seattletimes.com,Account Executive,6352,1295,7647
31182,Camila,Filtness,cfiltness4f@smugmug.com,Nuclear Power Engineer,4136,1619,5755
31935,Misha,Cardillo,mcardillo4g@hud.gov,Data Coordiator,1052,1457,2509
31386,Rhea,Furze,rfurze4h@si.edu,Safety Technician II,8602,1244,9846
31764,Alyce,Babst,ababst4i@e-recht24.de,Sales Representative,7388,551,7939
31626,Veronike,Hammor,vhammor4j@howstuffworks.com,Marketing Assistant,7153,1393,8546
31681,Hildagard,Fontes,hfontes4k@taobao.com,Editor,1388,1474,2862
31816,Datha,Alleyn,dalleyn4m@biblegateway.com,Librarian,4538,1185,5723
31356,Joice,Manjin,jmanjin4o@aol.com,VP Marketing,4748,516,5264
31905,Susannah,Savery,ssavery4p@tripadvisor.com,Statistician III,6307,524,6831
31630,Jolynn,Hailes,jhailes4q@purevolume.com,Senior Sales Associate,7758,874,8632
31843,Den,Balfe,dbalfe4r@qq.com,Marketing Assistant,7915,1166,9081
31382,Berti,Tuer,btuer4s@marriott.com,Food Chemist,9027,1779,10806
31147,Luke,Rohan,lrohan4t@walmart.com,Tax Accountant,4091,990,5081
31193,Lina,Finlater,lfinlater4u@1und1.de,Information Systems Manager,6554,482,7036
31196,Xenos,Jacquet,xjacquet4v@usgs.gov,VP Accounting,1404,1222,2626
31495,Cassius,Genders,cgenders4w@amazon.co.uk,Chief Design Engineer,4983,1213,6196
31913,Veronique,Ruppertz,vruppertz50@cyberchimps.com,Director of Sales,9714,1112,10826
31959,Jandy,Trime,jtrime52@msn.com,Technical Writer,2443,1442,3885
31619,Aliza,Dobrowolski,adobrowolski53@blog.com,Sales Representative,9162,1139,10301
31894,Carmel,Jepson,cjepson54@nbcnews.com,Executive Secretary,8824,1094,9918
31258,Barbara,Poundsford,bpoundsford56@npr.org,Account Coordinator,1347,767,2114
31457,Ardis,Wasmuth,awasmuth57@ted.com,Pharmacist,6464,848,7312
31895,Burty,Wressell,bwressell58@samsung.com,Web Developer II,7551,1692,9243
31239,Rosalynd,Zimek,rzimek59@twitpic.com,Physical Therapy Assistant,2022,400,2422
31972,Phyllis,Kettell,pkettell5b@sitemeter.com,Senior Editor,8944,572,9516
31800,Oralla,Menilove,omenilove5c@marketwatch.com,Financial Analyst,1420,1832,3252
31918,Gregoor,Godspede,ggodspede5d@acquirethisname.com,Pharmacist,7311,348,7659
31021,Karlotte,Maudling,kmaudling5f@harvard.edu,Information Systems Manager,4945,1201,6146
31720,Huberto,Yeend,hyeend5g@reddit.com,Social Worker,6818,817,7635
31304,Patsy,Houndson,phoundson5h@jiathis.com,Teacher,4470,1173,5643
31453,Joanie,Meltetal,jmeltetal5i@utexas.edu,Senior Developer,2124,634,2758
31787,Karna,Sliman,ksliman5j@de.vu,Occupational Therapist,7059,347,7406
31468,Yovonnda,Brum,ybrum5l@uol.com.br,Analog Circuit Design manager,5482,1517,6999
31931,Libby,Sayton,lsayton5m@rediff.com,Marketing Assistant,4226,1319,5545
31653,Pauletta,Trevino,ptrevino5n@nbcnews.com,Research Associate,3807,240,4047
31734,Park,Carbett,pcarbett5o@typepad.com,Paralegal,1869,1146,3015
31395,Ricky,Josephsen,rjosephsen5p@latimes.com,Registered Nurse,9327,327,9654
31585,Dudley,Mancer,dmancer5q@shareasale.com,Pharmacist,4637,1485,6122
31112,Swen,O'Crowley,socrowley5r@delicious.com,Junior Executive,4002,435,4437
31190,Felicia,Dearing,fdearing5s@netscape.com,Research Nurse,6552,1947,8499
31478,Rorke,Longrigg,rlongrigg5t@senate.gov,Geologist III,8760,1778,10538
31276,Elton,Welbeck,ewelbeck5u@wikimedia.org,Administrative Officer,2401,1437,3838
31912,Fina,McSporon,fmcsporon5v@mayoclinic.com,Clinical Specialist,6798,672,7470
31320,Andreas,Labrow,alabrow5w@w3.org,Assistant Media Planner,1914,265,2179
31702,Brandy,Itschakov,bitschakov5x@google.com.br,VP Quality Control,6585,281,6866
31765,Aurie,Arnefield,aarnefield5y@dot.gov,Data Coordiator,5571,765,6336
31641,Kristal,Clemmey,kclemmey5z@mapquest.com,Engineer III,7551,1115,8666
31689,Robyn,Morville,rmorville60@sohu.com,Account Representative IV,4240,565,4805
31575,Mehetabel,Imlacke,mimlacke61@ca.gov,Cost Accountant,7459,212,7671
31493,Tilly,Lytton,tlytton62@tripod.com,Help Desk Technician,2248,686,2934
31365,Maudie,Addicott,maddicott63@ebay.co.uk,Developer III,4584,822,5406
31184,Garrick,Asche,gasche65@illinois.edu,VP Accounting,8884,389,9273
31091,Ardelis,Ellcock,aellcock66@ow.ly,Media Manager I,2995,466,3461
31852,Paolo,Mallen,pmallen67@ifeng.com,Analog Circuit Design manager,8735,1825,10560
31301,Gladys,Janek,gjanek69@theguardian.com,Human Resources Assistant III,2746,393,3139
31437,Wyatan,Greeding,wgreeding6a@nps.gov,Compensation Analyst,1928,780,2708
31358,Druci,Absolom,dabsolom6b@mayoclinic.com,Administrative Officer,6343,494,6837
31868,Elinore,Strettle,estrettle6c@pagesperso-orange.fr,Director of Sales,7344,614,7958
31528,Babs,Simeoni,bsimeoni6d@feedburner.com,Analyst Programmer,2918,1473,4391
31837,Lief,Bracci,lbracci6e@scribd.com,Junior Executive,8718,421,9139
31724,Janey,Natalie,jnatalie6f@spiegel.de,Associate Professor,8880,1359,10239
31725,Forester,Temby,ftemby6g@printfriendly.com,Automation Specialist IV,2956,934,3890
31230,Sterne,Twinborne,stwinborne6h@nyu.edu,Safety Technician IV,5092,889,5981
31383,Yvette,Amorts,yamorts6j@buzzfeed.com,Programmer Analyst IV,3323,1446,4769
31614,Colline,Gadman,cgadman6k@ftc.gov,Nurse,1136,1772,2908
31208,Nelly,Broadist,nbroadist6l@flavors.me,Information Systems Manager,2741,1788,4529
31374,Godart,Gasking,ggasking6m@squidoo.com,Programmer II,3791,1839,5630
31929,Gav,Caisley,gcaisley6n@symantec.com,Executive Secretary,5634,1994,7628
31981,Giacomo,McGahy,gmcgahy6o@blog.com,Budget/Accounting Analyst I,3564,1631,5195
31279,Maddie,Davana,mdavana6p@nsw.gov.au,Dental Hygienist,5660,1587,7247
31227,Regen,Prebble,rprebble6q@sitemeter.com,Nurse Practicioner,1006,1798,2804
31980,Marcellina,Linford,mlinford6r@amazonaws.com,Dental Hygienist,3682,1822,5504
31205,Marwin,Billyeald,mbillyeald6t@mtv.com,Physical Therapy Assistant,7069,1849,8918
31793,Aylmar,Tolchard,atolchard6u@buzzfeed.com,Project Manager,1434,1195,2629
31551,Merilyn,Jakovijevic,mjakovijevic6v@cnbc.com,Marketing Manager,6044,1803,7847
31739,Shamus,Caunce,scaunce6w@wordpress.com,Geologist IV,7845,450,8295
31349,Malina,Muehle,mmuehle6x@ca.gov,Social Worker,6847,672,7519
31771,Clementia,Jakobssen,cjakobssen6y@miitbeian.gov.cn,Operator,1625,637,2262
31163,Laurens,Ollerhead,lollerhead6z@dailymotion.com,Automation Specialist IV,8614,1435,10049
31130,Ogdon,Coope,ocoope70@boston.com,Accounting Assistant I,5342,1212,6554
31534,Stefania,Honniebal,shonniebal71@goo.gl,VP Quality Control,7762,1363,9125
31635,Sheba,Espie,sespie72@prnewswire.com,Office Assistant II,4115,1066,5181
31882,Bernardine,Briar,bbriar73@gravatar.com,Administrative Assistant III,9766,866,10632
31727,Onfroi,Fabler,ofabler75@squidoo.com,Environmental Specialist,3599,1123,4722
31086,Red,Lehr,rlehr76@intel.com,Help Desk Technician,5995,433,6428
31506,Gregorius,Rickeard,grickeard77@canalblog.com,Internal Auditor,8954,1908,10862
31197,Siusan,Dacks,sdacks78@networksolutions.com,Structural Engineer,4299,267,4566
31082,Thea,Duncklee,tduncklee79@imgur.com,Desktop Support Technician,1037,487,1524
31372,Farlee,MacCracken,fmaccracken7b@patch.com,Civil Engineer,1855,1148,3003
31751,Chloe,Plewman,cplewman7d@ifeng.com,Information Systems Manager,8149,1606,9755
31047,Meredith,Golbourn,mgolbourn7e@goo.ne.jp,Biostatistician IV,3697,770,4467
31682,Lock,Fromant,lfromant7f@nhs.uk,Database Administrator II,7304,371,7675
31951,Andrey,Frankham,afrankham7h@123-reg.co.uk,Project Manager,9830,1691,11521
31003,Christian,Midlane,cmidlane7i@vimeo.com,Senior Sales Associate,8782,200,8982
31076,Caro,Riddiough,criddiough7j@indiatimes.com,Account Coordinator,5317,1892,7209
31672,Tracy,Solesbury,tsolesbury7k@usgs.gov,Design Engineer,7408,738,8146
31454,Fergus,Hixson,fhixson7l@army.mil,Graphic Designer,9876,1110,10986
31790,Robinette,Clute,rclute7m@purevolume.com,Community Outreach Specialist,8565,294,8859
31621,Napoleon,Stickney,nstickney7o@addtoany.com,Accounting Assistant I,4940,1309,6249
31507,Frankie,Farmiloe,ffarmiloe7p@hc360.com,Business Systems Development Analyst,1789,1583,3372
31136,Cindi,Mallabar,cmallabar7q@bloomberg.com,Budget/Accounting Analyst II,3406,475,3881
31286,Amanda,Boole,aboole7s@moonfruit.com,Database Administrator III,6505,1593,8098
31560,Arluene,Mangeon,amangeon7t@cbc.ca,Payment Adjustment Coordinator,5216,1890,7106
31625,La verne,Grunguer,lgrunguer7u@issuu.com,Information Systems Manager,4113,1871,5984
31777,Karie,Etherton,ketherton7v@51.la,Accountant III,7064,1792,8856
31402,Hildegarde,Chatain,hchatain7w@flickr.com,Speech Pathologist,9742,1921,11663
31715,Melesa,Rosenhaupt,mrosenhaupt7x@marriott.com,Account Representative I,4920,875,5795
31061,Isaiah,Winchcum,iwinchcum7z@webnode.com,Senior Cost Accountant,1936,690,2626
31409,Iosep,Steagall,isteagall80@digg.com,Project Manager,6795,1428,8223
31670,Zedekiah,Chave,zchave82@usatoday.com,Senior Sales Associate,8197,364,8561
31396,Omero,Fiddymont,ofiddymont83@networkadvertising.org,Quality Engineer,5135,248,5383
31721,Quintilla,Tarbox,qtarbox84@nationalgeographic.com,Assistant Professor,1578,635,2213
31610,Jazmin,Ratter,jratter86@printfriendly.com,Social Worker,2470,940,3410
31593,Sharlene,Crocombe,scrocombe87@tumblr.com,Chemical Engineer,5149,900,6049
31580,Kirstyn,Djuricic,kdjuricic89@japanpost.jp,Design Engineer,2896,328,3224
31415,Filippa,Gurney,fgurney8a@mail.ru,Desktop Support Technician,8941,686,9627
31586,Hattie,Nare,hnare8c@springer.com,Accountant III,1046,1896,2942
31678,Griffin,Fulford,gfulford8e@shop-pro.jp,Administrative Assistant I,8992,1931,10923
31243,Lynsey,Smedmoor,lsmedmoor8g@salon.com,Analyst Programmer,8577,907,9484
31020,Lanni,Studd,lstudd8h@scientificamerican.com,Safety Technician III,8135,1581,9716
31907,Cathrin,Masson,cmasson8i@cafepress.com,Human Resources Manager,6541,549,7090
31443,Magda,Layfield,mlayfield8j@istockphoto.com,GIS Technical Architect,1756,588,2344
31216,Kimberlee,Acey,kacey8k@guardian.co.uk,Account Representative IV,6160,495,6655
31084,Maible,Cud,mcud8l@deliciousdays.com,Programmer Analyst III,6908,729,7637
31274,Merle,Hebditch,mhebditch8m@netlog.com,Marketing Assistant,1096,797,1893
31399,Auberon,Faers,afaers8n@google.pl,Web Designer IV,4919,221,5140
31285,Katleen,Feast,kfeast8o@sciencedaily.com,Paralegal,2437,327,2764
31291,Roddy,Vittet,rvittet8p@harvard.edu,Speech Pathologist,2016,1869,3885
31674,Ethelin,Capelin,ecapelin8s@businessinsider.com,Database Administrator I,5516,1566,7082
31909,Sonnie,Winckworth,swinckworth8t@narod.ru,Sales Representative,7249,1365,8614
31375,Celeste,Cullen,ccullen8x@alibaba.com,Civil Engineer,4715,1394,6109
31299,Quinta,Wellbeloved,qwellbeloved8y@hibu.com,Occupational Therapist,8367,827,9194
31548,Miquela,Polkinghorne,mpolkinghorne8z@typepad.com,VP Sales,7978,1193,9171
31333,Emlynn,Colliber,ecolliber93@webeden.co.uk,Internal Auditor,7728,754,8482
31186,Elana,Bryer,ebryer94@cnn.com,Administrative Officer,6787,638,7425
31520,Benyamin,Treby,btreby95@howstuffworks.com,Programmer Analyst III,2825,1935,4760
31313,Gris,Jirzik,gjirzik96@yelp.com,Accountant I,5298,1772,7070
31509,Erie,Mabbot,emabbot97@usda.gov,Statistician IV,9766,489,10255
31067,Bea,Minnette,bminnette99@time.com,Human Resources Manager,6934,524,7458
31889,Sandi,Giocannoni,sgiocannoni9a@sfgate.com,Structural Analysis Engineer,3598,1455,5053
31030,Emmy,Wildish,ewildish9b@shareasale.com,VP Quality Control,4654,546,5200
31388,Marcile,Trumble,mtrumble9c@mysql.com,Office Assistant III,5739,1430,7169
31427,Aridatha,Ballard,aballard9d@dion.ne.jp,Registered Nurse,6968,1769,8737
31165,Aurel,Ramshay,aramshay9e@skyrock.com,Senior Cost Accountant,9821,1948,11769
31477,Iggy,Atlee,iatlee9h@ftc.gov,Compensation Analyst,8074,849,8923
31975,Datha,Cleminson,dcleminson9i@eventbrite.com,VP Product Management,1479,633,2112
31119,Wakefield,Paolone,wpaolone9j@miitbeian.gov.cn,Tax Accountant,4186,1566,5752
31060,Desmund,Gaskamp,dgaskamp9k@tripadvisor.com,GIS Technical Architect,9110,1296,10406
31718,Yuma,Colombier,ycolombier9l@apache.org,Help Desk Operator,3374,970,4344
31605,Abby,Dickey,adickey9m@omniture.com,Pharmacist,8232,733,8965
31100,Cobbie,Toretta,ctoretta9n@upenn.edu,Assistant Media Planner,4191,1634,5825
31945,Loralee,Sharrocks,lsharrocks9o@facebook.com,Structural Engineer,3890,259,4149
31532,Hildy,Tunnacliffe,htunnacliffe9p@tamu.edu,Media Manager II,5281,407,5688
31866,Kristina,Gilleon,kgilleon9s@sourceforge.net,Staff Accountant I,6947,767,7714
31064,Carolin,Northfield,cnorthfield9t@people.com.cn,Office Assistant III,2362,1285,3647
31038,Sayre,Ibbs,sibbs9u@live.com,Junior Executive,9494,1036,10530
31484,Mirabelle,Ladel,mladel9x@nba.com,Food Chemist,4272,1614,5886
31911,Gabbie,Lawleff,glawleff9y@wufoo.com,Help Desk Technician,7646,228,7874
31377,Teresa,Lakey,tlakeya1@geocities.com,Financial Advisor,3696,1917,5613
31667,Carlotta,Melliard,cmelliarda4@skyrock.com,Analog Circuit Design manager,3461,1060,4521
31759,Elbertina,Hindenberger,ehindenbergera6@shinystat.com,Financial Analyst,5314,727,6041
31351,Maris,Lemmon,mlemmona7@un.org,Professor,3323,1391,4714
31170,Vanya,LLelweln,vllelwelna8@netvibes.com,General Manager,1681,1875,3556
31094,Corty,Godfrey,cgodfreya9@redcross.org,Accounting Assistant III,9066,1273,10339
31822,Stirling,Merrikin,smerrikinaa@topsy.com,Cost Accountant,2668,1355,4023
31289,Marney,Exell,mexellab@themeforest.net,Teacher,1719,1708,3427
31390,Helaina,Dubbin,hdubbinac@google.co.jp,Sales Representative,4429,814,5243
31974,Osbourn,Hector,ohectorah@bluehost.com,Product Engineer,9181,863,10044
31887,Iosep,Studdard,istuddardai@webeden.co.uk,Clinical Specialist,5244,696,5940
31901,Morey,Leney,mleneyak@themeforest.net,Project Manager,9617,1909,11526
31742,Colline,Lambden,clambdenal@mediafire.com,Desktop Support Technician,3554,1213,4767
31167,Michaelina,Chuck,mchuckam@shop-pro.jp,Safety Technician III,9808,966,10774
31002,Britta,Giovannilli,bgiovannillian@google.cn,Data Coordiator,1018,721,1739
31368,Georg,Screeton,gscreetonao@hatena.ne.jp,Environmental Tech,8079,1392,9471
31884,Kaila,Lowless,klowlessaq@mac.com,Chief Design Engineer,5778,1300,7078
31673,Urbano,Chaplin,uchaplinar@topsy.com,Help Desk Technician,6470,748,7218
31022,Timothee,Ganford,tganfordav@tripod.com,Accountant III,2043,998,3041
31563,Olympe,Calleja,ocallejaaw@home.pl,Junior Executive,7492,1063,8555
31116,Rancell,Boagey,rboageyax@ameblo.jp,Recruiting Manager,9004,851,9855
31152,Debera,Renison,drenisonay@flavors.me,VP Marketing,8451,1920,10371
31098,Jewell,Kinlock,jkinlockaz@sina.com.cn,Analog Circuit Design manager,5165,902,6067
31282,Kellia,Fellis,kfellisb1@slideshare.net,Accounting Assistant I,9279,1201,10480
31425,Marquita,Dufer,mduferb2@ow.ly,Technical Writer,7674,1068,8742
31085,Aida,Henze,ahenzeb3@cbsnews.com,Assistant Professor,2706,1729,4435
31183,Carr,Meacher,cmeacherb4@upenn.edu,Actuary,1774,1447,3221
31323,Jedidiah,Upstone,jupstoneb6@ibm.com,Nurse,4654,1537,6191
31391,Daffi,Danihel,ddanihelb7@narod.ru,General Manager,6266,1796,8062
31706,Luella,Branche,lbrancheb8@studiopress.com,Analog Circuit Design manager,1982,1647,3629
31514,Florie,Stollenbecker,fstollenbeckerb9@adobe.com,Editor,5158,1623,6781
31993,Penrod,Gouinlock,pgouinlockbb@github.io,Human Resources Manager,4438,1542,5980
31745,Neddie,Duckels,nduckelsbc@columbia.edu,Senior Quality Engineer,5927,1603,7530
31159,Clio,Mabone,cmabonebe@google.co.uk,Pharmacist,3691,211,3902
31596,Lise,Calkin,lcalkinbf@wikipedia.org,Data Coordiator,9826,1743,11569
31016,Eddy,Muskett,emuskettbi@answers.com,Nurse,4612,1944,6556
31089,Nonna,Brewer,nbrewerbj@newsvine.com,Software Consultant,4387,414,4801
31268,Ajay,Rollason,arollasonbk@cargocollective.com,Business Systems Development Analyst,9794,482,10276
31491,Paddie,Boobier,pboobierbm@disqus.com,Systems Administrator IV,3834,660,4494
31341,Audi,Jump,ajumpbo@posterous.com,VP Quality Control,9823,1876,11699
31312,Joann,Burford,jburfordbq@reference.com,Nurse Practicioner,7369,377,7746
31830,Dacia,Summers,dsummersbr@tmall.com,Accountant IV,9004,741,9745
31517,Obidiah,Demko,odemkobt@bloomberg.com,Mechanical Systems Engineer,4721,790,5511
31166,Gaultiero,Budden,gbuddenbx@myspace.com,Research Associate,4807,487,5294
31881,Ulick,McUre,umcureby@about.com,Financial Analyst,3047,400,3447
31298,Tabina,Mc Caghan,tmccaghanc0@wsj.com,Internal Auditor,5436,1638,7074
31569,Glynda,Charter,gcharterc1@kickstarter.com,Internal Auditor,8785,1073,9858
31604,Gage,Botright,gbotrightc2@purevolume.com,Design Engineer,4097,447,4544
31081,Tobi,Need,tneedc4@fc2.com,Financial Analyst,4061,232,4293
31898,Ev,Druce,edrucec7@economist.com,Executive Secretary,3354,826,4180
31393,Garry,Tyrone,gtyronec8@trellian.com,Senior Financial Analyst,3292,1980,5272
31311,Almira,Doyle,adoylec9@google.com,Database Administrator I,6439,1441,7880
31150,Shannon,Brookesbie,sbrookesbieca@oaic.gov.au,Human Resources Manager,9808,982,10790
31900,Cheston,Abbes,cabbescb@vkontakte.ru,Financial Analyst,9205,1296,10501
31769,Laney,Eacle,leaclecc@pagesperso-orange.fr,Research Nurse,7039,605,7644
31591,Archibaldo,Sline,aslinecf@hostgator.com,Food Chemist,8813,1286,10099
31345,Rockwell,Rapa,rrapacg@example.com,Project Manager,8975,1094,10069
31270,Vince,Gherardesci,vgherardescici@gizmodo.com,Account Executive,2037,1615,3652
31940,Cosme,Tittershill,ctittershillcm@weebly.com,Staff Accountant I,7400,1470,8870
31962,Markus,Ilyuchyov,milyuchyovcp@opera.com,Assistant Media Planner,9096,1602,10698
31458,Barny,Witherow,bwitherowcq@economist.com,Help Desk Operator,7703,1595,9298
31638,Saba,Donovan,sdonovancr@over-blog.com,Assistant Media Planner,4498,1075,5573
31552,Tamar,Seakin,tseakincs@who.int,Electrical Engineer,8984,267,9251
31658,Godfrey,Carnegy,gcarnegyct@google.nl,Software Consultant,3098,1829,4927
31615,Hermon,Crossthwaite,hcrossthwaitecw@imageshack.us,Associate Professor,8526,1445,9971
31266,Bern,Dradey,bdradeycx@canalblog.com,Information Systems Manager,7237,825,8062
31519,Shay,Biggerdike,sbiggerdiked3@independent.co.uk,Nuclear Power Engineer,1485,1400,2885
31486,Roarke,Cardenoso,rcardenosod4@simplemachines.org,Registered Nurse,4579,919,5498
31860,Maryrose,Kilvington,mkilvingtond7@ovh.net,Senior Financial Analyst,7312,1422,8734
31576,Kimmi,Bambury,kbamburyd8@github.io,VP Sales,6536,1118,7654
31995,Aurlie,Sopper,asopperd9@deviantart.com,Systems Administrator III,3806,1224,5030
31057,Chrysa,Fontel,cfonteldb@google.nl,VP Marketing,5489,497,5986
31985,Roddie,McKevitt,rmckevittdc@deliciousdays.com,Database Administrator II,7242,1718,8960
31577,Aurora,Restieaux,arestieauxdd@archive.org,Technical Writer,5670,781,6451
31283,Bernard,Ciotti,bciottide@weibo.com,Help Desk Operator,8694,1937,10631
31703,Vernice,Dampier,vdampierdg@quantcast.com,Director of Sales,9378,1421,10799
31255,Jerrine,Maron,jmarondh@google.pl,Research Assistant III,9294,1589,10883
31058,Bobinette,Emerine,bemerinedi@chronoengine.com,Mechanical Systems Engineer,9357,883,10240
31024,Penny,Beresfore,pberesforedl@godaddy.com,Senior Cost Accountant,1402,1790,3192
31074,Hyman,Kahan,hkahandm@home.pl,Teacher,5379,884,6263
31538,Feodor,Godthaab,fgodthaabdn@yandex.ru,Design Engineer,3775,655,4430
31557,Ami,Regus,aregusdo@stanford.edu,Software Consultant,1869,383,2252
31462,Ronny,Stockin,rstockindp@miibeian.gov.cn,Desktop Support Technician,2841,1525,4366
31903,Julita,Scrace,jscracedr@nsw.gov.au,VP Product Management,8856,1205,10061
31758,Charline,MacNish,cmacnishdw@omniture.com,Editor,9564,1401,10965
31242,Natala,Egginton,neggintondx@blog.com,Structural Analysis Engineer,3244,1370,4614
31549,Vite,Greenhowe,vgreenhowedy@joomla.org,Legal Assistant,9659,797,10456
31634,Flss,Pevreal,fpevrealdz@mediafire.com,Structural Analysis Engineer,1741,1658,3399
31676,Darby,Tolerton,dtolertone0@comcast.net,Operator,1675,1238,2913
31669,Georas,Climie,gclimiee1@cnn.com,Safety Technician I,9100,1925,11025
31231,Miles,Le Cornu,mlecornue2@free.fr,Programmer Analyst I,2549,1542,4091
31418,Amalia,Jandac,ajandace3@techcrunch.com,Structural Engineer,7287,1889,9176
31858,Lorri,Georgievski,lgeorgievskie4@creativecommons.org,Mechanical Systems Engineer,6763,1436,8199
31157,Kelwin,Stringfellow,kstringfellowe5@weebly.com,Computer Systems Analyst I,7354,587,7941
31809,Montague,Hassewell,mhassewelle7@ovh.net,Senior Quality Engineer,9698,1629,11327
31797,Gannon,Shand,gshande8@unc.edu,Staff Scientist,1091,1664,2755
31384,Manuel,Lubeck,mlubeckeg@simplemachines.org,Quality Control Specialist,7159,1206,8365
31195,Ella,Laboune,elabouneeh@google.com,Human Resources Manager,4706,405,5111
31847,Audrey,Khomin,akhominek@ovh.net,VP Accounting,9401,1775,11176
31662,Celestyna,Newberry,cnewberryem@fema.gov,Administrative Assistant IV,1823,1593,3416
31248,Standford,Hebson,shebsonen@nationalgeographic.com,Associate Professor,5111,1510,6621
31006,Redd,Melhuish,rmelhuisheo@forbes.com,Help Desk Operator,2293,453,2746
31162,Leonie,Wrightson,lwrightsonep@themeforest.net,Chemical Engineer,8330,869,9199
31090,Tera,Woolfitt,twoolfitteu@alibaba.com,Geological Engineer,7752,831,8583
31141,Gris,Wardesworth,gwardesworthez@photobucket.com,Engineer III,8871,1808,10679
31479,Luciano,Rushbrook,lrushbrookf0@typepad.com,Speech Pathologist,5682,332,6014
31784,Phillida,Artingstall,partingstallf1@wikimedia.org,Engineer II,7214,1670,8884
31876,Haskel,Rantoul,hrantoulf2@opensource.org,Human Resources Assistant III,1062,1902,2964
31281,Rad,Starcks,rstarcksf3@liveinternet.ru,Staff Scientist,2011,983,2994
31648,Simone,Philippard,sphilippardf5@wix.com,Safety Technician II,6798,1405,8203
31966,Patricia,Davydenko,pdavydenkof6@hatena.ne.jp,Registered Nurse,1432,642,2074
31252,Tucky,Tregensoe,ttregensoef7@miibeian.gov.cn,Social Worker,7444,1981,9425
31825,Nancey,Rizzillo,nrizzillofa@multiply.com,Statistician III,2497,405,2902
31497,Hetti,Watling,hwatlingfd@g.co,Information Systems Manager,3376,796,4172
31244,Lynde,Godden,lgoddenfh@yelp.com,Help Desk Technician,3017,255,3272
31829,Inez,Bodham,ibodhamfj@cocolog-nifty.com,Developer I,3497,684,4181
31865,Giffy,Duddridge,gduddridgefk@wikimedia.org,Executive Secretary,3281,1942,5223
31578,Heath,Gammons,hgammonsfl@rediff.com,Research Nurse,8768,600,9368
31095,Kelcey,Palfrie,kpalfriefm@forbes.com,Assistant Manager,6944,556,7500
31307,Friederike,Stanyard,fstanyardfo@umn.edu,Junior Executive,7093,1660,8753
31599,Livy,Elrick,lelrickfq@tmall.com,Statistician II,8555,1520,10075
31296,Jacqueline,Inglesant,jinglesantfr@free.fr,Compensation Analyst,4854,1773,6627
31501,Ros,Matterdace,rmatterdacefs@github.com,Mechanical Systems Engineer,3180,497,3677
31976,Guido,Giacopetti,ggiacopettifu@gov.uk,Product Engineer,8178,363,8541
31342,Royall,Clemett,rclemettfx@cdc.gov,Staff Scientist,2844,1044,3888
31483,Tabbie,L' Estrange,tlestrangefy@salon.com,Chemical Engineer,7397,781,8178
31617,Sergio,Murtimer,smurtimerfz@mediafire.com,Director of Sales,4180,1093,5273
31401,Anabelle,Lacer,alacerg4@mayoclinic.com,Nurse Practicioner,3430,1272,4702
31326,Norine,Birtwhistle,nbirtwhistleg5@hatena.ne.jp,Web Developer IV,1778,974,2752
31025,Arie,Uccello,auccellog8@amazon.com,Tax Accountant,4236,739,4975
31656,Boycie,Leavesley,bleavesleyga@naver.com,Biostatistician IV,2112,1098,3210
31567,Gilberta,Swayte,gswaytegb@stanford.edu,Senior Sales Associate,1457,1245,2702
31444,Alvera,Jurek,ajurekgg@abc.net.au,Administrative Assistant III,5080,1085,6165
31554,Maribelle,Piotrkowski,mpiotrkowskigh@simplemachines.org,Budget/Accounting Analyst IV,3463,265,3728
31851,Netta,Mozzini,nmozzinigi@reddit.com,Budget/Accounting Analyst III,6284,807,7091
31983,Georgiana,Dashkov,gdashkovgj@phoca.cz,Payment Adjustment Coordinator,6648,1649,8297
31872,Griffie,Fattorini,gfattorinigk@vkontakte.ru,Electrical Engineer,9194,492,9686
31394,Harwell,Jahnisch,hjahnischgm@unicef.org,Business Systems Development Analyst,5777,329,6106
31620,Brande,Girsch,bgirschgo@oracle.com,Software Test Engineer IV,8701,1330,10031
31730,Lynnea,Doorly,ldoorlygp@phoca.cz,Registered Nurse,9382,1889,11271
31775,Brandise,Saggers,bsaggersgr@washingtonpost.com,Librarian,2821,1256,4077
31148,Roi,Normaville,rnormavilleh1@reddit.com,VP Sales,9124,1038,10162
31518,Babb,Greader,bgreaderh2@apple.com,Editor,4326,731,5057
31927,Kathryn,Haskew,khaskewh3@domainmarket.com,Tax Accountant,2462,1809,4271
31439,Mollee,Driscoll,mdriscollh6@whitehouse.gov,Design Engineer,2123,463,2586
31088,Lancelot,Binne,lbinneh7@arizona.edu,Structural Analysis Engineer,1552,1968,3520
31447,Barri,Arnault,barnaulthc@photobucket.com,VP Product Management,9887,1542,11429
31451,Minerva,Fulloway,mfullowayhd@irs.gov,Web Developer III,8898,1091,9989
31369,Gilligan,Beaushaw,gbeaushawhh@deviantart.com,Director of Sales,6956,854,7810
31213,Kelwin,Gribbins,kgribbinshi@washington.edu,Desktop Support Technician,2027,1153,3180
31223,Janetta,Warrington,jwarringtonhk@e-recht24.de,Senior Financial Analyst,8896,795,9691
31675,Bern,Ovell,bovellhn@quantcast.com,Engineer III,3324,965,4289
31164,Sal,Chrispin,schrispinhp@china.com.cn,Chief Design Engineer,3869,1005,4874
31052,Justinian,Nutman,jnutmanhq@imdb.com,Dental Hygienist,7794,1710,9504
31961,Gustave,Meenan,gmeenanhs@who.int,Civil Engineer,4974,1258,6232
31671,Tory,Le Lievre,tlelievreht@blinklist.com,Food Chemist,1926,1985,3911
31934,Zuzana,Coultard,zcoultardhw@slate.com,Food Chemist,1405,291,1696
31733,Nessi,Milland,nmillandhx@g.co,Senior Sales Associate,7616,1816,9432
31550,Wallis,Bisset,wbissethy@odnoklassniki.ru,Design Engineer,6851,238,7089
31272,Tadeas,Pask,tpaski1@deliciousdays.com,Programmer IV,1759,1180,2939
31179,Berton,Bofield,bbofieldi2@gov.uk,Office Assistant II,5715,1499,7214
31794,Finley,Raulston,fraulstoni7@soup.io,Occupational Therapist,5842,1427,7269
31069,Angelita,Gristock,agristocki9@bloomberg.com,Director of Sales,5891,831,6722
31778,Dani,Keel,dkeelia@engadget.com,Civil Engineer,9992,904,10896
31114,Norene,Lough,nloughib@addtoany.com,Automation Specialist II,9582,596,10178
31944,Beverlie,O'Doohaine,bodoohaineid@blogtalkradio.com,VP Sales,3345,1965,5310
31661,Sherlock,Damp,sdampie@census.gov,Nurse,4060,504,4564
31220,Alvira,Shuttle,ashuttleig@sakura.ne.jp,Tax Accountant,6807,1356,8163
31146,Antony,Buckthought,abuckthoughtii@canalblog.com,Systems Administrator IV,7490,248,7738
31996,Anita,Humm,ahummij@bloglines.com,Administrative Assistant III,3424,242,3666
31485,Norman,Farndon,nfarndonik@prweb.com,Computer Systems Analyst III,1909,1433,3342
31732,Ainsley,Boothman,aboothmanio@arstechnica.com,Senior Sales Associate,2195,1572,3767
31464,Lura,Schout,lschoutip@oakley.com,Research Nurse,1748,1241,2989
31714,Kore,Duffy,kduffyiq@typepad.com,Teacher,3637,291,3928
31814,Wilona,Dummett,wdummettis@gov.uk,Quality Control Specialist,3303,1759,5062
31949,Jeffry,Diment,jdimentiu@state.tx.us,Nurse Practicioner,3897,594,4491
31120,Moe,Grolle,mgrolleiv@nytimes.com,Nurse,4881,1714,6595
31723,Cherilynn,Moohan,cmoohaniw@devhub.com,Web Developer III,7403,1938,9341
31460,Yehudit,Hadcock,yhadcockix@eventbrite.com,Operator,9853,1421,11274
31601,Rufe,Williamson,rwilliamsoniy@sun.com,Senior Developer,4603,808,5411
31836,Hayyim,Croal,hcroalj0@samsung.com,Staff Scientist,3190,1069,4259
31424,Minetta,Kneeshaw,mkneeshawj4@acquirethisname.com,Registered Nurse,6164,967,7131
31788,Aurel,Germann,agermannj6@pen.io,Structural Engineer,1148,1652,2800
31500,Yank,Tofts,ytoftsj7@umn.edu,Business Systems Development Analyst,1765,1173,2938
31574,Humbert,Stilly,hstillyjc@theguardian.com,Web Developer III,7160,243,7403
31928,Gwenora,Ault,gaultjd@boston.com,Account Representative III,7847,1911,9758
31465,Jaquenetta,Speer,jspeerje@goodreads.com,GIS Technical Architect,9669,501,10170
31488,Lizabeth,Terlinden,lterlindenjh@netscape.com,Assistant Media Planner,8038,1498,9536
31449,Carie,Gobert,cgobertjj@bravesites.com,Assistant Media Planner,9450,810,10260
31544,Christopher,Sare,csarejk@time.com,Administrative Assistant IV,4629,1108,5737
31354,Cindee,Bergeau,cbergeaujl@hibu.com,Biostatistician I,6302,1493,7795
31821,Gaven,Steele,gsteelejn@vistaprint.com,Tax Accountant,8606,1406,10012
31997,Jeremie,Cullingford,jcullingfordjo@nationalgeographic.com,Occupational Therapist,2603,584,3187
31051,Mathilde,Blondin,mblondinjp@abc.net.au,Executive Secretary,4828,1225,6053
31446,Catherine,O'Brian,cobrianjq@4shared.com,Staff Scientist,9411,963,10374
31336,Yulma,Moryson,ymorysonju@delicious.com,Analog Circuit Design manager,4172,1296,5468
31123,Sanders,Pizzey,spizzeyjv@oakley.com,Senior Editor,7678,1228,8906
31566,Blondie,Pohlak,bpohlakjw@hp.com,Research Assistant I,2718,1428,4146
31288,Tomasina,Le Pine,tlepinejy@exblog.jp,Biostatistician I,5729,783,6512
31633,Albie,Purslow,apurslowjz@wordpress.org,Graphic Designer,9713,1947,11660
31251,Carly,Adlard,cadlardk0@instagram.com,Executive Secretary,6469,560,7029
31677,Karney,Biddlestone,kbiddlestonek3@seattletimes.com,Teacher,4696,560,5256
31059,Gaylene,Bohl,gbohlk5@jalbum.net,Paralegal,3063,1677,4740
31041,Dulcea,Chrstine,dchrstinek6@163.com,Compensation Analyst,3879,221,4100
31379,Beverlie,Bolley,bbolleyk8@wiley.com,Accountant II,8183,652,8835
31078,Odelle,Guido,oguidoka@mapquest.com,Chief Design Engineer,6345,1891,8236
31719,Robb,Doy,rdoykc@sciencedirect.com,Geological Engineer,2761,469,3230
31403,Aurelie,Holleworth,aholleworthkd@pen.io,Budget/Accounting Analyst I,9896,1984,11880
31892,Beverlie,Skehens,bskehenske@msu.edu,Paralegal,2472,788,3260
31978,Cesar,Eldon,celdonkf@posterous.com,Computer Systems Analyst I,6055,475,6530
31627,Nikolas,Durning,ndurningkg@google.ca,Mechanical Systems Engineer,7847,1821,9668
31953,Selby,Faier,sfaierki@feedburner.com,Desktop Support Technician,7400,399,7799
31891,Lodovico,Davitti,ldavittikk@ow.ly,Research Assistant IV,4646,1275,5921
31685,Leif,Wittleton,lwittletonkm@fc2.com,Business Systems Development Analyst,4852,764,5616
31096,Harold,Gartenfeld,hgartenfeldkn@w3.org,Operator,3338,403,3741
31206,Jeanette,Friend,jfriendko@nifty.com,Health Coach II,7687,819,8506
31645,Prue,Banbrook,pbanbrookks@soundcloud.com,Marketing Assistant,3067,594,3661
31688,Barnabas,Stutte,bstuttekw@eventbrite.com,Budget/Accounting Analyst I,1432,1767,3199
31746,Ashlin,Thonger,athongerky@java.com,Cost Accountant,5216,903,6119
31412,Barbi,Vost,bvostl1@time.com,Software Engineer II,5594,1996,7590
31812,Raleigh,Crang,rcrangl3@php.net,Senior Editor,7810,651,8461
31754,Marty,Carbery,mcarberyl4@intel.com,Research Assistant I,7596,232,7828
31075,Sherlock,Pointin,spointinl6@oakley.com,Food Chemist,3526,441,3967
31250,Ulrikaumeko,Messiter,umessiterl7@wufoo.com,Executive Secretary,4671,1622,6293
31043,Olivero,Engley,oengleyl8@blogs.com,Product Engineer,4314,1695,6009
31420,Merrill,Galtone,mgaltonel9@cnn.com,Database Administrator IV,5235,1065,6300
31798,Hartley,Burborough,hburboroughle@sitemeter.com,VP Marketing,2535,639,3174
31988,Madelena,Hearnes,mhearneslf@squarespace.com,Software Test Engineer II,5017,1074,6091
31472,Cyndy,Vequaud,cvequaudlg@bandcamp.com,Tax Accountant,1219,515,1734
31004,Cthrine,Kingscote,ckingscoteli@un.org,Product Engineer,2249,1935,4184
31664,Devinne,Gilbee,dgilbeelj@hibu.com,Automation Specialist III,4147,1900,6047
31129,Darline,Ahrend,dahrendlk@digg.com,Internal Auditor,7040,1991,9031
31902,Jefferson,Flavelle,jflavelleln@cbc.ca,Developer III,9914,1578,11492
31820,Denny,Ionnisian,dionnisianlo@360.cn,GIS Technical Architect,2385,291,2676
31445,Sheba,Hensmans,shensmanslw@cbslocal.com,Dental Hygienist,9506,1130,10636
31693,Leicester,Fitzsymon,lfitzsymonly@surveymonkey.com,Help Desk Technician,2137,1642,3779
31450,Richardo,Wasiel,rwasielm0@qq.com,Project Manager,5629,369,5998
31632,Darrell,Dies,ddiesm1@meetup.com,Geologist IV,7723,1003,8726
31118,Selig,Gosnall,sgosnallm4@multiply.com,Chief Design Engineer,5606,1712,7318
31502,Tammi,Dunrige,tdunrigem5@chicagotribune.com,Food Chemist,6656,1317,7973
31590,Abigale,Mayhew,amayhewm7@wikia.com,Web Designer I,2721,1069,3790
31175,Filia,Pennells,fpennellsm9@time.com,Biostatistician II,8322,473,8795
31315,Nowell,Syphas,nsyphasmb@dell.com,Desktop Support Technician,6597,516,7113
31629,Joscelin,Robrow,jrobrowmh@soundcloud.com,Web Designer III,9720,1142,10862
31334,Hunt,Loftin,hloftinml@mail.ru,VP Accounting,6398,1595,7993
31198,Mariele,Strete,mstretemm@shutterfly.com,Staff Scientist,5869,342,6211
31750,Janet,MacGuigan,jmacguiganmn@cdbaby.com,Financial Analyst,1739,781,2520
31121,Lane,Mandell,lmandellmo@ocn.ne.jp,Account Executive,1489,1265,2754
31214,Mufi,Senecaut,msenecautmp@icio.us,Quality Control Specialist,4759,1168,5927
31711,Tomaso,Mapis,tmapismq@abc.net.au,Account Coordinator,4205,470,4675
31890,Melesa,Meak,mmeakmr@ebay.com,Quality Engineer,3460,248,3708
31066,Carolin,Ciraldo,cciraldoms@intel.com,Senior Financial Analyst,2602,1688,4290
31954,Lyndsey,Fydoe,lfydoemw@mozilla.org,Database Administrator IV,6345,1370,7715
31958,Kippie,Disbrey,kdisbreyn2@last.fm,Structural Analysis Engineer,7549,1970,9519
31925,Beitris,Crust,bcrustn3@geocities.jp,Associate Professor,8643,986,9629
31133,Francisco,Rigardeau,frigardeaun4@dion.ne.jp,Media Manager III,7812,1176,8988
31766,Andrey,Huckabe,ahuckabend@unesco.org,Senior Developer,5855,1340,7195
31780,Kearney,Cossans,kcossansnh@yahoo.com,Analog Circuit Design manager,4383,482,4865
31353,Pierrette,Pappi,ppappini@tripod.com,Pharmacist,3962,447,4409
31263,Allard,Schwander,aschwandernk@de.vu,Sales Representative,9247,535,9782
31932,Dell,Branchet,dbranchetno@discovery.com,Payment Adjustment Coordinator,2903,1639,4542
31102,Ches,Sweatman,csweatmannq@senate.gov,Recruiting Manager,4710,694,5404
31063,Lauren,Yoselevitch,lyoselevitchnt@ed.gov,Nurse Practicioner,6970,1059,8029
31245,Shalom,Couroy,scouroynz@newsvine.com,Payment Adjustment Coordinator,4011,552,4563
31168,Romy,Trowsdall,rtrowsdallo5@netlog.com,Civil Engineer,9797,702,10499
31373,Kamilah,Lissett,klissetto6@printfriendly.com,Help Desk Technician,4323,843,5166
31247,Abbie,Langton,alangtono9@upenn.edu,Sales Associate,2811,1573,4384
31687,Markos,Joisce,mjoisceoa@cafepress.com,Account Representative IV,8710,1592,10302
31476,Roger,MacLise,rmacliseoe@aol.com,VP Accounting,6119,710,6829
31398,Cynthy,Dowsett,cdowsettoh@nasa.gov,Analyst Programmer,7385,1721,9106
31728,Carmita,Prujean,cprujeanoj@youtube.com,Senior Financial Analyst,9017,1549,10566
31191,Sanderson,Healey,shealeyon@freewebs.com,Marketing Assistant,8065,462,8527
31803,Bil,Banfield,bbanfieldoo@freewebs.com,Staff Scientist,2169,537,2706
31666,Chlo,Wysome,cwysomeop@mail.ru,Assistant Professor,5351,1682,7033
31652,Basile,Chessell,bchessellor@altervista.org,VP Product Management,9371,1081,10452
31156,Natalina,Dybbe,ndybbeos@nymag.com,Desktop Support Technician,4094,1543,5637
31869,Ninon,Ranald,nranaldow@utexas.edu,Sales Representative,1822,1853,3675
31731,Orlan,Dadge,odadgep2@mayoclinic.com,Chief Design Engineer,1206,1536,2742
31188,Dorey,Schutze,dschutzep4@bbc.co.uk,Biostatistician I,2354,1085,3439
31419,Antony,Tomkinson,atomkinsonp5@merriam-webster.com,Chief Design Engineer,8120,1271,9391
31305,Ced,McGuggy,cmcguggyp6@newsvine.com,Product Engineer,3411,1168,4579
31499,Sean,Rosenshine,srosenshinep7@intel.com,Software Engineer IV,4487,770,5257
31325,Avery,Rust,arustpa@tinyurl.com,Executive Secretary,6084,1871,7955
31558,Rosmunda,McEachern,rmceachernpc@nymag.com,Recruiting Manager,1326,808,2134
31087,Sarina,Winslade,swinsladepd@si.edu,Accountant IV,2642,1611,4253
31539,Mireille,Kilcoyne,mkilcoynepi@biglobe.ne.jp,Human Resources Assistant IV,6408,1969,8377
31831,Birdie,Eplate,beplatepn@behance.net,VP Marketing,2594,551,3145
31137,Krissie,Sherar,ksherarpu@tamu.edu,Web Developer I,2806,1888,4694
31158,Clifford,Hadkins,chadkinspv@youtube.com,Account Executive,4413,1160,5573
31202,Tessi,Gethyn,tgethynpy@un.org,Graphic Designer,7353,629,7982
31939,Humphrey,Gilfether,hgilfetherq1@barnesandnoble.com,Staff Accountant III,8495,678,9173
31513,Zebedee,Paintain,zpaintainq5@arizona.edu,Project Manager,4850,1680,6530
31103,Kipp,Castagnier,kcastagnierq7@ebay.com,Structural Analysis Engineer,5301,798,6099
31603,Abbey,Writtle,awrittleqb@qq.com,Office Assistant III,4325,1593,5918
31110,Maybelle,Astley,mastleyqd@sakura.ne.jp,Accounting Assistant IV,7701,1920,9621
31241,Yard,Lehrian,ylehrianqg@ebay.co.uk,Office Assistant I,5827,348,6175
31795,Barbara-anne,Nares,bnaresqn@woothemes.com,Mechanical Systems Engineer,9661,1715,11376
31579,Cherlyn,Yorke,cyorkequ@sitemeter.com,Environmental Tech,8725,399,9124
31856,Lucita,Muzzlewhite,lmuzzlewhiteqw@seattletimes.com,Speech Pathologist,5742,807,6549
31819,Edee,Anglin,eanglinqy@dmoz.org,Developer I,1144,1872,3016
31126,Cullen,McLewd,cmclewdqz@xinhuanet.com,Geological Engineer,8806,1253,10059
31187,Karlee,Etter,ketterr1@theguardian.com,Project Manager,6727,1678,8405
31422,Timoteo,Buie,tbuier2@npr.org,Biostatistician II,3631,575,4206
31910,Ruth,Pedrick,rpedrickr3@discuz.net,Nurse,9256,1188,10444
31160,Trevar,Stilgo,tstilgor6@apple.com,Account Executive,1746,1733,3479
31963,Daria,Pidgeley,dpidgeleyr8@examiner.com,Nuclear Power Engineer,1049,1649,2698
31381,Danella,Ashpital,dashpitalr9@nifty.com,Structural Analysis Engineer,9819,1505,11324
31761,Stefan,Slimm,sslimmra@imageshack.us,Account Executive,3464,541,4005
31684,Casey,Caudray,ccaudrayre@amazonaws.com,Office Assistant III,5141,1873,7014
31783,Yance,Glave,yglaverf@spotify.com,Quality Control Specialist,5908,462,6370
31467,Vanessa,Noddle,vnoddlerj@weather.com,Senior Sales Associate,7475,1461,8936
31853,Marnie,Lodden,mloddenrk@scribd.com,Desktop Support Technician,5375,1134,6509
31138,Chloe,Crolly,ccrollyrm@businessinsider.com,Database Administrator III,9102,1212,10314
31015,Emmaline,Kiera,ekierarn@huffingtonpost.com,Office Assistant II,4287,910,5197
31234,Rance,Gurrado,rgurradoro@pcworld.com,Structural Analysis Engineer,1597,1899,3496
32016,Harlene,Ousby,housby0@desdev.cn,Programmer Analyst II,2643,813,3456
32924,Kiel,Cassley,kcassley1@jigsy.com,Structural Analysis Engineer,5370,1360,6730
32048,Emyle,Furniss,efurniss2@columbia.edu,Internal Auditor,8255,244,8499
32802,Emma,Wattins,ewattins3@springer.com,Automation Specialist IV,1617,337,1954
32615,Norrie,McCambrois,nmccambrois4@qq.com,Nuclear Power Engineer,7583,1086,8669
32921,Neile,Diben,ndiben5@example.com,GIS Technical Architect,8879,945,9824
32306,Jemimah,Derr,jderr6@wordpress.org,Desktop Support Technician,1377,1068,2445
32038,Hadley,Lawler,hlawler7@bluehost.com,Electrical Engineer,4086,263,4349
32101,Adrian,Reinard,areinard8@phpbb.com,Civil Engineer,4355,216,4571
32288,Cletis,Lowe,clowe9@accuweather.com,Tax Accountant,1536,710,2246
32696,Carlin,Elmhirst,celmhirsta@google.fr,Safety Technician III,5559,1399,6958
32087,Gustavo,Billitteri,gbillitterib@soundcloud.com,Environmental Specialist,7416,926,8342
32782,Emlen,Gale,egalec@nifty.com,Account Representative IV,2251,248,2499
32678,Hyacinth,Ahearne,hahearned@yahoo.co.jp,Graphic Designer,1103,1228,2331
32012,Reid,Caldecott,rcaldecotte@nature.com,Research Nurse,6607,1618,8225
32917,Dennie,Hawker,dhawkerf@a8.net,Accounting Assistant I,8316,672,8988
32508,Wylie,Caban,wcabang@symantec.com,Administrative Officer,8422,1082,9504
32410,Alard,Gifford,agiffordh@marketwatch.com,Community Outreach Specialist,6715,1803,8518
32435,Maurizio,Norval,mnorvali@nature.com,General Manager,6117,604,6721
32979,Christean,Cushion,ccushionj@yellowbook.com,Software Test Engineer II,6085,1636,7721
32593,Dimitri,Gloyens,dgloyensk@hud.gov,Senior Developer,1830,941,2771
32122,Hedwiga,Gierth,hgierthl@technorati.com,Social Worker,5738,1224,6962
32216,Deirdre,O'Codihie,docodihiem@etsy.com,Programmer II,4843,1758,6601
32002,Ambrosi,Saterweyte,asaterweyten@chron.com,GIS Technical Architect,2299,554,2853
32274,Stearn,Langfitt,slangfitto@google.co.uk,VP Marketing,5856,1213,7069
32725,Nydia,Ruse,nrusep@flavors.me,General Manager,4176,680,4856
32366,Micky,McManamon,mmcmanamonq@stumbleupon.com,Human Resources Manager,2877,1842,4719
32729,Kayle,Eisig,keisigr@webmd.com,Business Systems Development Analyst,3779,1132,4911
32971,Giustino,Warlow,gwarlows@webmd.com,Payment Adjustment Coordinator,6015,731,6746
32745,Karalynn,Faulks,kfaulkst@telegraph.co.uk,Systems Administrator II,8457,648,9105
32744,Ronda,Luckcock,rluckcocku@dyndns.org,Graphic Designer,1334,677,2011
32639,Cody,Elcox,celcoxv@yellowpages.com,Social Worker,7808,539,8347
32075,Forest,Meeus,fmeeusw@deliciousdays.com,Software Test Engineer III,2373,517,2890
32946,Cyndy,Ranby,cranbyx@infoseek.co.jp,Actuary,1197,703,1900
32260,Rosamond,Nigh,rnighy@toplist.cz,Graphic Designer,9326,841,10167
32284,Jolene,Donavan,jdonavanz@bizjournals.com,Product Engineer,6395,348,6743
32132,Janeva,Awde,jawde10@rakuten.co.jp,Database Administrator I,4395,1419,5814
32905,Clay,Banat,cbanat11@businesswire.com,Librarian,8277,955,9232
32728,Brana,Drewett,bdrewett12@mapquest.com,VP Accounting,2124,1685,3809
32149,Talia,Steagall,tsteagall13@howstuffworks.com,Director of Sales,1928,1145,3073
32885,Chrissy,Kubis,ckubis14@ovh.net,Engineer I,4434,1194,5628
32960,Kimberlee,Feenan,kfeenan15@spiegel.de,Structural Engineer,6361,1620,7981
32080,Leupold,Millom,lmillom16@dagondesign.com,Software Consultant,7683,1425,9108
32945,Horatius,Finlayson,hfinlayson17@omniture.com,Account Executive,5257,601,5858
32489,Fonz,Shearstone,fshearstone18@washington.edu,Geologist IV,7513,1487,9000
32877,Hobart,Moxted,hmoxted19@surveymonkey.com,Structural Engineer,8991,1634,10625
32227,Rivalee,Tween,rtween1a@washingtonpost.com,General Manager,4838,1832,6670
32603,Daile,Normanvill,dnormanvill1b@t.co,Senior Quality Engineer,5854,1945,7799
32273,Rance,Pumfrey,rpumfrey1c@wikia.com,Biostatistician IV,7350,1802,9152
32507,Sybila,O'Keenan,sokeenan1d@salon.com,Speech Pathologist,7780,1466,9246
32146,Alexis,Oylett,aoylett1e@hugedomains.com,Senior Cost Accountant,5738,950,6688
32126,Ginnifer,Cowcha,gcowcha1f@ustream.tv,Nuclear Power Engineer,8804,464,9268
32442,Kimble,Gwinnett,kgwinnett1g@seesaa.net,Senior Financial Analyst,3382,1115,4497
32007,Linette,Musico,lmusico1h@mashable.com,Assistant Media Planner,4746,356,5102
32838,Laetitia,Chester,lchester1j@bloglovin.com,Teacher,7795,560,8355
32242,Elsey,Eyam,eeyam1k@mac.com,Social Worker,8994,285,9279
32403,Turner,Di Bartolomeo,tdibartolomeo1l@ehow.com,Human Resources Assistant II,4146,1550,5696
32896,Anderea,Tiery,atiery1n@skype.com,VP Marketing,7952,1872,9824
32438,Gwendolen,Buckle,gbuckle1o@cmu.edu,Staff Accountant I,1678,780,2458
32605,Spenser,Aguirrezabal,saguirrezabal1p@simplemachines.org,Marketing Manager,2651,675,3326
32161,Daniella,Klagge,dklagge1q@unblog.fr,Assistant Professor,6866,709,7575
32798,Mile,Adamkiewicz,madamkiewicz1r@amazon.co.uk,Actuary,2329,962,3291
32932,Florida,Champagne,fchampagne1s@delicious.com,Statistician I,6267,856,7123
32314,Rollo,Glasspool,rglasspool1t@delicious.com,Occupational Therapist,9624,950,10574
32067,Carmelina,Kirby,ckirby1u@dot.gov,VP Quality Control,6927,851,7778
32003,Whitby,Tait,wtait1v@nydailynews.com,Actuary,4449,1536,5985
32147,Nat,Cummings,ncummings1w@delicious.com,Account Representative II,5743,530,6273
32554,Caritta,Parrish,cparrish1y@geocities.com,VP Quality Control,4789,464,5253
32491,Jerrome,Hiddy,jhiddy1z@a8.net,Biostatistician IV,7347,739,8086
32792,Gasper,Heber,gheber20@google.com,Analyst Programmer,2199,1452,3651
32455,Deeanne,Jiricka,djiricka21@lycos.com,Programmer II,5422,1590,7012
32713,Jeana,Fantin,jfantin22@hao123.com,General Manager,5947,385,6332
32265,Cory,Anthonsen,canthonsen24@unicef.org,Media Manager III,7188,375,7563
32864,Roley,Clampton,rclampton25@phoca.cz,Financial Advisor,9326,1004,10330
32177,Sara-ann,Deakins,sdeakins26@va.gov,Executive Secretary,4906,394,5300
32718,Hyacinthe,Biggin,hbiggin27@blogger.com,Design Engineer,4811,238,5049
32071,Damien,Evered,devered28@wunderground.com,Clinical Specialist,4399,536,4935
32881,Damon,Ricart,dricart29@twitter.com,Senior Sales Associate,1322,809,2131
32267,Guinevere,Bosse,gbosse2a@technorati.com,Human Resources Manager,4802,1984,6786
32460,Ruprecht,Mounfield,rmounfield2c@blogspot.com,Tax Accountant,7458,1143,8601
32434,Zacherie,Impey,zimpey2d@ox.ac.uk,Graphic Designer,8030,475,8505
32947,Filberte,Antoniat,fantoniat2e@etsy.com,Financial Advisor,8385,534,8919
32029,Mag,Van Waadenburg,mvanwaadenburg2f@sohu.com,Business Systems Development Analyst,6482,1954,8436
32991,Egor,Dulin,edulin2g@indiatimes.com,VP Product Management,9879,1099,10978
32642,Kare,Bettridge,kbettridge2i@amazon.co.jp,Geologist IV,3517,772,4289
32553,Nada,Elford,nelford2j@friendfeed.com,Senior Developer,6055,816,6871
32201,Sabine,Webling,swebling2l@google.com.br,Marketing Assistant,6562,831,7393
32160,Tirrell,Poytheras,tpoytheras2n@xing.com,Developer I,7863,893,8756
32106,Mirabel,Rubinovitsch,mrubinovitsch2o@unblog.fr,Pharmacist,4661,1939,6600
32447,Lenka,Emor,lemor2q@ycombinator.com,Registered Nurse,6544,1881,8425
32348,Hope,Lafee,hlafee2r@comsenz.com,Computer Systems Analyst IV,1372,279,1651
32178,Mamie,Atyeo,matyeo2s@opera.com,Account Coordinator,2755,215,2970
32683,Jamil,Loveguard,jloveguard2t@spiegel.de,Computer Systems Analyst IV,7807,1556,9363
32870,Rubie,Blakelock,rblakelock2u@merriam-webster.com,Civil Engineer,4374,472,4846
32116,Gilli,McKeown,gmckeown2v@reference.com,Payment Adjustment Coordinator,5533,1558,7091
32480,Jehanna,Hatcher,jhatcher2w@seesaa.net,Structural Analysis Engineer,5131,263,5394
32041,Sallyann,Keat,skeat2x@homestead.com,Internal Auditor,1264,932,2196
32517,Jud,Stonman,jstonman2z@photobucket.com,Staff Scientist,3737,791,4528
32018,Shaina,Laidlaw,slaidlaw30@ox.ac.uk,Cost Accountant,6675,249,6924
32995,Bev,Scougal,bscougal31@1und1.de,Nuclear Power Engineer,4566,821,5387
32139,Larine,Salkeld,lsalkeld32@dion.ne.jp,Environmental Specialist,8180,1347,9527
32009,Darleen,Juares,djuares34@yellowbook.com,Pharmacist,8216,1428,9644
32498,Letty,Rallings,lrallings35@stumbleupon.com,Senior Developer,7446,814,8260
32541,Aldwin,Lockey,alockey36@ed.gov,Actuary,1948,1557,3505
32158,Koren,Muckloe,kmuckloe37@usatoday.com,Senior Developer,9647,485,10132
32952,Stacie,Pauncefoot,spauncefoot38@g.co,Structural Analysis Engineer,7001,1857,8858
32388,Kilian,Corby,kcorby39@behance.net,Financial Advisor,3475,1651,5126
32185,Ulla,Mushawe,umushawe3a@eventbrite.com,Computer Systems Analyst IV,5923,392,6315
32478,Tomasine,Kleinhausen,tkleinhausen3c@nhs.uk,Financial Advisor,3180,867,4047
32565,Bibi,Kiwitz,bkiwitz3d@so-net.ne.jp,Physical Therapy Assistant,4070,277,4347
32276,Coreen,Trippitt,ctrippitt3e@columbia.edu,Desktop Support Technician,5400,1975,7375
32588,Randy,Lawson,rlawson3f@artisteer.com,Project Manager,8363,655,9018
32207,Sherman,Newland,snewland3g@loc.gov,Assistant Manager,2563,685,3248
32856,Roshelle,Mellanby,rmellanby3h@merriam-webster.com,Web Developer IV,4947,1501,6448
32824,Galven,Whitemarsh,gwhitemarsh3i@nifty.com,Administrative Assistant IV,8860,1493,10353
32411,Nathan,Lodden,nlodden3j@pinterest.com,Computer Systems Analyst II,4581,1952,6533
32875,Simmonds,Bickerstasse,sbickerstasse3k@virginia.edu,Food Chemist,3640,1686,5326
32641,Ingelbert,Ivanyukov,iivanyukov3l@disqus.com,Database Administrator I,4373,1444,5817
32138,Trudey,Elms,telms3m@so-net.ne.jp,Sales Representative,4652,1088,5740
32739,Perry,Kasting,pkasting3n@mlb.com,Associate Professor,5867,1491,7358
32705,Daria,Vankeev,dvankeev3p@simplemachines.org,Business Systems Development Analyst,6792,976,7768
32844,Carrissa,Massel,cmassel3q@statcounter.com,Pharmacist,3627,477,4104
32378,Analiese,Follacaro,afollacaro3r@blog.com,Programmer IV,9941,1258,11199
32328,Claybourne,Golda,cgolda3s@blogs.com,Pharmacist,5955,1484,7439
32193,Vasili,Vedikhov,vvedikhov3u@buzzfeed.com,Dental Hygienist,8920,1646,10566
32019,Hedwig,Boult,hboult3v@zdnet.com,Technical Writer,8025,1415,9440
32059,Rita,Binton,rbinton3w@pinterest.com,Web Developer III,7141,1903,9044
32285,Lauryn,Gatiss,lgatiss3x@wisc.edu,Cost Accountant,5462,1551,7013
32190,Shurwood,Battie,sbattie3z@blinklist.com,Professor,5751,1488,7239
32672,Reynolds,Killiam,rkilliam40@icq.com,Assistant Manager,8348,1370,9718
32040,Ripley,Grummitt,rgrummitt41@nyu.edu,Mechanical Systems Engineer,2992,230,3222
32118,Bryn,Reschke,breschke42@example.com,Chemical Engineer,2193,829,3022
32577,Eb,Blaze,eblaze43@youtu.be,Nurse,2289,1277,3566
32564,Lefty,Choak,lchoak44@privacy.gov.au,Accounting Assistant II,3074,1304,4378
32621,Dwayne,Llewelyn,dllewelyn45@virginia.edu,VP Product Management,5698,1151,6849
32622,Giralda,Hallut,ghallut46@netvibes.com,Professor,6991,1696,8687
32835,Wileen,Mealham,wmealham48@technorati.com,Environmental Specialist,2882,1165,4047
32576,Johnnie,De'Vere - Hunt,jdeverehunt49@auda.org.au,Technical Writer,9766,643,10409
32060,Robenia,Clench,rclench4a@cafepress.com,Automation Specialist IV,3461,563,4024
32532,Ulrike,Syphas,usyphas4b@archive.org,Human Resources Assistant III,1855,1595,3450
32334,Malia,Berzon,mberzon4c@shop-pro.jp,Product Engineer,3722,1853,5575
32424,Boot,Baptiste,bbaptiste4d@smugmug.com,Recruiter,5083,1294,6377
32368,Rose,Gonnet,rgonnet4e@freewebs.com,Teacher,9384,1004,10388
32822,Abbott,Baynon,abaynon4f@ocn.ne.jp,Media Manager III,1930,503,2433
32130,Bourke,Traice,btraice4h@sourceforge.net,Research Nurse,2378,1809,4187
32567,Cicely,Cochrane,ccochrane4i@google.ru,Health Coach IV,2418,330,2748
32226,Cosme,Seeley,cseeley4j@narod.ru,Payment Adjustment Coordinator,9280,1317,10597
32427,Thorn,Hartigan,thartigan4k@ovh.net,Analog Circuit Design manager,3320,1356,4676
32703,Amelie,Morewood,amorewood4l@youtu.be,Occupational Therapist,1660,1737,3397
32544,Rollie,Heighway,rheighway4m@google.nl,Recruiter,9569,865,10434
32848,Otha,Domone,odomone4o@icio.us,Occupational Therapist,8089,1961,10050
32266,Winslow,Readitt,wreaditt4p@discuz.net,Legal Assistant,9672,1343,11015
32474,Cathryn,Heald,cheald4q@nhs.uk,Assistant Media Planner,2290,477,2767
32077,Kevon,Short,kshort4r@goodreads.com,Statistician III,6103,1735,7838
32596,Ashlan,Itshak,aitshak4s@yandex.ru,Programmer Analyst III,8795,1356,10151
32704,Pauletta,Hammerberger,phammerberger4t@wikimedia.org,Accounting Assistant II,4692,1681,6373
32326,Abbie,Crossman,acrossman4u@ucoz.com,Compensation Analyst,3034,1509,4543
32367,Cos,Seide,cseide4w@adobe.com,Sales Representative,8199,408,8607
32254,Hakeem,Papierz,hpapierz4x@netvibes.com,Librarian,3400,1232,4632
32701,Sergeant,Ridwood,sridwood4y@reddit.com,Structural Engineer,5696,641,6337
32097,Sheryl,Bradnock,sbradnock50@google.ru,Registered Nurse,4326,1764,6090
32669,Corly,MacDearmid,cmacdearmid51@tripod.com,Pharmacist,6248,1487,7735
32419,Sibella,Zuker,szuker52@disqus.com,Analyst Programmer,1961,456,2417
32224,Hanni,Catonne,hcatonne53@archive.org,Accountant IV,3261,517,3778
32395,Kailey,Eccleston,keccleston54@themeforest.net,Biostatistician IV,3746,927,4673
32181,Bennie,Kennermann,bkennermann55@bbb.org,Editor,8351,1877,10228
32133,Glenn,Parradine,gparradine56@moonfruit.com,Software Test Engineer I,9553,793,10346
32108,Sophia,Pawelek,spawelek58@wikispaces.com,Director of Sales,7724,422,8146
32733,Leland,Coghlin,lcoghlin5a@techcrunch.com,Junior Executive,4736,1057,5793
32338,Xever,Cotmore,xcotmore5b@webmd.com,Data Coordiator,6569,1717,8286
32317,Myra,Minister,mminister5c@cafepress.com,Internal Auditor,5119,774,5893
32823,Eirena,Rubega,erubega5d@independent.co.uk,Product Engineer,3498,695,4193
32834,Matt,Bowton,mbowton5e@typepad.com,Health Coach II,6214,1906,8120
32685,Garald,Reddyhoff,greddyhoff5f@google.cn,Teacher,6373,625,6998
32303,Peadar,Penylton,ppenylton5h@google.pl,Project Manager,8638,877,9515
32272,Rennie,Cowan,rcowan5i@godaddy.com,Automation Specialist II,8036,1584,9620
32897,Thane,Village,tvillage5k@flavors.me,Recruiter,6258,1957,8215
32780,Robinetta,Dowling,rdowling5l@scientificamerican.com,Senior Sales Associate,3504,484,3988
32530,Liza,Beetham,lbeetham5m@businessinsider.com,Geologist II,3609,1100,4709
32228,Sheri,Shiels,sshiels5n@slate.com,Account Executive,5876,553,6429
32247,Flory,Leeuwerink,fleeuwerink5p@shutterfly.com,Software Test Engineer III,4097,1633,5730
32659,Brigitte,Wallington,bwallington5r@freewebs.com,Social Worker,3134,649,3783
32539,Hirsch,Weavill,hweavill5s@ameblo.jp,Design Engineer,6873,1932,8805
32786,Miriam,Curtin,mcurtin5t@nps.gov,Human Resources Manager,1840,1239,3079
32248,Fleur,Delf,fdelf5u@ebay.com,Programmer IV,9511,291,9802
32842,Timmi,Marrion,tmarrion5v@harvard.edu,Programmer II,3315,530,3845
32300,Debera,Reinhardt,dreinhardt5w@ameblo.jp,Nuclear Power Engineer,2336,1621,3957
32966,Gawain,Strivens,gstrivens5x@people.com.cn,Health Coach I,3019,862,3881
32691,Carolyn,Philipp,cphilipp5z@chronoengine.com,Developer IV,8146,739,8885
32663,Louise,Bruford,lbruford60@tuttocitta.it,Dental Hygienist,3421,469,3890
32987,Reginald,Bodleigh,rbodleigh62@newyorker.com,Software Test Engineer IV,8701,656,9357
32879,Orland,Hennington,ohennington63@xing.com,VP Accounting,4654,1124,5778
32044,Cam,Southey,csouthey64@ted.com,Payment Adjustment Coordinator,2165,1539,3704
32382,Tiphany,Filde,tfilde65@deviantart.com,Payment Adjustment Coordinator,9690,1920,11610
32182,Rebeka,Hazael,rhazael66@blogtalkradio.com,Project Manager,2634,1957,4591
32830,Myrna,Deme,mdeme67@intel.com,Account Coordinator,2522,1810,4332
32581,Juanita,Edmonstone,jedmonstone68@disqus.com,Human Resources Manager,9592,815,10407
32840,Cindee,Peakman,cpeakman69@goo.ne.jp,Executive Secretary,1046,1248,2294
32545,Amitie,Itshak,aitshak6a@seattletimes.com,Information Systems Manager,6303,974,7277
32264,Klaus,Walburn,kwalburn6b@house.gov,Help Desk Operator,5549,1367,6916
32271,Coop,Luscott,cluscott6c@stumbleupon.com,Business Systems Development Analyst,5517,546,6063
32305,Lauryn,Ridewood,lridewood6d@hostgator.com,Staff Accountant I,1849,1988,3837
32065,Kathye,Dwyr,kdwyr6e@cnn.com,Professor,6316,1349,7665
32104,Alleyn,Biskup,abiskup6f@1und1.de,Senior Developer,6947,339,7286
32559,Clementine,Khotler,ckhotler6g@t-online.de,Technical Writer,9795,663,10458
32020,Lanette,Ricciardello,lricciardello6h@tumblr.com,Chemical Engineer,6562,711,7273
32969,Hedi,Parfitt,hparfitt6i@intel.com,Senior Developer,2893,502,3395
32006,Aveline,Grabban,agrabban6j@bloomberg.com,Financial Advisor,3285,1715,5000
32776,Colline,Snoxell,csnoxell6k@thetimes.co.uk,VP Quality Control,5111,961,6072
32090,Birgitta,Lockery,blockery6l@census.gov,Computer Systems Analyst III,1106,1016,2122
32687,Issi,Bassano,ibassano6m@huffingtonpost.com,Financial Analyst,6542,1726,8268
32716,Suzanne,Capaldi,scapaldi6n@posterous.com,Software Consultant,1983,1834,3817
32450,Chelsae,Ouver,couver6o@altervista.org,Safety Technician I,6950,1393,8343
32389,Selby,Merle,smerle6p@fda.gov,Developer I,4190,1422,5612
32437,Marlin,Kiggel,mkiggel6q@nifty.com,Junior Executive,2309,1584,3893
32862,Nathalie,Dumberrill,ndumberrill6r@eventbrite.com,Occupational Therapist,6696,1914,8610
32210,Angy,Gasticke,agasticke6t@vk.com,VP Sales,9200,1993,11193
32221,Fields,Bather,fbather6v@hubpages.com,Senior Sales Associate,5698,1549,7247
32968,Ezri,Alison,ealison6w@meetup.com,Programmer Analyst II,9482,571,10053
32769,Jennette,Boylan,jboylan6x@rakuten.co.jp,Environmental Tech,4775,1278,6053
32058,Ruthe,Sherwin,rsherwin70@cargocollective.com,Business Systems Development Analyst,3117,1689,4806
32159,Jory,Shilburne,jshilburne74@over-blog.com,Programmer Analyst IV,8515,347,8862
32155,Elisabeth,Brugh,ebrugh75@nature.com,Environmental Tech,6523,568,7091
32942,Theodor,Gamlen,tgamlen76@wikia.com,GIS Technical Architect,5436,1355,6791
32523,Dallis,Philipet,dphilipet77@boston.com,Help Desk Technician,7001,1762,8763
32916,Thorvald,Inkles,tinkles79@globo.com,Research Nurse,2562,1071,3633
32534,Myrvyn,Gerriets,mgerriets7a@yahoo.co.jp,Environmental Specialist,1945,1978,3923
32036,Isiahi,Trenfield,itrenfield7b@sphinn.com,Sales Representative,7097,1899,8996
32583,Tomasine,Seaborn,tseaborn7c@businesswire.com,Automation Specialist II,8609,1033,9642
32556,Haydon,Peck,hpeck7d@xrea.com,Physical Therapy Assistant,8519,1577,10096
32406,Libbie,Ellicock,lellicock7e@narod.ru,Legal Assistant,3602,1258,4860
32509,Clay,Esh,cesh7f@marriott.com,Software Engineer II,8684,829,9513
32054,Adelheid,Savege,asavege7g@wordpress.com,Help Desk Technician,9953,489,10442
32360,Tandi,Theurer,ttheurer7h@foxnews.com,Statistician I,9705,1343,11048
32555,Barthel,Brunone,bbrunone7i@msu.edu,Structural Analysis Engineer,3377,748,4125
32925,Dara,Kupisz,dkupisz7j@prweb.com,Assistant Professor,1688,1476,3164
32165,Gage,Vasiljevic,gvasiljevic7m@engadget.com,Physical Therapy Assistant,2664,349,3013
32538,Correna,Burnand,cburnand7n@oracle.com,Associate Professor,5755,1477,7232
32057,Christy,Hartnell,chartnell7o@prweb.com,Senior Financial Analyst,8117,1504,9621
32699,Myron,Sone,msone7p@cloudflare.com,Software Engineer I,6802,811,7613
32746,Andriette,Posthill,aposthill7r@yahoo.com,Programmer III,9866,456,10322
32413,Vasilis,Chapier,vchapier7s@businessweek.com,Software Consultant,6130,938,7068
32051,Quill,Simanenko,qsimanenko7t@tiny.cc,Administrative Assistant I,5030,885,5915
32959,Gray,Nials,gnials7u@istockphoto.com,Programmer I,3082,892,3974
32774,Jehu,Caldero,jcaldero7y@jiathis.com,Chief Design Engineer,8426,555,8981
32379,Jamill,Mulrenan,jmulrenan7z@amazon.co.jp,Research Assistant III,4005,1931,5936
32131,Pietra,Trathan,ptrathan81@163.com,General Manager,5376,751,6127
32865,Cosetta,MacCallion,cmaccallion82@chronoengine.com,Web Designer III,4253,1452,5705
32457,Lynnell,Petrello,lpetrello83@mashable.com,Nuclear Power Engineer,3517,1965,5482
32860,Carlye,O'Gleasane,cogleasane84@hugedomains.com,Human Resources Assistant IV,1306,698,2004
32092,Ardelia,Cresser,acresser87@fotki.com,Electrical Engineer,1219,944,2163
32481,Lauretta,Airdrie,lairdrie88@blogspot.com,Help Desk Technician,8506,233,8739
32677,Charlean,Brompton,cbrompton89@noaa.gov,Editor,5693,1814,7507
32137,Raquela,Middiff,rmiddiff8b@addtoany.com,General Manager,1288,1205,2493
32636,Wyn,Papa,wpapa8c@slate.com,Speech Pathologist,5256,462,5718
32055,Pierre,Andrassy,pandrassy8e@adobe.com,Quality Control Specialist,1425,248,1673
32926,Dede,Hanham,dhanham8f@reference.com,Associate Professor,4842,237,5079
32771,Oralee,Broxap,obroxap8i@tumblr.com,Senior Developer,6512,543,7055
32422,Mirna,Foxten,mfoxten8j@youtu.be,Business Systems Development Analyst,3565,752,4317
32757,Arly,MacAne,amacane8k@exblog.jp,Software Engineer II,6657,342,6999
32095,Janene,Snazel,jsnazel8m@fc2.com,Occupational Therapist,6977,623,7600
32620,Rolph,Surman,rsurman8o@uiuc.edu,Technical Writer,2595,1595,4190
32174,Arielle,Goldup,agoldup8p@intel.com,Mechanical Systems Engineer,5924,312,6236
32445,Sharl,Spratt,sspratt8q@imageshack.us,Staff Scientist,3248,1973,5221
32033,Tallie,MacKeague,tmackeague8r@chronoengine.com,Help Desk Technician,4419,896,5315
32624,Julina,Geraudy,jgeraudy8s@gnu.org,Legal Assistant,6288,1288,7576
32726,Neel,Fernely,nfernely8u@bizjournals.com,Cost Accountant,9767,295,10062
32717,Flossy,Kubek,fkubek8v@nhs.uk,Chemical Engineer,6117,538,6655
32154,Vanna,McDonagh,vmcdonagh8w@feedburner.com,Environmental Specialist,1315,540,1855
32290,Martin,Kleimt,mkleimt8x@google.com.hk,VP Accounting,4695,1280,5975
32988,Britte,Keepe,bkeepe8y@un.org,Statistician IV,8502,1661,10163
32743,Forrester,Witcomb,fwitcomb8z@noaa.gov,Database Administrator I,5520,1936,7456
32028,Clair,Gowers,cgowers90@blogspot.com,Systems Administrator III,1251,844,2095
32072,Vyky,Sweetlove,vsweetlove92@sogou.com,Quality Control Specialist,3605,999,4604
32985,Shaun,Riddock,sriddock95@newsvine.com,Civil Engineer,7991,505,8496
32085,Karil,Davsley,kdavsley96@csmonitor.com,Nurse Practicioner,2634,1620,4254
32431,Nicolina,MacCarlich,nmaccarlich97@icio.us,Geologist IV,3551,1682,5233
32373,Hillel,Wigley,hwigley98@intel.com,Statistician IV,4061,1855,5916
32363,Richard,Jeffray,rjeffray99@meetup.com,Nuclear Power Engineer,9776,1994,11770
32943,Lesley,Stockoe,lstockoe9a@mapquest.com,Media Manager IV,2948,1777,4725
32614,Fayre,Lies,flies9h@dropbox.com,Executive Secretary,1399,1151,2550
32005,Carlita,Boole,cboole9j@usatoday.com,Data Coordiator,8571,631,9202
32280,Dall,Learmond,dlearmond9k@feedburner.com,Quality Engineer,1109,1536,2645
32730,Kassie,Forsdike,kforsdike9m@biblegateway.com,Senior Developer,5717,1173,6890
32315,Gardener,Copplestone,gcopplestone9n@bbc.co.uk,Computer Systems Analyst III,4973,1498,6471
32110,Jenny,Tudhope,jtudhope9r@g.co,Social Worker,5553,1142,6695
32157,Ole,Staunton,ostaunton9t@google.fr,VP Accounting,3706,1415,5121
32336,Ingrid,Stollenwerck,istollenwerck9w@youtube.com,Software Test Engineer I,8154,415,8569
32797,Veronica,Kearford,vkearford9y@sitemeter.com,Junior Executive,1002,1895,2897
32661,Seumas,Mellon,smellona0@noaa.gov,Technical Writer,3267,772,4039
32754,Laverne,Burrel,lburrela2@thetimes.co.uk,Assistant Manager,6278,1363,7641
32978,Bary,Hares,bharesa4@geocities.com,Chemical Engineer,6354,255,6609
32525,Wilbert,Lilywhite,wlilywhitea7@amazon.de,Data Coordiator,1280,377,1657
32343,Abra,Kerton,akertona8@chicagotribune.com,Nuclear Power Engineer,7955,1615,9570
32721,Rriocard,Donnell,rdonnellaa@bravesites.com,Account Executive,7584,1965,9549
32192,Olly,Costa,ocostaab@tripadvisor.com,Payment Adjustment Coordinator,7783,1777,9560
32091,Ethe,Jedrasik,ejedrasikad@hugedomains.com,Structural Analysis Engineer,7866,1870,9736
32318,Zebadiah,Broscombe,zbroscombeaf@prweb.com,Budget/Accounting Analyst II,9909,758,10667
32645,Town,Linden,tlindenag@webs.com,Software Engineer IV,1294,1354,2648
32321,Marcellina,Faiers,mfaiersaj@angelfire.com,Community Outreach Specialist,2894,246,3140
32655,Roxanna,Romera,rromeraal@icq.com,Research Associate,6944,245,7189
32804,Austin,Bonnell,abonnellam@ebay.com,Systems Administrator IV,1947,834,2781
32465,Cariotta,Full,cfullap@xinhuanet.com,Statistician III,2109,560,2669
32129,Randell,Britch,rbritchaq@printfriendly.com,Payment Adjustment Coordinator,4646,426,5072
32735,Owen,Cambridge,ocambridgear@hibu.com,Desktop Support Technician,3173,1425,4598
32070,Floris,Donlon,fdonlonas@live.com,Biostatistician I,9923,895,10818
32944,Quintana,Woofenden,qwoofendenat@businessweek.com,Senior Editor,3471,647,4118
32667,Murray,Neate,mneateaw@deliciousdays.com,Food Chemist,5653,1817,7470
32400,Anders,Curton,acurtonay@squidoo.com,Geologist I,5716,1805,7521
32962,Rosina,Holwell,rholwellb0@cargocollective.com,Speech Pathologist,1086,440,1526
32827,Melisent,Bischof,mbischofb2@state.tx.us,Structural Analysis Engineer,2892,208,3100
32524,Wilmer,Delacroux,wdelacrouxb3@qq.com,Statistician I,9644,1409,11053
32330,Alix,Oldham,aoldhamb4@1688.com,Electrical Engineer,2785,620,3405
32402,Jenna,Matiewe,jmatieweb5@cargocollective.com,Budget/Accounting Analyst II,6969,592,7561
32056,Geordie,Belison,gbelisonb6@cdc.gov,Physical Therapy Assistant,6109,686,6795
32638,Hunt,Brennon,hbrennonb8@phpbb.com,Sales Representative,8936,506,9442
32050,Alessandro,Vinick,avinickbb@prlog.org,Food Chemist,6394,821,7215
32500,Madelle,Tombling,mtomblingbc@1und1.de,Actuary,7333,1435,8768
32217,Iosep,Fowlston,ifowlstonbd@businessinsider.com,Computer Systems Analyst III,5642,1325,6967
32111,Elwood,Fidian,efidianbe@gizmodo.com,VP Sales,9397,1316,10713
32042,Sissy,Tabard,stabardbi@merriam-webster.com,Office Assistant II,3960,1074,5034
32682,Eleanor,Cuttings,ecuttingsbk@ocn.ne.jp,Senior Cost Accountant,2151,795,2946
32601,Clarabelle,Melonby,cmelonbybm@printfriendly.com,Analog Circuit Design manager,6092,1716,7808
32708,Bernice,Bwye,bbwyebo@yale.edu,Social Worker,3835,1638,5473
32385,Upton,Turmel,uturmelbp@cnbc.com,Engineer I,8420,1239,9659
32037,Savina,McQuillan,smcquillanbq@eventbrite.com,Staff Accountant IV,7291,1256,8547
32582,Lynde,Reinger,lreingerbr@walmart.com,Director of Sales,6714,1690,8404
32499,Idell,MacCourt,imaccourtbt@ameblo.jp,Senior Quality Engineer,1724,1306,3030
32586,Dean,Blowen,dblowenbu@ted.com,Safety Technician I,7751,638,8389
32299,Pete,Parsonage,pparsonagebw@state.gov,Nuclear Power Engineer,2418,1657,4075
32369,Abagael,Szwandt,aszwandtbx@quantcast.com,Senior Sales Associate,7763,1769,9532
32980,Anthiathia,Pestricke,apestrickeby@parallels.com,Business Systems Development Analyst,7873,548,8421
32345,Jerrie,Dreier,jdreierc1@walmart.com,Biostatistician III,8175,742,8917
32143,Friedrick,Emsley,femsleyc2@bloglines.com,Senior Quality Engineer,2409,925,3334
32961,Timmy,Kruse,tkrusec4@economist.com,Account Coordinator,6832,210,7042
32871,Mendie,Woodroofe,mwoodroofec6@storify.com,Structural Engineer,6500,1481,7981
32629,Cymbre,Georg,cgeorgc7@nsw.gov.au,Compensation Analyst,2314,1236,3550
32957,Dela,Yexley,dyexleyc8@gravatar.com,Marketing Manager,7529,327,7856
32805,Chico,Don,cdonc9@un.org,Graphic Designer,6589,1601,8190
32477,Deidre,Gotecliffe,dgotecliffecc@photobucket.com,Quality Control Specialist,7738,405,8143
32698,Ingemar,Wanstall,iwanstallce@scribd.com,Senior Financial Analyst,8358,1484,9842
32441,Cissiee,Rhymer,crhymercg@blogspot.com,Media Manager I,5610,303,5913
32684,Maurine,Hoyte,mhoytech@paypal.com,Help Desk Operator,7677,1111,8788
32955,Bennett,Querree,bquerreeci@cnbc.com,Nuclear Power Engineer,4387,682,5069
32560,Pippa,Mapledoore,pmapledoorecj@nifty.com,Senior Financial Analyst,2472,578,3050
32466,Corny,Timlin,ctimlinck@163.com,Cost Accountant,6694,1708,8402
32665,Mitchel,Nortcliffe,mnortcliffecl@google.fr,Senior Developer,2571,1568,4139
32914,Maggee,Bedminster,mbedminstercm@zimbio.com,Systems Administrator III,6400,1093,7493
32888,Essy,Corteis,ecorteisco@imageshack.us,Engineer IV,8304,442,8746
32550,Lilas,Ziemecki,lziemeckicp@imageshack.us,Electrical Engineer,8066,1882,9948
32461,Kaylee,Crus,kcruscr@gnu.org,VP Product Management,4758,441,5199
32074,Sean,Natte,snattect@sciencedaily.com,Automation Specialist IV,3118,670,3788
32657,Tobiah,Lestor,tlestorcy@uol.com.br,VP Quality Control,2818,1396,4214
32332,Ossie,Redding,oreddingcz@seesaa.net,Accounting Assistant II,2604,1341,3945
32882,Shae,Pach,spachd1@google.de,Geologist III,6062,1940,8002
32954,Arni,Hamments,ahammentsd2@baidu.com,Geologist I,3412,1567,4979
32572,Lindie,Matijevic,lmatijevicd7@addtoany.com,Senior Financial Analyst,1750,865,2615
32515,Ashlan,Hussell,ahusselld8@1und1.de,Account Representative III,5931,1696,7627
32552,Gerhard,Horche,ghorched9@columbia.edu,Financial Advisor,1032,1863,2895
32832,Byrom,Southorn,bsouthornda@flickr.com,Business Systems Development Analyst,6209,1264,7473
32580,Jania,Spraberry,jspraberrydb@about.com,Legal Assistant,1492,1097,2589
32894,Trever,Mulligan,tmulligandc@taobao.com,Research Associate,2119,820,2939
32082,Audy,Blackaller,ablackallerde@admin.ch,Senior Financial Analyst,6899,254,7153
32472,Tressa,Fishley,tfishleydg@ibm.com,Environmental Tech,3395,1005,4400
32893,Hansiain,Escreet,hescreetdi@163.com,Software Engineer II,9635,732,10367
32867,Saudra,Tipling,stiplingdk@virginia.edu,Media Manager III,4798,1677,6475
32208,Glen,Gummie,ggummiedl@lulu.com,Paralegal,3547,1476,5023
32230,Tremain,Strivens,tstrivensdn@ihg.com,Information Systems Manager,5446,258,5704
32015,Corbett,Clausner,cclausnerdp@smh.com.au,Research Associate,8722,292,9014
32837,Evaleen,Bennis,ebennisdu@themeforest.net,Systems Administrator III,9999,800,10799
32376,Phyllis,Pinsent,ppinsentdv@tripod.com,Senior Quality Engineer,9058,1494,10552
32206,Ranice,Moulsdale,rmoulsdaledy@t.co,Compensation Analyst,7538,243,7781
32365,Di,Furber,dfurberdz@photobucket.com,Paralegal,8701,1812,10513
32263,Meyer,Dyche,mdychee0@gizmodo.com,Nurse Practicioner,7326,1946,9272
32232,Lesly,Kyffin,lkyffine1@moonfruit.com,Sales Representative,1960,619,2579
32484,Dewey,Hamelyn,dhamelyne4@ft.com,Account Representative III,1155,1308,2463
32551,Ronnica,Somerlie,rsomerliee6@flickr.com,Environmental Specialist,9010,663,9673
32547,Celestina,Arderne,cardernee8@nih.gov,Teacher,7227,380,7607
32451,Sallee,Dealtry,sdealtryea@g.co,Product Engineer,2600,1979,4579
32611,Binky,Yablsley,byablsleyec@instagram.com,Programmer Analyst III,8460,1456,9916
32134,Catlaina,Aysik,caysikee@privacy.gov.au,Recruiter,6276,481,6757
32963,Ainslie,Buckeridge,abuckeridgeef@walmart.com,VP Marketing,4929,1909,6838
32536,Hartley,Kibbey,hkibbeyeg@trellian.com,Staff Accountant IV,2585,1346,3931
32913,Miranda,Prop,mpropei@mysql.com,Software Test Engineer II,2327,810,3137
32787,Chicky,Gowthrop,cgowthropej@usnews.com,Geological Engineer,7727,1471,9198
32853,Freddy,Readitt,freadittel@scribd.com,General Manager,3384,1497,4881
32089,Sully,Agett,sagetten@tinyurl.com,Administrative Assistant I,1555,1367,2922
32542,Rosanne,Marfield,rmarfieldeo@hubpages.com,Systems Administrator III,4458,1006,5464
32637,Libbie,Neild,lneildep@japanpost.jp,Nuclear Power Engineer,1738,338,2076
32819,Devi,Wevell,dwevelleq@soup.io,Technical Writer,6844,853,7697
32412,Susanna,Biggam,sbiggamer@lycos.com,Actuary,6007,1554,7561
32847,Ches,Antonchik,cantonchikes@loc.gov,Office Assistant III,8241,1428,9669
32322,Dacia,Handslip,dhandslipev@linkedin.com,Software Consultant,8113,641,8754
32884,Konstantine,Mcasparan,kmcasparaney@netscape.com,Registered Nurse,7325,425,7750
32151,Aloysia,Mate,amatef0@google.fr,Research Assistant I,4309,645,4954
32355,Verena,Khoter,vkhoterf5@reference.com,Social Worker,4414,1467,5881
32487,Willie,Louthe,wlouthef8@addtoany.com,Senior Financial Analyst,4418,1449,5867
32069,Grantham,Killough,gkilloughf9@ow.ly,Mechanical Systems Engineer,1625,1631,3256
32983,Lizzy,Corson,lcorsonfb@cnn.com,Human Resources Manager,5008,1069,6077
32996,Harland,Gonzales,hgonzalesfd@fotki.com,Senior Developer,6167,1903,8070
32384,Alex,Issacov,aissacovfe@woothemes.com,Geologist I,6777,447,7224
32073,Kevina,Barwood,kbarwoodff@nsw.gov.au,Project Manager,4616,562,5178
32202,Lynnette,Wadworth,lwadworthfg@ehow.com,Civil Engineer,1366,1456,2822
32234,Malanie,Smyley,msmyleyfj@dailymail.co.uk,Environmental Tech,3871,807,4678
32312,Guinna,Allott,gallottfk@artisteer.com,Research Assistant I,7060,1935,8995
32522,Maris,Padmore,mpadmorefq@cyberchimps.com,Nurse,4058,1514,5572
32197,Gilbert,Beards,gbeardsfr@deviantart.com,Registered Nurse,7229,601,7830
32025,Winne,Hasell,whasellfs@joomla.org,Systems Administrator IV,9676,928,10604
32784,Darius,Buckmaster,dbuckmasterft@tripod.com,Web Designer III,3532,1387,4919
32592,Rock,MacCleay,rmaccleayfx@liveinternet.ru,Payment Adjustment Coordinator,2536,896,3432
32829,Edward,Burden,eburdenfy@soup.io,Cost Accountant,7827,1971,9798
32758,Salomone,Skeldon,sskeldonfz@columbia.edu,Financial Advisor,8031,1319,9350
32736,Kiersten,Victory,kvictoryg0@shutterfly.com,Internal Auditor,2959,1006,3965
32204,Prudi,Irnis,pirnisg1@pbs.org,Web Designer III,1999,1029,3028
32900,Thorndike,Vasyutochkin,tvasyutochking2@economist.com,Quality Engineer,3252,771,4023
32750,Amie,Stott,astottg3@imageshack.us,Mechanical Systems Engineer,9306,1279,10585
32899,Eddie,Criag,ecriagg5@un.org,Administrative Assistant II,1248,1085,2333
32394,Vere,Pocock,vpocockg6@mac.com,VP Marketing,7174,479,7653
32093,Cyndie,Cranstoun,ccranstoung7@bluehost.com,Teacher,6806,1805,8611
32562,Charla,Kerford,ckerfordg8@digg.com,Structural Engineer,4829,397,5226
32148,Milzie,Malek,mmalekg9@patch.com,Electrical Engineer,3409,1930,5339
32851,Homerus,Gillean,hgilleangb@patch.com,Software Engineer IV,2482,892,3374
32426,Joachim,Daughtrey,jdaughtreygc@wufoo.com,GIS Technical Architect,7235,905,8140
32281,Leesa,Garfath,lgarfathgd@networksolutions.com,Quality Engineer,5670,1968,7638
32293,Madison,Partkya,mpartkyagh@csmonitor.com,Librarian,1956,1387,3343
32213,Paulie,Eymer,peymergi@cyberchimps.com,Environmental Specialist,6559,1480,8039
32068,Skye,Spacy,sspacygl@woothemes.com,Graphic Designer,9767,355,10122
32475,Natalie,Spieght,nspieghtgm@freewebs.com,Environmental Specialist,6723,1040,7763
32316,Jackqueline,Doumic,jdoumicgn@chron.com,Programmer III,3171,1307,4478
32261,Natalina,Pyzer,npyzergo@php.net,Technical Writer,1375,1097,2472
32386,Land,Jossum,ljossumgr@ning.com,VP Marketing,6733,1599,8332
32383,Bastian,Craine,bcrainegs@scribd.com,Health Coach IV,9744,313,10057
32868,Rolf,Dedam,rdedamgt@slideshare.net,Nurse Practicioner,2432,1387,3819
32209,Ivonne,Fowlston,ifowlstongu@mapquest.com,Senior Developer,4837,709,5546
32308,Rowney,Bartomieu,rbartomieugw@addtoany.com,Junior Executive,6907,1632,8539
32631,Ingunna,Buist,ibuistgz@yale.edu,Financial Advisor,7272,642,7914
32490,Cloe,Ratray,cratrayh1@amazon.co.jp,Occupational Therapist,5198,515,5713
32821,Ruy,Walster,rwalsterh4@time.com,Recruiter,3334,559,3893
32915,Charlot,Anyon,canyonhb@stumbleupon.com,Associate Professor,9614,202,9816
32268,Beverie,Arnison,barnisonhd@state.gov,Environmental Tech,4683,1673,6356
32353,Joly,Lambe,jlambehe@cnn.com,Senior Quality Engineer,3464,835,4299
32337,Bernardine,Langlais,blanglaishg@newsvine.com,Help Desk Operator,7223,1011,8234
32731,Roscoe,Vicioso,rviciosohi@google.com.au,Sales Associate,2027,557,2584
32045,Catharina,Kisbee,ckisbeehj@state.tx.us,Tax Accountant,9643,902,10545
32670,Swen,Mehmet,smehmethk@pen.io,Librarian,4053,768,4821
32876,Sibby,Chappell,schappellhm@virginia.edu,Recruiting Manager,3816,268,4084
32156,Gustaf,Mushett,gmushetthn@so-net.ne.jp,Marketing Assistant,4945,996,5941
32397,Willi,Mitro,wmitroho@engadget.com,Product Engineer,5103,1889,6992
32813,Pen,Cockerton,pcockertonhp@mayoclinic.com,Staff Accountant III,4551,370,4921
32211,Payton,Pucker,ppuckerhq@ebay.co.uk,Geological Engineer,9013,1277,10290
32034,Mallory,Coultard,mcoultardhs@fda.gov,Chemical Engineer,7733,653,8386
32375,Barty,Hoyt,bhoytht@reverbnation.com,Physical Therapy Assistant,9032,624,9656
32521,Therine,Adshad,tadshadhu@nydailynews.com,Senior Financial Analyst,9057,1863,10920
32889,Alford,Chevolleau,achevolleauhz@unicef.org,Automation Specialist IV,3111,1845,4956
32377,Ethe,Sawl,esawli0@mozilla.org,Administrative Officer,2874,1659,4533
32289,Janean,Gronw,jgronwi1@friendfeed.com,Associate Professor,4277,1128,5405
32852,Aile,Prevost,aprevosti4@google.cn,Help Desk Technician,2925,1359,4284
32231,Rolfe,Payze,rpayzei5@cbslocal.com,Budget/Accounting Analyst IV,6090,549,6639
32107,Anastasia,Bladon,abladoni6@yelp.com,Statistician II,2116,1684,3800
32948,Frederick,Bramhall,fbramhalli7@webs.com,Database Administrator III,6979,1160,8139
32200,Tymon,Limmer,tlimmeri9@lulu.com,VP Accounting,9265,231,9496
32333,Corinne,Gammill,cgammillia@eepurl.com,General Manager,6801,1776,8577
32656,Rosalyn,Santon,rsantonic@cargocollective.com,Computer Systems Analyst II,5227,1751,6978
32064,Teresina,Otterwell,totterwellie@newsvine.com,Budget/Accounting Analyst III,8653,1510,10163
32654,Kally,O'Shavlan,koshavlanif@berkeley.edu,Financial Advisor,5466,1482,6948
32123,Daniella,Roma,dromaig@businessweek.com,Help Desk Operator,6236,391,6627
32612,Avril,Tallent,atallentii@admin.ch,Senior Editor,1423,1119,2542
32974,Lonni,Tripe,ltripeij@constantcontact.com,Legal Assistant,1211,341,1552
32767,Dottie,Thundercliffe,dthundercliffeik@goo.gl,Professor,8397,1056,9453
32467,Else,Cadreman,ecadremanim@wp.com,Registered Nurse,1303,1544,2847
32278,Bliss,MacGeffen,bmacgeffenin@illinois.edu,Professor,8056,1711,9767
32857,Bernard,Ambrus,bambrusio@reverbnation.com,Research Nurse,6726,977,7703
32381,Marcela,Knapp,mknappiq@aol.com,Quality Control Specialist,2077,1359,3436
32967,Debby,Hatley,dhatleyir@booking.com,Account Executive,4295,943,5238
32512,Martguerita,Cammis,mcammisit@tmall.com,Compensation Analyst,6503,508,7011
32358,Ransell,Gerok,rgerokiw@ask.com,Account Coordinator,4103,212,4315
32770,Dominic,Hargerie,dhargerieix@constantcontact.com,Database Administrator II,3046,883,3929
32096,Orlando,Depke,odepkeiz@tinyurl.com,Food Chemist,9926,1324,11250
32167,Gal,Pauler,gpaulerj1@ted.com,Accountant III,8015,1645,9660
32895,Dorene,Hanmore,dhanmorej9@hibu.com,Office Assistant II,9793,221,10014
32866,Bibi,Illston,billstonja@msu.edu,Help Desk Technician,7931,551,8482
32393,Caryn,Moseley,cmoseleyjb@vkontakte.ru,Environmental Specialist,5138,1996,7134
32469,Graham,Lonsdale,glonsdalejc@creativecommons.org,Human Resources Assistant IV,1764,1772,3536
32999,Nickolai,Hunnywell,nhunnywelljd@phoca.cz,Administrative Assistant II,4031,1797,5828
32673,Darrick,May,dmayji@amazon.com,Cost Accountant,2711,585,3296
32142,Angy,MacLleese,amaclleesejl@stumbleupon.com,Information Systems Manager,5974,889,6863
32775,Micaela,Greensitt,mgreensittjm@usgs.gov,Tax Accountant,7720,1308,9028
32214,Andeee,Camolli,acamollijn@sciencedaily.com,Analyst Programmer,8082,1303,9385
32589,Igor,Bellwood,ibellwoodjo@barnesandnoble.com,Assistant Manager,5779,1902,7681
32194,Bancroft,Bartolini,bbartolinijq@usgs.gov,Paralegal,6476,1561,8037
32329,Eldin,Lowen,elowenjr@youku.com,Executive Secretary,6690,401,7091
32880,Sam,Bustard,sbustardjs@shinystat.com,Registered Nurse,4524,1696,6220
32635,Agnesse,Gossan,agossanjw@quantcast.com,Information Systems Manager,3199,991,4190
32584,Karlik,Garman,kgarmanjy@devhub.com,Developer I,3587,307,3894
32344,Marsha,Garralts,mgarraltsk1@craigslist.org,Help Desk Technician,9771,928,10699
32449,Rosie,Tomaskunas,rtomaskunask3@addtoany.com,Nurse,1832,409,2241
32891,Rosette,Ridel,rridelk4@php.net,VP Quality Control,9383,1545,10928
32286,Desdemona,McGeaney,dmcgeaneyk9@blog.com,Design Engineer,7469,1193,8662
32997,Alard,Tripe,atripekd@seesaa.net,Junior Executive,4343,1631,5974
32188,Karine,Ellingford,kellingfordke@upenn.edu,Tax Accountant,2082,802,2884
32709,Mair,Santo,msantokg@wunderground.com,Senior Sales Associate,2006,489,2495
32773,Blinni,Pickle,bpicklekh@japanpost.jp,Editor,3580,1195,4775
32010,Akim,Fellowes,afelloweskj@techcrunch.com,Nuclear Power Engineer,5013,1023,6036
32950,Perice,Goosey,pgooseykk@oaic.gov.au,Research Assistant II,3930,1206,5136
32937,Ameline,Hampton,ahamptonkl@naver.com,Web Developer II,9892,1677,11569
32633,Eulalie,Izard,eizardko@amazonaws.com,Software Consultant,5126,1989,7115
32692,Mikkel,Fayers,mfayerskp@blogspot.com,Administrative Officer,6774,1696,8470
32981,Olva,Bremner,obremnerkq@bloomberg.com,Web Developer III,6348,570,6918
32052,Kalle,Speechly,kspeechlykr@house.gov,Payment Adjustment Coordinator,3709,1988,5697
32766,Jecho,Westerman,jwestermankv@linkedin.com,Research Assistant IV,9500,1468,10968
32994,Fidel,Dorro,fdorrokw@1688.com,VP Product Management,1101,1950,3051
32571,Arabel,Biles,abilesl1@bandcamp.com,Sales Associate,5372,1319,6691
32939,Lisabeth,Deval,ldevall2@simplemachines.org,Senior Sales Associate,7935,1433,9368
32751,Liliane,Dadswell,ldadswelll4@rambler.ru,Quality Engineer,7197,303,7500
32845,Hilly,Sutherns,hsuthernsl6@multiply.com,Nurse,8363,1227,9590
32658,Marlane,Clapson,mclapsonl8@mapy.cz,Statistician I,2925,1928,4853
32693,Mil,McGahey,mmcgaheyl9@example.com,Geological Engineer,9336,249,9585
32806,Monroe,Rushmere,mrushmerela@yelp.com,Computer Systems Analyst II,1581,847,2428
32100,Raymond,Pitcock,rpitcockli@deliciousdays.com,Chief Design Engineer,1295,1537,2832
32430,Lannie,Theobold,ltheoboldlk@parallels.com,Marketing Manager,1129,987,2116
32409,Morten,Cleugh,mcleughlm@webnode.com,Administrative Assistant IV,5787,376,6163
32470,Archibaldo,Fone,afonelo@yellowbook.com,Account Representative I,3645,532,4177
32446,Dillie,Affleck,dafflecklq@jigsy.com,Account Executive,2586,611,3197
32533,Adlai,Woolfoot,awoolfootlr@unblog.fr,Nuclear Power Engineer,9938,1157,11095
32520,Jeri,Salzburger,jsalzburgerls@pen.io,Staff Scientist,2999,1649,4648
32839,Palmer,Pothbury,ppothburylt@ed.gov,Research Nurse,5995,1667,7662
32627,Hurleigh,Abson,habsonm2@indiegogo.com,Data Coordiator,4693,1221,5914
32720,Olenka,Towey,otoweym4@cnbc.com,Automation Specialist III,1431,530,1961
32180,Findley,MacDonell,fmacdonellm5@house.gov,Senior Quality Engineer,6144,1356,7500
32707,Amalia,Bernli,abernlim7@bbb.org,Geological Engineer,7207,1893,9100
32287,Urban,Proom,uproomm9@paginegialle.it,VP Marketing,6106,877,6983
32297,Dory,Gritten,dgrittenma@ycombinator.com,Teacher,6942,1060,8002
32826,Fanni,Parratt,fparrattmc@about.com,Human Resources Manager,3815,1521,5336
32448,Katleen,Dict,kdictmf@hexun.com,Information Systems Manager,9648,547,10195
32984,Florance,Azema,fazemami@flickr.com,Research Nurse,1406,666,2072
32277,Darell,Rickaby,drickabymj@deviantart.com,Internal Auditor,3060,1863,4923
32026,La verne,Crosston,lcrosstonmk@latimes.com,Mechanical Systems Engineer,1967,845,2812
32458,Cedric,Oolahan,coolahanmq@wordpress.com,Mechanical Systems Engineer,8352,1015,9367
32459,Constantine,Begg,cbeggmt@diigo.com,Account Coordinator,8638,387,9025
32391,Terencio,Epdell,tepdellmu@cdc.gov,Senior Quality Engineer,9399,1012,10411
32801,Amata,Cone,aconemv@cam.ac.uk,Legal Assistant,8060,1736,9796
32653,Con,Filyashin,cfilyashinn3@usnews.com,Occupational Therapist,7817,990,8807
32938,Marigold,Skrine,mskrinen5@techcrunch.com,Payment Adjustment Coordinator,2942,1894,4836
32795,Asa,Dredge,adredgen6@usa.gov,VP Sales,5643,1442,7085
32982,Haleigh,O'Cleary,hoclearyn8@gravatar.com,Mechanical Systems Engineer,4949,917,5866
32414,Jessalin,Dilger,jdilgern9@qq.com,Help Desk Operator,5169,1999,7168
32651,Duane,Bamlet,dbamletnb@arstechnica.com,Librarian,2010,631,2641
32152,Theadora,McGinney,tmcginneynd@tamu.edu,Recruiting Manager,4528,1800,6328
32053,Nealon,Tansill,ntansillnf@ucla.edu,Senior Cost Accountant,6390,714,7104
32184,Adena,Shapiro,ashapironm@shinystat.com,Electrical Engineer,2447,739,3186
32531,Amory,Colleck,acollecknn@umn.edu,Actuary,2053,951,3004
32762,Beatrice,Beneze,bbenezeno@mashable.com,Actuary,3229,1573,4802
32858,Marlane,Embra,membranu@aboutads.info,Actuary,2889,317,3206
32175,Jada,Mulbry,jmulbrynx@webmd.com,Account Coordinator,7630,1053,8683
32503,Sisely,Feild,sfeildnz@seattletimes.com,Senior Editor,3108,1409,4517
32700,Annetta,Sacks,asackso0@geocities.com,Web Designer III,2084,847,2931
32269,Lyell,Brakespear,lbrakespearo2@seattletimes.com,Tax Accountant,2448,1576,4024
32650,Athene,Dedrick,adedricko7@marketwatch.com,Professor,1671,957,2628
32356,Sebastien,Gronno,sgronnooa@alibaba.com,Financial Advisor,9851,277,10128
32566,Wilfrid,Collie,wcollieog@miibeian.gov.cn,Director of Sales,8726,1723,10449
32803,Quinn,Morfey,qmorfeyoi@squarespace.com,Software Consultant,8364,1414,9778
32255,Peggie,Nathon,pnathonoj@e-recht24.de,Social Worker,6369,259,6628
32153,Duff,Fenech,dfenechok@vkontakte.ru,Civil Engineer,6976,624,7600
32632,Danit,Stanyon,dstanyonol@macromedia.com,Web Designer I,1311,1191,2502
32396,Donalt,Fullicks,dfullicksoo@xinhuanet.com,Physical Therapy Assistant,7721,609,8330
32740,Guss,Sheardown,gsheardownop@spiegel.de,Staff Scientist,6470,703,7173
32807,Zaccaria,Goble,zgobleoq@indiatimes.com,Desktop Support Technician,8291,1647,9938
32863,Kissee,Dorey,kdoreyos@time.com,Computer Systems Analyst III,8833,630,9463
32674,Barney,Almond,balmondou@mapy.cz,Developer IV,7733,1514,9247
32919,Zolly,Dooley,zdooleyow@cyberchimps.com,Librarian,8068,1239,9307
32027,Chelsey,Kasper,ckasperoy@ucla.edu,Software Consultant,1978,345,2323
32083,Monroe,Eccleshare,meccleshareoz@senate.gov,Analog Circuit Design manager,4720,1261,5981
32664,Ursala,Itzcovich,uitzcovichp4@house.gov,Safety Technician I,7412,1280,8692
32646,Reginauld,Gameson,rgamesonp5@hhs.gov,Junior Executive,7981,1327,9308
32799,Artemis,Foulcher,afoulcherp7@ezinearticles.com,Environmental Tech,4361,268,4629
32392,Damaris,Apperley,dapperleypd@wordpress.org,Office Assistant IV,3587,1815,5402
32320,Rosaleen,Rockell,rrockellpe@google.fr,Teacher,9821,1691,11512
32791,Carine,Sang,csangpi@berkeley.edu,Associate Professor,1766,429,2195
32124,Benjy,Ramelet,brameletpk@e-recht24.de,Environmental Specialist,5825,670,6495
32035,Daphna,Labuschagne,dlabuschagnepm@sciencedaily.com,Safety Technician III,5015,1401,6416
32892,Adamo,Mannakee,amannakeepp@addthis.com,Paralegal,8655,1389,10044
32229,Ravi,Zettoi,rzettoipq@jigsy.com,GIS Technical Architect,6974,254,7228
32918,Ruthie,Berzons,rberzonspr@comcast.net,Office Assistant IV,2367,1883,4250
32719,Lemar,Lippingwell,llippingwellpy@ucoz.com,Chief Design Engineer,9929,1123,11052
32140,Gannie,Plak,gplakpz@qq.com,Design Engineer,3224,749,3973
32820,Austin,Mitchard,amitchardq6@bbb.org,Statistician II,2440,1762,4202
32549,Jess,Swedeland,jswedelandq8@nhs.uk,Systems Administrator IV,8848,1083,9931
32046,Ronald,Ughetti,rughettiqg@stanford.edu,Office Assistant II,8865,1974,10839
32496,Carolyne,Ouchterlony,couchterlonyqi@dailymotion.com,Nurse Practicioner,3906,1161,5067
32364,Marcie,MacNab,mmacnabqk@ibm.com,Structural Analysis Engineer,6265,1928,8193
32495,Ora,Allbones,oallbonesqm@people.com.cn,Operator,1447,894,2341
32086,Mario,Sustins,msustinsqn@booking.com,Nurse Practicioner,8033,1854,9887
32697,Andreana,Beasleigh,abeasleighqq@example.com,Recruiting Manager,7310,1948,9258
32737,Teodora,Cromley,tcromleyqs@who.int,Editor,7622,1338,8960
32488,Vanya,Oxberry,voxberryqw@apple.com,Payment Adjustment Coordinator,4770,311,5081
32933,Kris,Sammonds,ksammondsqx@comcast.net,Associate Professor,1813,1863,3676
32144,Abbye,Binns,abinnsqz@google.ca,Statistician I,9210,1627,10837
32170,Franciskus,Herrieven,fherrievenr2@reuters.com,Senior Developer,8513,1951,10464
32168,Margarete,Edmunds,medmundsr5@netvibes.com,Social Worker,2143,1738,3881
32756,Constance,Dover,cdoverr8@google.ru,Occupational Therapist,9113,731,9844
32233,Josefina,Soane,jsoanerb@paginegialle.it,Research Nurse,3615,1790,5405
32371,Marlane,Dominey,mdomineyrc@vkontakte.ru,Assistant Manager,9494,947,10441
32671,Ludvig,Bore,lborerg@aboutads.info,Sales Associate,5539,1657,7196
32898,Dermot,Springham,dspringhamri@ebay.co.uk,Business Systems Development Analyst,6808,828,7636
32869,Leonore,Bissatt,lbissattrk@soundcloud.com,Account Representative II,1783,1732,3515
32169,Krissy,Cholmondeley,kcholmondeleyrl@moonfruit.com,Legal Assistant,3827,1701,5528
32120,Yvette,Broggelli,ybroggellirm@usnews.com,Quality Engineer,1209,565,1774
32749,Daisi,Wilks,dwilksrp@dailymotion.com,Clinical Specialist,9838,1363,11201
33299,Dugald,Klassman,dklassman0@networksolutions.com,Safety Technician III,8453,1417,9870
33047,Cornelius,Marchington,cmarchington1@spiegel.de,Safety Technician IV,5740,1476,7216
33704,Brooks,Orrocks,borrocks2@aol.com,Food Chemist,6082,1999,8081
33998,Carena,Mcimmie,cmcimmie3@nydailynews.com,Structural Analysis Engineer,2172,244,2416
33226,Kipp,Zini,kzini4@walmart.com,Occupational Therapist,6972,1924,8896
33906,Verge,Wedlake,vwedlake5@istockphoto.com,Quality Control Specialist,6625,1966,8591
33488,Hazel,Gairdner,hgairdner6@springer.com,Sales Representative,3073,1547,4620
33683,Meghan,Feldstern,mfeldstern7@a8.net,Help Desk Technician,4896,1704,6600
33245,Tabatha,Pipkin,tpipkin8@merriam-webster.com,Research Assistant I,6692,1716,8408
33637,Isadora,Baal,ibaal9@vk.com,Cost Accountant,4496,790,5286
33494,Leonelle,Billing,lbillinga@weebly.com,Help Desk Operator,3372,1273,4645
33056,Arabela,Pooke,apookeb@buzzfeed.com,Engineer III,3476,1246,4722
33900,Alexa,Tame,atamec@walmart.com,Structural Engineer,5014,825,5839
33703,Barbey,Juliff,bjuliffd@amazonaws.com,Automation Specialist I,9967,1795,11762
33897,Roshelle,Binstead,rbinsteade@ebay.com,Office Assistant I,2963,303,3266
33439,Bamby,Elph,belphf@xinhuanet.com,Safety Technician I,5361,273,5634
33378,Terrence,Truce,ttruceg@phpbb.com,Speech Pathologist,9577,1309,10886
33662,Verne,Dunican,vdunicanh@etsy.com,Director of Sales,1418,741,2159
33899,Nanon,Lyte,nlytei@uol.com.br,Librarian,3504,240,3744
33314,Camila,Clemetts,cclemettsj@businessweek.com,Analog Circuit Design manager,4071,1881,5952
33908,Joyce,Dovidaitis,jdovidaitisk@wikispaces.com,Internal Auditor,1536,1822,3358
33308,Dorena,Culkin,dculkinl@netvibes.com,Environmental Tech,8907,1707,10614
33873,Nataniel,Pook,npookm@chron.com,Analyst Programmer,8954,765,9719
33612,Jarib,Pyford,jpyfordn@slashdot.org,Biostatistician IV,7898,424,8322
33120,Munroe,Crut,mcruto@earthlink.net,Senior Developer,5019,563,5582
33776,Alley,Morrison,amorrisonp@symantec.com,Health Coach I,7103,1707,8810
33660,Doralynn,Plascott,dplascottq@freewebs.com,Media Manager III,2247,694,2941
33576,Vincents,Brock,vbrockr@harvard.edu,Clinical Specialist,7952,1596,9548
33373,Tedd,Gerrell,tgerrells@infoseek.co.jp,Senior Financial Analyst,3952,449,4401
33663,Marvin,O'Scollee,moscolleet@telegraph.co.uk,VP Marketing,6098,1192,7290
33666,Bird,Crollman,bcrollmanu@virginia.edu,Human Resources Assistant IV,3461,858,4319
33110,Russell,Easdon,reasdonv@umich.edu,VP Sales,4020,1135,5155
33159,Danya,Bydaway,dbydawayw@shutterfly.com,Staff Accountant IV,5753,329,6082
33949,Gabbie,Pargeter,gpargeterx@toplist.cz,Senior Cost Accountant,3066,376,3442
33657,Wang,Lamey,wlameyy@un.org,Statistician II,8076,1731,9807
33981,Maurine,Dayer,mdayerz@google.cn,Executive Secretary,9261,219,9480
33186,Nonah,Cleever,ncleever10@odnoklassniki.ru,Financial Advisor,3978,785,4763
33891,Ainsley,Fingleton,afingleton11@berkeley.edu,Clinical Specialist,9345,1002,10347
33849,Marcelia,Phipps,mphipps12@foxnews.com,Quality Control Specialist,1000,408,1408
33889,Justino,Lazenby,jlazenby14@ning.com,Quality Control Specialist,6652,597,7249
33279,Edwin,Martignon,emartignon15@yandex.ru,Structural Engineer,6226,640,6866
33507,Ofelia,Wedmore,owedmore16@loc.gov,Project Manager,5270,302,5572
33566,Brett,Palffy,bpalffy17@blinklist.com,Teacher,1462,1323,2785
33617,Lenore,Bennett,lbennett18@accuweather.com,Programmer Analyst IV,1192,1390,2582
33607,Starr,Secker,ssecker19@ucoz.ru,Social Worker,8988,1641,10629
33905,Killie,Dight,kdight1a@redcross.org,Associate Professor,5147,976,6123
33675,Isidore,Fawley,ifawley1b@springer.com,Help Desk Technician,4125,1782,5907
33514,Barbey,Phaup,bphaup1c@guardian.co.uk,Geologist IV,7429,1536,8965
33465,Rhianna,Knock,rknock1d@mit.edu,Systems Administrator II,8926,1840,10766
33383,Romola,Drydale,rdrydale1e@dyndns.org,Senior Quality Engineer,4342,247,4589
33443,Tiena,M'Chirrie,tmchirrie1f@prlog.org,Financial Advisor,3598,1335,4933
33461,Darlleen,Sayton,dsayton1g@booking.com,Structural Analysis Engineer,7289,1721,9010
33970,Shepperd,Hairsine,shairsine1h@earthlink.net,Recruiter,9097,776,9873
33918,Lory,Demcak,ldemcak1i@mit.edu,Human Resources Manager,3795,1104,4899
33199,Dallis,Small,dsmall1j@google.de,VP Product Management,2215,1559,3774
33948,Emeline,Purbrick,epurbrick1k@artisteer.com,Research Associate,3031,1465,4496
33718,Alexandro,Fitch,afitch1l@oaic.gov.au,Help Desk Technician,8966,1160,10126
33462,Durand,Dobie,ddobie1m@theguardian.com,Professor,3465,1227,4692
33400,Nataline,McIlhatton,nmcilhatton1n@vk.com,Teacher,2050,1455,3505
33097,Cloe,Nimmo,cnimmo1o@unblog.fr,Chief Design Engineer,1218,684,1902
33123,Launce,Shurville,lshurville1p@youtu.be,Legal Assistant,7752,683,8435
33480,Rozina,Drew,rdrew1q@usgs.gov,Junior Executive,8431,543,8974
33850,Brenna,Baribal,bbaribal1r@ihg.com,Geological Engineer,2862,472,3334
33534,Mellie,MacHoste,mmachoste1s@typepad.com,Junior Executive,7069,557,7626
33031,Wren,Bulgen,wbulgen1t@indiegogo.com,Research Assistant III,7723,1466,9189
33622,Lincoln,Soames,lsoames1u@prweb.com,Assistant Manager,1766,437,2203
33605,Ynez,Stainfield,ystainfield1v@unesco.org,Cost Accountant,9886,1972,11858
33708,Rey,Petracco,rpetracco1w@gizmodo.com,Staff Scientist,1297,1182,2479
33917,Ardenia,Chopping,achopping1y@arstechnica.com,Account Executive,5153,1128,6281
33856,Alexa,Houlworth,ahoulworth1z@sciencedaily.com,Financial Analyst,1498,1563,3061
33768,Gaby,Delaprelle,gdelaprelle20@bizjournals.com,Developer II,4803,1547,6350
33729,Elianore,Hyndman,ehyndman21@blogs.com,VP Product Management,6848,781,7629
33633,Barnie,Cearley,bcearley22@hao123.com,Help Desk Operator,1486,1063,2549
33316,Sydney,Roback,sroback23@irs.gov,Quality Engineer,8180,1674,9854
33105,Curran,Ivie,civie24@census.gov,Web Developer IV,2866,1605,4471
33397,Vasily,Boni,vboni25@hc360.com,Desktop Support Technician,8326,1959,10285
33478,Tabor,MacDavitt,tmacdavitt26@1und1.de,Help Desk Technician,3412,1632,5044
33424,Meta,Vallance,mvallance27@state.gov,Desktop Support Technician,7632,200,7832
33561,Kariotta,Blincoe,kblincoe28@vistaprint.com,Programmer Analyst III,4078,1519,5597
33134,Derrick,Minchinden,dminchinden29@hugedomains.com,Automation Specialist I,2486,1124,3610
33832,Frank,Velareal,fvelareal2a@icq.com,Accountant III,7451,626,8077
33188,Geraldine,Lemery,glemery2b@discuz.net,GIS Technical Architect,5157,383,5540
33265,Paulette,Blything,pblything2c@ning.com,Librarian,4387,662,5049
33102,Madge,Bisley,mbisley2d@theglobeandmail.com,Compensation Analyst,3079,768,3847
33877,Silvain,Attoc,sattoc2e@admin.ch,Quality Engineer,2248,542,2790
33529,Lauraine,Kidney,lkidney2f@ustream.tv,Junior Executive,4992,280,5272
33818,Zondra,Albutt,zalbutt2g@jimdo.com,Marketing Assistant,2810,1205,4015
33198,Ambur,Ridgwell,aridgwell2h@imageshack.us,Civil Engineer,8544,1382,9926
33264,Holly-anne,Lambert-Ciorwyn,hlambertciorwyn2i@umich.edu,Chemical Engineer,2661,640,3301
33606,Vinny,Alldridge,valldridge2j@storify.com,Registered Nurse,5344,737,6081
33075,Kin,Trimby,ktrimby2k@e-recht24.de,Environmental Tech,2877,1071,3948
33893,Quent,Davidavidovics,qdavidavidovics2l@ftc.gov,Statistician I,4329,741,5070
33796,Shane,Manthorpe,smanthorpe2m@oracle.com,Nurse Practicioner,9747,1139,10886
33855,Karlik,Ramsby,kramsby2n@theglobeandmail.com,Accounting Assistant III,6698,731,7429
33327,Margareta,Mirfin,mmirfin2o@rakuten.co.jp,Systems Administrator I,6852,573,7425
33693,Rosamund,Handrik,rhandrik2p@irs.gov,Assistant Professor,5648,396,6044
33671,Chalmers,Berkery,cberkery2q@delicious.com,Geological Engineer,3011,873,3884
33817,Bowie,Corten,bcorten2r@exblog.jp,Software Engineer II,1827,1727,3554
33738,Perren,Munks,pmunks2s@addtoany.com,Statistician IV,7356,1412,8768
33449,Marie,Sturgis,msturgis2t@tmall.com,Research Associate,8109,1598,9707
33064,Aubert,Wreford,awreford2u@smh.com.au,Accountant III,8201,551,8752
33043,Brooks,Monteaux,bmonteaux2v@cbslocal.com,Food Chemist,3213,642,3855
33697,Delbert,Westerman,dwesterman2w@dagondesign.com,Quality Engineer,3264,430,3694
33004,Adelheid,Saura,asaura2x@discuz.net,Programmer I,6529,358,6887
33058,Ave,Dun,adun2y@altervista.org,Nurse Practicioner,7627,208,7835
33022,Selina,Suttling,ssuttling30@icio.us,Account Representative II,4069,1543,5612
33865,Delmer,Lassetter,dlassetter31@adobe.com,Research Nurse,2441,1007,3448
33585,Baillie,Ketchaside,bketchaside32@ox.ac.uk,Systems Administrator III,8170,1478,9648
33668,Milo,Victoria,mvictoria33@nhs.uk,Financial Advisor,7316,308,7624
33012,Rainer,Tunmore,rtunmore37@cocolog-nifty.com,Quality Control Specialist,7166,257,7423
33180,Selia,Getty,sgetty38@wiley.com,Editor,9692,313,10005
33980,Bentley,Smalls,bsmalls39@statcounter.com,Budget/Accounting Analyst III,8610,1405,10015
33456,Barry,Buxey,bbuxey3a@unc.edu,Structural Analysis Engineer,5755,1599,7354
33911,Teddy,Sewter,tsewter3b@chicagotribune.com,Account Executive,6818,1801,8619
33298,Cate,Gammack,cgammack3c@cargocollective.com,Tax Accountant,6327,1251,7578
33747,Arliene,Goch,agoch3d@chronoengine.com,Pharmacist,6847,633,7480
33008,Lola,Castille,lcastille3e@moonfruit.com,Recruiting Manager,3016,1932,4948
33421,Kasper,Cressey,kcressey3f@wikia.com,VP Quality Control,1928,294,2222
33355,Virgina,Punch,vpunch3g@netlog.com,GIS Technical Architect,7990,260,8250
33386,Penny,Rubinsohn,prubinsohn3h@usatoday.com,Human Resources Assistant III,8776,889,9665
33658,Carter,Vasechkin,cvasechkin3i@deviantart.com,Administrative Officer,3701,225,3926
33399,Natala,Dows,ndows3l@uol.com.br,Clinical Specialist,4264,1294,5558
33501,Marta,Rostron,mrostron3m@devhub.com,Tax Accountant,2264,1564,3828
33489,Devora,Sandiland,dsandiland3n@vimeo.com,Sales Representative,1392,1592,2984
33232,Kinnie,Bowles,kbowles3o@engadget.com,VP Accounting,8238,1198,9436
33106,Denice,Rylatt,drylatt3p@earthlink.net,Budget/Accounting Analyst I,5571,1087,6658
33257,Katharina,Daouse,kdaouse3q@typepad.com,VP Accounting,9479,1029,10508
33983,Steven,Ciementini,sciementini3r@google.nl,Database Administrator II,3055,1725,4780
33953,Carlita,Mottinelli,cmottinelli3s@intel.com,Recruiter,1779,1073,2852
33758,Ty,Labram,tlabram3t@cbslocal.com,Nurse Practicioner,4669,430,5099
33392,Kathi,Rudgerd,krudgerd3u@npr.org,Actuary,4046,385,4431
33924,Foster,Mapplebeck,fmapplebeck3v@yellowpages.com,Computer Systems Analyst I,6630,1303,7933
33640,Luce,Tregaskis,ltregaskis3w@imgur.com,Director of Sales,1146,527,1673
33986,Tull,Medway,tmedway3x@feedburner.com,Chief Design Engineer,2839,565,3404
33831,Keary,Fison,kfison3y@mac.com,Librarian,2263,381,2644
33560,Mona,Morshead,mmorshead3z@abc.net.au,Software Test Engineer III,3620,429,4049
33883,Tobias,Shee,tshee40@tripod.com,Nurse Practicioner,7554,857,8411
33681,Den,Cosin,dcosin41@ebay.com,Office Assistant II,3201,544,3745
33586,Greta,Lambot,glambot42@arstechnica.com,Accountant IV,7789,1215,9004
33515,Duff,Prium,dprium44@umn.edu,Food Chemist,8749,327,9076
33039,Olive,Jubert,ojubert45@zdnet.com,Associate Professor,6391,240,6631
33863,Astra,Farfoot,afarfoot46@go.com,Account Coordinator,9490,1527,11017
33690,Christiane,Doogan,cdoogan47@weebly.com,Professor,1877,1400,3277
33142,Silvia,Tullis,stullis48@princeton.edu,Accountant II,7699,1941,9640
33700,Izak,Madre,imadre49@blogger.com,Tax Accountant,3231,978,4209
33842,Deerdre,Eglise,deglise4a@nyu.edu,Account Representative I,1393,242,1635
33618,Dalis,Haye,dhaye4d@nymag.com,Executive Secretary,8427,1629,10056
33015,Torry,Orrell,torrell4e@wikia.com,Assistant Professor,9100,338,9438
33709,Bridget,Bunworth,bbunworth4f@networksolutions.com,Occupational Therapist,9532,1755,11287
33111,Marsh,Gianolini,mgianolini4h@newyorker.com,VP Accounting,8152,511,8663
33080,Christina,Capsey,ccapsey4i@blogtalkradio.com,VP Marketing,6855,1454,8309
33369,Ophelia,Vines,ovines4j@java.com,Operator,3860,554,4414
33280,Marco,Pontefract,mpontefract4k@canalblog.com,Research Nurse,7305,1064,8369
33321,Hildegaard,Belleny,hbelleny4l@fastcompany.com,Research Nurse,1603,1225,2828
33256,Tabina,Lockyear,tlockyear4m@goo.ne.jp,Graphic Designer,4551,933,5484
33885,Carmelle,Paddock,cpaddock4n@hugedomains.com,VP Product Management,5806,1689,7495
33021,Lora,Bukowski,lbukowski4o@sakura.ne.jp,Research Assistant I,4783,1468,6251
33600,Almire,Laudham,alaudham4p@pcworld.com,Accounting Assistant I,3221,949,4170
33137,Emeline,Blowes,eblowes4q@unc.edu,Paralegal,7067,1492,8559
33446,Hodge,Symones,hsymones4r@umich.edu,Senior Sales Associate,8163,734,8897
33995,Temple,Harrild,tharrild4s@infoseek.co.jp,Business Systems Development Analyst,1193,1482,2675
33223,Rey,Doulden,rdoulden4t@usa.gov,Compensation Analyst,3571,1216,4787
33687,Aleen,Minards,aminards4u@friendfeed.com,Food Chemist,9510,1946,11456
33609,Sharl,Purcell,spurcell4w@ca.gov,Chemical Engineer,9492,606,10098
33337,Dalia,Wadforth,dwadforth4x@ucoz.ru,Structural Engineer,8771,1533,10304
33791,Annemarie,Kibbey,akibbey4y@loc.gov,VP Sales,5745,1877,7622
33460,Sidonnie,Cuesta,scuesta4z@google.com.hk,Chemical Engineer,6433,1008,7441
33978,Rupert,Rosell,rrosell50@moonfruit.com,Automation Specialist I,8050,268,8318
33909,Antoine,Gorusso,agorusso51@pen.io,Web Developer IV,8550,1996,10546
33724,Eustacia,Petrolli,epetrolli52@nbcnews.com,Assistant Media Planner,6666,1718,8384
33201,Laughton,Oakwell,loakwell53@edublogs.org,Chief Design Engineer,8441,938,9379
33244,Benetta,Hiscoke,bhiscoke54@taobao.com,Computer Systems Analyst I,7113,1595,8708
33189,Pepi,Basilio,pbasilio55@plala.or.jp,Senior Sales Associate,2754,1002,3756
33623,Marla,Abdie,mabdie56@samsung.com,Speech Pathologist,1587,1152,2739
33962,Vite,Macbeth,vmacbeth57@macromedia.com,Quality Control Specialist,5456,1025,6481
33086,Skipp,Pestell,spestell58@alibaba.com,Systems Administrator II,2761,414,3175
33395,Margarita,Ricoald,mricoald59@redcross.org,Assistant Media Planner,1819,1212,3031
33027,Oriana,Leeming,oleeming5a@sun.com,Director of Sales,1300,1484,2784
33799,Winnie,Penk,wpenk5b@bravesites.com,Recruiting Manager,5818,1209,7027
33942,Zonnya,Bishop,zbishop5c@home.pl,Developer III,3636,1824,5460
33220,Wenda,Macconaghy,wmacconaghy5d@miitbeian.gov.cn,Analyst Programmer,2927,1848,4775
33370,Langsdon,Keys,lkeys5e@bbb.org,Staff Accountant II,9686,1846,11532
33405,Jacquette,Ayris,jayris5f@eepurl.com,VP Sales,1583,1046,2629
33620,Klara,Espy,kespy5g@ask.com,Software Consultant,9794,1314,11108
33714,Starlene,Pashby,spashby5j@yahoo.com,Human Resources Assistant II,3700,766,4466
33228,Dena,Diegan,ddiegan5k@tamu.edu,Legal Assistant,7181,832,8013
33453,Melanie,Pellant,mpellant5l@slate.com,Registered Nurse,4339,1455,5794
33425,Marjory,Daid,mdaid5m@flavors.me,Computer Systems Analyst IV,3532,294,3826
33303,Jasen,Parnell,jparnell5p@free.fr,Cost Accountant,8200,259,8459
33190,Raimund,Lyptrit,rlyptrit5s@rambler.ru,Community Outreach Specialist,1352,764,2116
33023,Nannette,Mathet,nmathet5t@theatlantic.com,Graphic Designer,3405,1513,4918
33951,Chiarra,Taylder,ctaylder5v@jalbum.net,Geological Engineer,3895,1636,5531
33414,Chadd,Henrichsen,chenrichsen5w@moonfruit.com,Mechanical Systems Engineer,5191,1923,7114
33987,Rex,Swapp,rswapp5x@ehow.com,Software Engineer III,7407,1519,8926
33471,Helen,Spurryer,hspurryer5y@sakura.ne.jp,Food Chemist,7838,1224,9062
33323,Linette,Trundell,ltrundell5z@usatoday.com,Dental Hygienist,2731,1517,4248
33932,Koenraad,Filipov,kfilipov60@discuz.net,Marketing Assistant,2807,1321,4128
33059,Prudi,de Quesne,pdequesne63@exblog.jp,Office Assistant I,6463,1441,7904
33847,Barnard,Pycock,bpycock64@free.fr,Developer I,1938,1349,3287
33587,Sebastiano,Game,sgame65@europa.eu,Physical Therapy Assistant,2392,1677,4069
33686,Zaccaria,Hanscomb,zhanscomb66@ustream.tv,Payment Adjustment Coordinator,2532,1400,3932
33467,Galvan,Aers,gaers67@guardian.co.uk,Senior Cost Accountant,8378,864,9242
33773,Royal,Duguid,rduguid69@exblog.jp,Geologist I,7037,1409,8446
33158,Rodrique,Hargey,rhargey6a@flavors.me,Budget/Accounting Analyst I,7289,1637,8926
33169,Gilli,Griswood,ggriswood6b@who.int,Structural Engineer,8464,956,9420
33125,Andrus,Goldsberry,agoldsberry6c@geocities.com,Sales Associate,3600,394,3994
33139,Ricoriki,McGillacoell,rmcgillacoell6d@icq.com,Associate Professor,2482,493,2975
33330,Rudiger,Mattiussi,rmattiussi6f@businessweek.com,Accounting Assistant II,4162,965,5127
33762,Micky,Gori,mgori6g@abc.net.au,Financial Advisor,1027,1887,2914
33511,Jeniece,Farlane,jfarlane6h@hexun.com,Senior Editor,2765,409,3174
33311,Giana,Boow,gboow6j@fotki.com,Environmental Specialist,6609,1053,7662
33078,Kingsley,Drewitt,kdrewitt6k@about.me,Geologist II,9065,426,9491
33151,Milt,Bridgett,mbridgett6l@wufoo.com,Research Nurse,5129,422,5551
33825,Benni,Graal,bgraal6m@hc360.com,Food Chemist,3702,1613,5315
33743,Rabi,Fero,rfero6o@digg.com,Payment Adjustment Coordinator,1997,631,2628
33939,Orlan,Adame,oadame6p@altervista.org,Speech Pathologist,1894,1501,3395
33048,Goldi,Endacott,gendacott6r@nps.gov,Professor,3299,430,3729
33093,Enos,Weblin,eweblin6s@shop-pro.jp,Paralegal,2558,343,2901
33077,Joey,Stowte,jstowte6t@fastcompany.com,Director of Sales,1786,1932,3718
33032,Brana,Schermick,bschermick6u@tiny.cc,Product Engineer,1308,787,2095
33360,Renaldo,Timberlake,rtimberlake6v@php.net,Biostatistician IV,7517,1115,8632
33956,Ermentrude,Janecki,ejanecki6w@qq.com,Geological Engineer,1099,430,1529
33737,Brena,Penson,bpenson6x@gmpg.org,VP Marketing,7073,1376,8449
33479,Leslie,Rosthorn,lrosthorn6y@engadget.com,Geological Engineer,8175,537,8712
33207,Cindy,Passby,cpassby6z@tamu.edu,Mechanical Systems Engineer,4079,1564,5643
33719,Katina,Ranyard,kranyard70@house.gov,Environmental Tech,6603,1079,7682
33604,Marie,Bewlie,mbewlie71@youtube.com,Marketing Manager,3553,1384,4937
33999,Tanner,Stafford,tstafford73@freewebs.com,Environmental Tech,1620,667,2287
33648,Clarice,Marion,cmarion74@creativecommons.org,Nurse Practicioner,1168,510,1678
33195,Sharline,Kiwitz,skiwitz75@live.com,Software Engineer III,3169,973,4142
33967,Micah,Tournay,mtournay76@people.com.cn,VP Accounting,2342,305,2647
33844,Carr,Forrest,cforrest77@skype.com,Systems Administrator II,1551,1021,2572
33793,Bebe,Lowther,blowther78@nyu.edu,Human Resources Manager,3996,1270,5266
33284,Lem,Tavernor,ltavernor79@statcounter.com,Legal Assistant,1291,1764,3055
33578,Wiatt,Segrott,wsegrott7b@oakley.com,Financial Advisor,6124,818,6942
33192,Ailey,Justis,ajustis7f@google.pl,Chemical Engineer,8624,407,9031
33591,Jillayne,Sinden,jsinden7g@artisteer.com,Structural Engineer,5854,1539,7393
33602,Woody,Goodbarne,wgoodbarne7h@mozilla.com,Programmer IV,9884,1456,11340
33672,Lonnie,Date,ldate7i@hostgator.com,Media Manager I,6473,1987,8460
34000,Danette,Brisard,dbrisard7k@behance.net,Environmental Tech,9139,1651,10790
33408,Jaquenette,Benning,jbenning7l@sakura.ne.jp,Help Desk Operator,4537,1422,5959
33230,Franzen,Hazelgrove,fhazelgrove7m@un.org,Information Systems Manager,8906,484,9390
33273,Marlyn,Mithun,mmithun7n@gizmodo.com,Database Administrator III,3742,972,4714
33836,Marven,Edger,medger7q@huffingtonpost.com,Chemical Engineer,4609,389,4998
33145,Brett,Spawton,bspawton7s@unesco.org,Desktop Support Technician,5047,1995,7042
33706,Patrice,Bratley,pbratley7t@posterous.com,Financial Advisor,3351,1714,5065
33356,Wells,Doodney,wdoodney7v@technorati.com,Web Developer IV,7058,860,7918
33839,Sigismund,Percival,spercival7x@jimdo.com,Legal Assistant,3218,1288,4506
33459,Tana,Pingstone,tpingstone7y@goo.ne.jp,Research Nurse,7023,1697,8720
33293,Boony,Marques,bmarques81@admin.ch,Community Outreach Specialist,9875,381,10256
33322,Karee,Rheam,krheam82@umn.edu,Teacher,8041,1152,9193
33375,Alameda,Tonkes,atonkes83@linkedin.com,Staff Scientist,3761,408,4169
33432,Oliver,Szepe,oszepe84@google.de,Structural Analysis Engineer,2876,204,3080
33562,Damara,Sulland,dsulland85@wunderground.com,Cost Accountant,8064,373,8437
33772,Joann,Clowser,jclowser86@discuz.net,Research Assistant I,8643,717,9360
33353,Anet,Jumonet,ajumonet87@facebook.com,Software Test Engineer IV,3164,623,3787
33218,Aloise,Pattlel,apattlel88@techcrunch.com,Senior Sales Associate,2994,948,3942
33650,Pete,McAlester,pmcalester8a@wix.com,Marketing Manager,9528,1846,11374
33242,Tucker,Shotboulte,tshotboulte8b@booking.com,Registered Nurse,9494,1832,11326
33787,Vic,Johncey,vjohncey8d@scientificamerican.com,Legal Assistant,7758,1105,8863
33913,Rabbi,Chillingsworth,rchillingsworth8h@yahoo.co.jp,Nurse,6447,1428,7875
33530,Britteny,Doyley,bdoyley8i@nsw.gov.au,Administrative Assistant III,9663,1745,11408
33993,Karrah,Counihan,kcounihan8j@google.es,Nurse Practicioner,4674,1193,5867
33904,Ashley,Heustice,aheustice8m@newsvine.com,Tax Accountant,6520,1756,8276
33301,Filberto,Sculpher,fsculpher8o@toplist.cz,Senior Sales Associate,3341,1138,4479
33925,Mack,Sember,msember8p@linkedin.com,Community Outreach Specialist,9367,1100,10467
33712,Staffard,Jewers,sjewers8q@uiuc.edu,Mechanical Systems Engineer,2474,1758,4232
33979,Nat,Alabaster,nalabaster8r@fastcompany.com,Design Engineer,1774,1799,3573
33072,Jade,Loxston,jloxston8v@adobe.com,Nurse Practicioner,2137,477,2614
33567,Hermione,Springford,hspringford8w@ezinearticles.com,Financial Analyst,1252,404,1656
33349,Tabor,Lenton,tlenton8x@usatoday.com,Operator,9342,1742,11084
33552,Guy,Iacobini,giacobini8z@blogtalkradio.com,Marketing Assistant,6151,1027,7178
33642,Harriot,Vida,hvida91@pcworld.com,Occupational Therapist,8224,1146,9370
33387,Mina,Gallaccio,mgallaccio93@foxnews.com,Assistant Professor,1362,1100,2462
33549,Kevin,Battie,kbattie94@microsoft.com,Analyst Programmer,5606,1296,6902
33215,Claire,Tungay,ctungay96@ted.com,Compensation Analyst,3430,402,3832
33339,Pablo,Pattillo,ppattillo97@dagondesign.com,Senior Editor,1929,1689,3618
33894,Layton,Vearncombe,lvearncombe99@mlb.com,Research Associate,6757,1228,7985
33268,Kayne,Minto,kminto9a@bizjournals.com,Librarian,7253,1066,8319
33060,Fawne,Frain,ffrain9b@arizona.edu,Occupational Therapist,8188,276,8464
33813,Lemmie,Valentin,lvalentin9c@apache.org,Director of Sales,6404,223,6627
33701,Ario,Banishevitz,abanishevitz9f@google.nl,Sales Associate,4869,1058,5927
33726,Marlow,De Freitas,mdefreitas9j@psu.edu,Analog Circuit Design manager,5279,614,5893
33317,Kelsi,Aucott,kaucott9m@loc.gov,Executive Secretary,4049,258,4307
33187,Yancey,Tremlett,ytremlett9n@xing.com,Research Associate,9865,1186,11051
33267,Ester,Honatsch,ehonatsch9p@mail.ru,Financial Advisor,1135,362,1497
33781,Danice,MacCostye,dmaccostye9r@acquirethisname.com,Financial Advisor,2949,1348,4297
33801,Malvina,Blaiklock,mblaiklock9s@yolasite.com,Teacher,4910,1831,6741
33784,Bertine,Sevior,bsevior9t@shutterfly.com,Professor,1267,1299,2566
33275,Roseanna,Carletto,rcarletto9u@dmoz.org,VP Sales,8736,1158,9894
33964,Antoinette,Scriver,ascriver9x@blogtalkradio.com,Environmental Specialist,4509,1426,5935
33161,Maurine,Poser,mposer9y@fastcompany.com,GIS Technical Architect,2141,1491,3632
33835,Freedman,Isaacson,fisaacson9z@google.com.hk,Analog Circuit Design manager,8992,1378,10370
33289,Armando,Hawkshaw,ahawkshawa2@tamu.edu,Developer II,1818,758,2576
33807,Rosabel,Firebrace,rfirebracea3@bizjournals.com,Quality Engineer,6800,1653,8453
33379,Freddy,Waud,fwauda4@cisco.com,Software Consultant,5716,372,6088
33310,Bettine,Mowling,bmowlinga6@paginegialle.it,Account Executive,1590,519,2109
33711,Lyndsie,De Lisle,ldelislea7@examiner.com,Geologist I,5633,513,6146
33735,Ketty,Uzzell,kuzzella8@wikia.com,Editor,7797,1654,9451
33597,Robb,Wadie,rwadiea9@infoseek.co.jp,Senior Cost Accountant,9730,681,10411
33689,Chlo,Baroux,cbarouxaa@behance.net,Project Manager,4411,1442,5853
33482,Tessy,Trewman,ttrewmanab@desdev.cn,Operator,6809,1216,8025
33368,Austina,Jaulme,ajaulmeac@nsw.gov.au,Geologist IV,1153,720,1873
33087,Kessiah,Lindborg,klindborgad@mapy.cz,Structural Analysis Engineer,3347,1656,5003
33240,Tamiko,McCarry,tmccarryae@yale.edu,Systems Administrator I,8668,803,9471
33750,Caty,Cossam,ccossamaf@comsenz.com,Accounting Assistant I,3426,748,4174
33684,Eleni,Verlinde,everlindeag@lulu.com,Systems Administrator IV,5287,854,6141
33266,Joycelin,Belk,jbelkah@youtu.be,Mechanical Systems Engineer,2414,1883,4297
33099,Nev,Trosdall,ntrosdallai@jigsy.com,Teacher,6120,492,6612
33754,Bambi,Rayne,brayneaj@newsvine.com,Community Outreach Specialist,4138,1213,5351
33103,Amelia,Iohananof,aiohananofak@nytimes.com,Information Systems Manager,6372,1754,8126
33685,Vivyan,Burras,vburrasal@storify.com,Database Administrator III,3151,363,3514
33829,Estel,Schimke,eschimkeam@lulu.com,Civil Engineer,7248,677,7925
33415,Mimi,Rayhill,mrayhillap@51.la,Mechanical Systems Engineer,1568,323,1891
33278,Ham,Thrower,hthrowerar@google.com.au,Help Desk Operator,7726,706,8432
33109,Ingmar,De la Perrelle,idelaperrelleas@tumblr.com,Senior Cost Accountant,9331,761,10092
33934,Cinnamon,Fendlen,cfendlenat@multiply.com,Business Systems Development Analyst,5745,1128,6873
33915,Evanne,Broseke,ebrosekeau@bbb.org,Speech Pathologist,4250,1631,5881
33500,Cecilia,Hendron,chendronav@telegraph.co.uk,Quality Control Specialist,6693,904,7597
33645,Dannie,Giannini,dgianniniaw@mail.ru,Product Engineer,7396,1864,9260
33481,Boyd,Soar,bsoarax@prweb.com,Administrative Officer,9667,1748,11415
33108,Hilary,Brookes,hbrookesay@disqus.com,Systems Administrator II,6055,1893,7948
33254,Florinda,Keates,fkeatesaz@spotify.com,Media Manager IV,6676,1562,8238
33682,Carmelita,Yankov,cyankovb0@freewebs.com,Product Engineer,6713,1868,8581
33005,Suzie,Dillicate,sdillicateb2@nhs.uk,Product Engineer,6017,1539,7556
33166,Gardner,Slogrove,gslogroveb4@prweb.com,Actuary,4634,683,5317
33938,Noni,Levey,nleveyb6@lycos.com,Software Test Engineer I,3405,1329,4734
33377,Germana,Strood,gstroodba@jiathis.com,Human Resources Assistant I,1220,432,1652
33547,Rogerio,Lindell,rlindellbd@elegantthemes.com,Business Systems Development Analyst,5492,910,6402
33593,Hyacinthe,Verne,hvernebe@youku.com,Software Engineer IV,9689,1593,11282
33788,Farra,Rollitt,frollittbf@com.com,Recruiting Manager,6913,1167,8080
33066,Denver,Bidewell,dbidewellbg@unblog.fr,Media Manager I,3665,1486,5151
33417,Morey,Plomer,mplomerbh@ftc.gov,Analog Circuit Design manager,9222,1899,11121
33655,Brena,Richt,brichtbj@youku.com,Nuclear Power Engineer,5307,1076,6383
33716,Aurel,Ganforth,aganforthbk@barnesandnoble.com,Geologist I,8240,1887,10127
33512,Ansley,Chittie,achittiebl@photobucket.com,Software Consultant,7495,1966,9461
33286,Susy,Bernier,sbernierbm@drupal.org,Help Desk Technician,7437,584,8021
33282,Jacklyn,Bunstone,jbunstonebn@a8.net,Analog Circuit Design manager,6070,1627,7697
33523,Beatriz,Baden,bbadenbo@discuz.net,Desktop Support Technician,1885,1084,2969
33947,Doralin,Stanner,dstannerbq@google.cn,Quality Control Specialist,6537,655,7192
33418,Gray,Fareweather,gfareweatherbr@instagram.com,Senior Sales Associate,3547,533,4080
33155,Leah,Ugo,lugobs@adobe.com,Developer II,4711,1596,6307
33084,Spence,Jurisic,sjurisicbt@list-manage.com,Financial Advisor,2622,1869,4491
33271,Shandra,Izat,sizatbu@canalblog.com,Office Assistant III,2776,417,3193
33992,Hulda,Zaniolo,hzaniolobv@arizona.edu,Accounting Assistant IV,3824,1775,5599
33531,Des,Cockley,dcockleybw@arstechnica.com,Senior Cost Accountant,1560,1179,2739
33095,Hartley,McFall,hmcfallbx@google.ca,Research Assistant I,1283,1479,2762
33920,Christophorus,Solesbury,csolesburyby@myspace.com,Marketing Manager,4130,1275,5405
33420,Alyss,Matusovsky,amatusovskybz@ed.gov,Sales Associate,2451,871,3322
33457,Cloris,Flanne,cflannec0@narod.ru,Senior Quality Engineer,8735,1714,10449
33565,Keelby,Joice,kjoicec1@nsw.gov.au,Staff Accountant I,4931,1917,6848
33118,Avril,Honeyghan,ahoneyghanc2@mozilla.org,VP Product Management,7565,1967,9532
33848,Arvin,Futty,afuttyc3@spiegel.de,Community Outreach Specialist,7267,857,8124
33505,Rozele,Renish,rrenishc4@newsvine.com,Marketing Manager,7069,425,7494
33721,Hyacinth,Yankishin,hyankishinc5@parallels.com,Paralegal,7539,1308,8847
33277,Gay,Statton,gstattonc6@guardian.co.uk,VP Accounting,1297,1686,2983
33705,Halsey,Arnot,harnotc7@dmoz.org,Senior Developer,5847,1869,7716
33592,Reinhard,McAllen,rmcallenca@jimdo.com,Office Assistant IV,7170,1285,8455
33385,Cass,Chomiszewski,cchomiszewskicc@example.com,Sales Representative,8039,660,8699
33320,Dominica,Cretney,dcretneyce@miitbeian.gov.cn,Computer Systems Analyst IV,6722,1779,8501
33150,Desi,Rich,drichch@fastcompany.com,Account Coordinator,8508,650,9158
33973,Monti,Bugdall,mbugdallci@dion.ne.jp,Senior Financial Analyst,4088,444,4532
33237,Kristin,Goutcher,kgoutchercl@amazon.co.uk,Systems Administrator IV,5464,1545,7009
33802,Evanne,Arpin,earpincn@nasa.gov,Senior Cost Accountant,7458,1313,8771
33283,Cassandra,Haddon,chaddonco@networkadvertising.org,Electrical Engineer,7358,1793,9151
33364,Jerrie,Borgnet,jborgnetcp@last.fm,Social Worker,5750,1171,6921
33477,Jock,Bartholin,jbartholincq@fc2.com,Junior Executive,5044,900,5944
33094,Marji,Bowdler,mbowdlercr@senate.gov,Actuary,6990,477,7467
33184,Chester,Inglesent,cinglesentcs@telegraph.co.uk,Administrative Officer,1699,1443,3142
33412,Yasmin,Heningham,yheninghamcu@usatoday.com,Marketing Assistant,6565,1927,8492
33210,Ruttger,Giotto,rgiottocv@tinypic.com,Structural Engineer,9280,285,9565
33821,Udale,Boyer,uboyercw@slashdot.org,Account Coordinator,6975,459,7434
33903,Garnette,Desorts,gdesortscy@people.com.cn,VP Marketing,1836,699,2535
33652,Timmie,Sidworth,tsidworthd0@cisco.com,Marketing Manager,9000,1910,10910
33520,Allis,Issacov,aissacovd1@wsj.com,Business Systems Development Analyst,6998,253,7251
33524,Betty,Emeline,bemelined3@taobao.com,Research Associate,8600,1389,9989
33577,Kitty,Hawton,khawtond5@weebly.com,Social Worker,2292,1549,3841
33315,Benedetto,Bunce,bbunced7@liveinternet.ru,Electrical Engineer,2290,965,3255
33177,Willard,Lomen,wlomenda@biblegateway.com,VP Quality Control,2006,1721,3727
33358,Brew,Zarfai,bzarfaidd@uol.com.br,Engineer III,9288,1916,11204
33541,Rhianon,Mundle,rmundledf@fda.gov,Account Executive,3645,1746,5391
33069,Gwenette,Girhard,ggirharddg@cdc.gov,Senior Financial Analyst,1495,1051,2546
33732,Thomasina,Trenear,ttreneardh@ucoz.com,Database Administrator IV,6152,1091,7243
33014,Cord,Bayldon,cbayldondi@mapy.cz,Tax Accountant,9321,490,9811
33960,Opaline,Dell Casa,odellcasadl@opera.com,Office Assistant II,5471,1032,6503
33644,Loralie,Cheson,lchesondm@pagesperso-orange.fr,Software Consultant,6660,1274,7934
33173,Michaeline,Plunkett,mplunkettdp@ft.com,Legal Assistant,8187,1687,9874
33639,Marta,Cowthard,mcowtharddr@flickr.com,Systems Administrator III,3678,1999,5677
33760,Elizabeth,Edmeades,eedmeadesdt@indiegogo.com,Programmer II,6248,1418,7666
33598,Korella,Berick,kberickdv@feedburner.com,Human Resources Manager,9287,1842,11129
33646,Reade,Eglaise,reglaisedy@patch.com,Cost Accountant,6478,299,6777
33029,Daile,Rosling,droslingdz@mysql.com,Food Chemist,9818,911,10729
33122,Nerte,Bolstridge,nbolstridgee0@sohu.com,Data Coordiator,6641,1415,8056
33731,Kettie,Culshew,kculshewe1@seattletimes.com,Professor,1777,1016,2793
33049,Beckie,Odegaard,bodegaarde3@hc360.com,Speech Pathologist,2094,1073,3167
33051,Levin,Dinesen,ldinesene4@shinystat.com,Registered Nurse,4560,1413,5973
33100,Drusilla,Tregust,dtreguste5@un.org,Chemical Engineer,2962,1923,4885
33234,Mikael,Rupert,mruperte6@redcross.org,Budget/Accounting Analyst IV,6127,1435,7562
33367,Hartley,Dukes,hdukese7@auda.org.au,Engineer II,9231,408,9639
33589,Natalie,Hellings,nhellingse8@biblegateway.com,VP Product Management,5068,1061,6129
33474,Lizzy,Andriesse,landriesseeb@hexun.com,Clinical Specialist,6535,925,7460
33062,Tobiah,McGurgan,tmcgurganee@naver.com,Tax Accountant,3442,786,4228
33694,Aeriell,Connechie,aconnechieef@wisc.edu,Assistant Manager,4327,661,4988
33532,Fredek,Holwell,fholwelleg@discuz.net,Librarian,4364,466,4830
33786,Evey,McAlinden,emcalindeneh@google.nl,Civil Engineer,8442,432,8874
33996,Elvyn,Huggard,ehuggardei@wordpress.com,Director of Sales,1966,848,2814
33944,Nevsa,Claire,nclaireej@myspace.com,Chief Design Engineer,2907,1442,4349
33393,Abbie,Cush,acushek@yandex.ru,Analog Circuit Design manager,2636,1058,3694
33434,Ada,Ludovici,aludoviciel@pagesperso-orange.fr,Legal Assistant,9755,1106,10861
33643,Ethe,Kneafsey,ekneafseyeo@alexa.com,Human Resources Manager,7805,1260,9065
33235,Hyatt,Piet,hpietep@dagondesign.com,Food Chemist,4358,746,5104
33287,Cooper,Latek,clatekeq@upenn.edu,Safety Technician I,6277,926,7203
33045,Ladonna,Wippermann,lwippermanner@geocities.com,Accounting Assistant IV,5542,888,6430
33211,Merrel,Burnett,mburnettes@123-reg.co.uk,Dental Hygienist,5788,1218,7006
33140,Ulrick,Wilfinger,uwilfingeret@flickr.com,Software Consultant,2198,1638,3836
33359,Anthe,Lankester,alankestereu@umich.edu,Pharmacist,2791,1822,4613
33149,Miran,Burleigh,mburleighew@paginegialle.it,Internal Auditor,8603,1585,10188
33406,Christiane,Topley,ctopleyex@123-reg.co.uk,Recruiter,9022,1037,10059
33935,Aldin,Scard,ascardf0@jalbum.net,Programmer Analyst II,1044,649,1693
33527,Lincoln,Gennings,lgenningsf1@fotki.com,Actuary,4406,1904,6310
33676,Fayina,Tewes,ftewesf2@vistaprint.com,Systems Administrator I,4763,1238,6001
33050,Reggie,Doeg,rdoegf3@washingtonpost.com,Developer III,1080,1919,2999
33065,Aube,Riddell,ariddellf4@sourceforge.net,VP Sales,5457,378,5835
33445,Wolfie,Enston,wenstonf7@state.gov,Director of Sales,9788,850,10638
33647,Madge,McLernon,mmclernonf9@bing.com,Safety Technician III,5386,1144,6530
33638,Keri,Waugh,kwaughfb@dailymotion.com,Structural Engineer,9538,757,10295
33006,Drugi,Clucas,dclucasfc@clickbank.net,Software Consultant,7316,411,7727
33869,Inna,Rubinov,irubinovfe@github.com,Computer Systems Analyst II,5945,808,6753
33753,Corbett,Bartod,cbartodff@163.com,Research Nurse,5068,225,5293
33945,Eleanore,Casale,ecasalefg@wsj.com,Nuclear Power Engineer,2005,367,2372
33692,Elyssa,Reynoldson,ereynoldsonfh@boston.com,VP Accounting,5918,1093,7011
33881,Osmund,Marwood,omarwoodfi@goodreads.com,Automation Specialist IV,1093,941,2034
33352,Alexio,Plank,aplankfj@who.int,Senior Editor,7458,1220,8678
33196,Chiarra,Barritt,cbarrittfl@amazon.co.jp,Paralegal,4911,1695,6606
33296,Amberly,Pacitti,apacittifm@nih.gov,Senior Editor,4473,951,5424
33362,Cirilo,Dunphie,cdunphiefn@sfgate.com,Graphic Designer,9272,1109,10381
33498,Kerwin,Burwin,kburwinfq@elegantthemes.com,Research Nurse,1071,223,1294
33172,Dannie,Schwand,dschwandfs@clickbank.net,Analog Circuit Design manager,6653,238,6891
33148,Rosanna,Dwelley,rdwelleyft@posterous.com,Editor,8471,384,8855
33628,Maxwell,Howel,mhowelfu@virginia.edu,Automation Specialist I,9032,836,9868
33313,Colas,Climo,cclimofx@cam.ac.uk,Executive Secretary,1944,505,2449
33450,Darda,Shillaber,dshillaberg1@phpbb.com,Data Coordiator,2016,407,2423
33129,Orion,Dealy,odealyg4@smh.com.au,Statistician III,2752,1085,3837
33054,Cornela,Summerside,csummersideg5@jugem.jp,Engineer I,2585,1207,3792
33238,Audry,Sams,asamsg6@fema.gov,Account Representative III,9206,1138,10344
33259,Joey,Guidone,jguidonega@blogs.com,Pharmacist,4439,1087,5526
33222,Norris,Millican,nmillicangb@gnu.org,Electrical Engineer,5554,1036,6590
33035,Quent,Paynes,qpaynesgc@mapquest.com,Registered Nurse,8708,230,8938
33800,Laurice,Gourdon,lgourdongf@un.org,Senior Financial Analyst,5325,1848,7173
33472,Link,Todeo,ltodeogg@slideshare.net,Occupational Therapist,3351,1928,5279
33384,Gayler,Clayton,gclaytongh@blogger.com,Senior Cost Accountant,6359,940,7299
33974,Tobin,Hollows,thollowsgk@typepad.com,Programmer Analyst III,5403,805,6208
33341,Shir,Oxburgh,soxburghgo@princeton.edu,Physical Therapy Assistant,6150,1410,7560
33318,Louie,Sharland,lsharlandgp@google.pl,VP Marketing,3367,650,4017
33810,Bevvy,Farnworth,bfarnworthgr@about.com,Engineer II,6024,808,6832
33442,Viviene,Beller,vbellergt@wp.com,Senior Editor,1716,1807,3523
33025,Easter,Filoniere,efilonieregu@weather.com,Programmer Analyst III,3960,898,4858
33026,Amargo,Jannasch,ajannaschgv@nifty.com,Internal Auditor,9644,1648,11292
33840,Silas,Fassman,sfassmangx@nba.com,Recruiter,8359,654,9013
33191,Axel,Swansbury,aswansburyh0@networkadvertising.org,Senior Editor,7118,1718,8836
33239,Jessy,Wildes,jwildesh1@issuu.com,Junior Executive,3414,1126,4540
33331,Glenden,Le Grand,glegrandh4@sun.com,Quality Control Specialist,4940,1737,6677
33229,Jase,Shingles,jshinglesh5@thetimes.co.uk,Internal Auditor,1910,985,2895
33003,Viv,Rodders,vroddersh6@purevolume.com,VP Accounting,9654,496,10150
33621,Mariette,Priestman,mpriestmanh8@sbwire.com,Chemical Engineer,5535,526,6061
33564,Rheta,Dunmuir,rdunmuirh9@deliciousdays.com,Electrical Engineer,6676,1367,8043
33519,Frieda,Bodle,fbodleha@ebay.co.uk,Senior Sales Associate,7540,1200,8740
33879,Ailbert,Lowseley,alowseleyhb@nature.com,Pharmacist,2983,1079,4062
33508,Caryl,Greensitt,cgreensitthd@photobucket.com,Programmer Analyst III,1683,563,2246
33845,Baryram,MacClenan,bmacclenanhf@prnewswire.com,Research Nurse,2958,1954,4912
33741,Brit,Hartwell,bhartwellhg@uiuc.edu,Librarian,5265,777,6042
33404,Tate,Woodwin,twoodwinhh@cargocollective.com,Sales Representative,5318,850,6168
33288,Robers,Andreev,randreevhi@desdev.cn,Help Desk Technician,9784,994,10778
33782,Cullin,Gatling,cgatlinghj@themeforest.net,Marketing Assistant,2790,570,3360
33312,Nobe,Cuskery,ncuskeryhk@statcounter.com,Community Outreach Specialist,6614,1714,8328
33745,Anabella,Skuce,askucehl@xrea.com,Electrical Engineer,3144,1482,4626
33430,Leeland,Mathieu,lmathieuhn@xinhuanet.com,Account Coordinator,7703,1687,9390
33156,Melodee,Haggar,mhaggarhq@soundcloud.com,Director of Sales,7319,1848,9167
33036,Shannen,Trehearn,strehearnhs@hatena.ne.jp,Administrative Assistant III,5028,1783,6811
33940,Ertha,Le Gassick,elegassickhw@dailymotion.com,Chemical Engineer,8384,759,9143
33982,Carleen,Sparshutt,csparshutthy@vkontakte.ru,Payment Adjustment Coordinator,2087,1148,3235
33895,Blaine,Brewitt,bbrewitthz@squidoo.com,Data Coordiator,8400,1515,9915
33649,Rab,Jakov,rjakovi3@economist.com,Librarian,1816,1731,3547
33919,Ebba,Hansford,ehansfordi4@comsenz.com,Software Engineer IV,3164,1643,4807
33568,Tommie,Byllam,tbyllami5@topsy.com,Assistant Professor,5768,1658,7426
33484,Leese,Greenslade,lgreensladeid@apple.com,VP Product Management,7245,1193,8438
33816,Bobine,Strawbridge,bstrawbridgeih@house.gov,Administrative Officer,8352,1354,9706
33438,Jami,De Ruggero,jderuggeroim@pen.io,Structural Analysis Engineer,5641,1313,6954
33763,Job,Murton,jmurtonin@addthis.com,Mechanical Systems Engineer,8472,453,8925
33034,Benetta,Monkman,bmonkmanio@miibeian.gov.cn,Project Manager,6190,1690,7880
33040,Abe,Walden,awaldeniq@about.me,Marketing Manager,7535,1757,9292
33572,Efren,Carvill,ecarvillit@ucoz.com,Health Coach III,9083,865,9948
33550,Ax,Elix,aelixiu@un.org,Assistant Media Planner,9975,1237,11212
33569,Dino,Hurdwell,dhurdwelliv@csmonitor.com,Environmental Specialist,1764,1866,3630
33071,Jdavie,Tasch,jtaschiz@bloglovin.com,Financial Analyst,9291,1459,10750
33419,Dominik,Tunbridge,dtunbridgej3@jigsy.com,Research Nurse,8484,1322,9806
33107,Gav,Alford,galfordj5@vk.com,Research Associate,3732,1674,5406
33774,Kit,Caroli,kcarolij7@smugmug.com,Programmer III,5849,1365,7214
33361,Valaree,Glasscott,vglasscottj8@stumbleupon.com,Civil Engineer,9166,372,9538
33126,Leontine,Olivari,lolivarijc@4shared.com,Computer Systems Analyst IV,9834,1791,11625
33319,Corenda,Taig,ctaigjd@columbia.edu,Safety Technician III,4243,1729,5972
33670,Camille,Trethewey,ctretheweyje@nationalgeographic.com,Operator,6103,1887,7990
33030,Grenville,Crutcher,gcrutcherjj@phoca.cz,Senior Sales Associate,4358,790,5148
33325,Urban,Giovanizio,ugiovaniziojl@thetimes.co.uk,Geologist III,4726,1462,6188
33052,Daria,Bispham,dbisphamjm@slashdot.org,Senior Quality Engineer,5958,1124,7082
33295,Jenni,Hyland,jhylandjr@cbsnews.com,Assistant Professor,7236,915,8151
33794,Jessy,Sambiedge,jsambiedgejs@cmu.edu,Computer Systems Analyst III,9763,929,10692
33852,Penrod,Gittus,pgittusjt@tripadvisor.com,Account Coordinator,3152,1432,4584
33756,Keane,Knapton,kknaptonjv@sfgate.com,Engineer IV,7879,1514,9393
33699,Vernor,Shimoni,vshimonijx@booking.com,Recruiter,9866,1926,11792
33067,Wendeline,Deason,wdeasonk2@amazon.com,Research Associate,6880,1453,8333
33090,Pearla,Goldring,pgoldringk4@istockphoto.com,Business Systems Development Analyst,9280,640,9920
33554,Pip,Vause,pvausek7@naver.com,Director of Sales,3303,809,4112
33526,Noreen,Swarbrigg,nswarbriggk8@163.com,Professor,6166,1861,8027
33431,Clayborn,Lamplugh,clamplughka@bing.com,Office Assistant I,4728,1157,5885
33495,Keir,Cossam,kcossamkd@hugedomains.com,Analyst Programmer,7897,1490,9387
33975,Don,Sabater,dsabaterke@nasa.gov,VP Sales,4261,1573,5834
33115,Kristien,Sonnenschein,ksonnenscheinkf@webnode.com,Senior Cost Accountant,4150,461,4611
33513,Nata,Henniger,nhennigerki@webmd.com,VP Marketing,6230,1124,7354
33231,Fina,Yushmanov,fyushmanovkj@wired.com,Developer I,2026,1312,3338
33324,Aretha,Waggatt,awaggattkp@pinterest.com,Environmental Specialist,3225,1879,5104
33752,Daloris,Layus,dlayusks@virginia.edu,Speech Pathologist,8572,1697,10269
33247,Colene,Himpson,chimpsonkx@google.cn,Staff Accountant III,4150,821,4971
33990,Adriaens,Sherston,asherstonky@elegantthemes.com,Business Systems Development Analyst,8165,1961,10126
33619,Raye,Zorener,rzorenerl0@economist.com,Nurse Practicioner,8611,399,9010
33357,Nelle,Found,nfoundl1@blogspot.com,Software Engineer I,8235,1286,9521
33611,Foss,Cuseck,fcuseckl4@nbcnews.com,Technical Writer,9454,1939,11393
33673,Padraic,Poyzer,ppoyzerl7@phpbb.com,Operator,4061,927,4988
33803,Val,Royston,vroystonl9@miibeian.gov.cn,Human Resources Manager,8611,1372,9983
33371,Ade,Horley,ahorleylb@google.de,Associate Professor,5181,870,6051
33963,Virgilio,Jinda,vjindale@theglobeandmail.com,Data Coordiator,2710,1794,4504
33402,Bobette,Denison,bdenisonlf@dmoz.org,Statistician I,8206,910,9116
33937,Ainslie,Caldera,acalderalg@theatlantic.com,Electrical Engineer,9777,960,10737
33543,Chryste,Petroff,cpetroffli@1688.com,Tax Accountant,5399,1719,7118
33208,Bee,Buttfield,bbuttfieldlk@netlog.com,Help Desk Technician,5100,1951,7051
33588,Alden,Shallcrass,ashallcrassll@bing.com,Software Engineer III,8678,1556,10234
33503,Sollie,Roles,sroleslo@dedecms.com,Office Assistant II,1237,1562,2799
33890,Catharine,Kilbey,ckilbeylp@oakley.com,Marketing Assistant,2179,835,3014
33197,Lorry,Doxsey,ldoxseylr@irs.gov,Environmental Specialist,6768,1400,8168
33751,Brigitta,Matten,bmattenlt@toplist.cz,Data Coordiator,3441,1397,4838
33162,Rodi,Runsey,rrunseylv@yahoo.com,Speech Pathologist,4158,1471,5629
33746,Suzi,Domelaw,sdomelawm0@opera.com,Recruiter,1365,283,1648
33603,Archibald,Snowman,asnowmanm2@nbcnews.com,Food Chemist,8640,292,8932
33104,Corey,Vannozzii,cvannozziim3@businessweek.com,Staff Scientist,2039,1281,3320
33435,Gaston,Itzhaki,gitzhakim4@google.co.jp,Human Resources Manager,6201,496,6697
33528,Mata,Stockoe,mstockoem6@t.co,Technical Writer,1252,1519,2771
33757,Othello,Wylam,owylamm7@zdnet.com,Geologist IV,3472,1890,5362
33394,Rudolfo,McMackin,rmcmackinme@apache.org,Food Chemist,8792,588,9380
33629,Marie-ann,Millington,mmillingtonmf@digg.com,Tax Accountant,5566,924,6490
33351,Eliza,Doy,edoymi@wix.com,Account Representative II,4972,1505,6477
33941,Amara,Roze,arozemk@wisc.edu,Legal Assistant,3419,798,4217
33874,Nadine,Stack,nstackmn@craigslist.org,Speech Pathologist,2433,1180,3613
33579,Vaclav,Ramplee,vrampleemp@prnewswire.com,Associate Professor,1672,1047,2719
33328,Dory,Delap,ddelapmq@cisco.com,Analog Circuit Design manager,4726,1519,6245
33972,Wally,Kerner,wkernermu@feedburner.com,Developer II,3161,518,3679
33581,Langsdon,Dupre,ldupremv@wordpress.com,Compensation Analyst,5961,1404,7365
33252,Barthel,Proctor,bproctormw@geocities.jp,Staff Scientist,9437,1396,10833
33281,Christie,Paddle,cpaddlemy@youku.com,Technical Writer,7367,671,8038
33544,Pippo,Earey,peareymz@photobucket.com,Associate Professor,8209,1596,9805
33250,Marylynne,Rossetti,mrossettin4@exblog.jp,Paralegal,2728,1948,4676
33225,Sada,Lyfe,slyfen9@adobe.com,Environmental Specialist,3868,900,4768
33764,Fidela,Thonason,fthonasonnb@ucoz.com,Data Coordiator,1358,1153,2511
33789,Eartha,Stonelake,estonelakenc@fema.gov,Compensation Analyst,5587,1356,6943
33624,Ulric,Owbrick,uowbricknd@google.co.uk,VP Quality Control,4846,967,5813
33888,Cordie,St Louis,cstlouisnf@senate.gov,Pharmacist,6149,1751,7900
33214,Lalo,Duigenan,lduigenanng@joomla.org,Junior Executive,6638,1967,8605
33727,Edwin,Andrat,eandratnk@nydailynews.com,Web Designer II,9579,758,10337
33736,Wood,Hanigan,whanigannm@php.net,Account Representative II,3168,1498,4666
33206,Dillie,Calrow,dcalrowns@ebay.co.uk,Junior Executive,8796,1600,10396
33469,Daniel,Minor,dminornt@4shared.com,Clinical Specialist,6075,1078,7153
33070,Kristofor,Megainey,kmegaineynv@hubpages.com,VP Product Management,5712,486,6198
33734,Lauree,Pimblett,lpimblettnz@stanford.edu,Professor,8521,325,8846
33153,Eada,Labitt,elabitto3@issuu.com,Technical Writer,3288,1365,4653
33389,Kaiser,Vreede,kvreedeo4@wp.com,Compensation Analyst,7419,520,7939
33806,Gunter,Vaan,gvaano5@hostgator.com,Financial Analyst,5304,489,5793
33812,Mabel,Voules,mvouleso6@yahoo.co.jp,Food Chemist,4326,913,5239
33555,Edith,Ruggen,eruggeno8@ustream.tv,Clinical Specialist,7715,1565,9280
33875,Rod,Durrans,rdurranso9@businesswire.com,Occupational Therapist,3118,1881,4999
33216,Nataniel,Cary,ncaryob@statcounter.com,Administrative Officer,3683,699,4382
33843,Kile,Maddison,kmaddisonod@a8.net,GIS Technical Architect,5132,999,6131
33539,Ruthi,Darlasson,rdarlassonoh@istockphoto.com,Business Systems Development Analyst,4355,1834,6189
33167,Fifine,Scard,fscardoi@rambler.ru,Data Coordiator,9519,287,9806
33117,Gabriellia,Geering,ggeeringon@desdev.cn,Web Designer II,9513,275,9788
33867,Layney,Dulany,ldulanyop@tmall.com,Help Desk Operator,5314,1540,6854
33837,Helge,Malec,hmalecos@ucoz.com,Teacher,1478,1550,3028
33988,Sonny,Hume,shumeot@livejournal.com,Actuary,6873,1428,8301
33688,Major,Lesser,mlesserou@home.pl,Software Consultant,7966,659,8625
33253,Edith,Hucquart,ehucquartov@seattletimes.com,Analyst Programmer,2046,292,2338
33423,Frans,Kingswold,fkingswoldow@acquirethisname.com,Tax Accountant,6969,1023,7992
33436,Annabella,Try,atryoy@loc.gov,Accountant II,1202,1218,2420
33248,Leandra,Shall,lshallp1@infoseek.co.jp,Automation Specialist I,5654,1603,7257
33300,Jenn,Moon,jmoonp3@oakley.com,Senior Cost Accountant,3310,542,3852
33989,Alvira,Tethacot,atethacotp5@amazon.com,Clinical Specialist,4097,942,5039
33679,Shelby,Jenney,sjenneyp6@wikimedia.org,Junior Executive,1145,405,1550
33871,Arvie,Bolan,abolanpa@miitbeian.gov.cn,Structural Engineer,8327,1911,10238
33744,Adelind,Pummery,apummerypd@narod.ru,Engineer I,2347,749,3096
33464,Saunders,Pimblott,spimblottpf@themeforest.net,Dental Hygienist,6846,578,7424
33775,Magdaia,Chotty,mchottypg@youtube.com,Statistician I,4948,845,5793
33398,Saba,Chalk,schalkpj@google.cn,Sales Representative,6892,513,7405
33010,Lesley,Attree,lattreepk@google.pl,Compensation Analyst,8091,1341,9432
33411,Dag,Doerling,ddoerlingpl@businesswire.com,Tax Accountant,9689,1595,11284
33792,Joletta,Henri,jhenripm@pagesperso-orange.fr,Sales Representative,9374,1818,11192
33380,Sidonnie,Dormer,sdormerpn@craigslist.org,Software Consultant,5180,1953,7133
33922,Mel,McCullough,mmcculloughpo@etsy.com,VP Marketing,3253,1450,4703
33157,Standford,Ganniclifft,sganniclifftpr@people.com.cn,Information Systems Manager,6584,1387,7971
33861,Skelly,Conaghy,sconaghypu@slideshare.net,Health Coach II,9518,1575,11093
33096,Hervey,Lyfe,hlyfepw@fotki.com,Pharmacist,8076,1157,9233
33798,Dasya,Milton,dmiltonpx@sina.com.cn,Civil Engineer,1661,1921,3582
33771,Perri,Phorsby,pphorsbypz@salon.com,Office Assistant III,2091,1497,3588
33018,Adoree,Verdy,averdyq1@cbsnews.com,Software Engineer IV,2445,1726,4171
33127,Otes,Fitkin,ofitkinq3@woothemes.com,Technical Writer,7420,235,7655
33667,Helyn,Bustin,hbustinq4@hatena.ne.jp,Account Coordinator,4565,883,5448
33009,Benny,Lane,blaneq7@upenn.edu,VP Quality Control,3398,1753,5151
33019,Sterne,Yell,syellq9@homestead.com,Structural Analysis Engineer,5538,226,5764
33610,Salomi,Davison,sdavisonqd@w3.org,Graphic Designer,9987,1446,11433
33659,Griffin,Boshard,gboshardqe@timesonline.co.uk,Web Developer II,8873,1388,10261
33243,Dulcine,Melby,dmelbyqf@dell.com,Assistant Professor,3483,464,3947
33556,Georgie,Rozenbaum,grozenbaumql@google.nl,Media Manager II,3971,1923,5894
33085,Rudy,Ovitts,rovittsqq@arstechnica.com,Project Manager,8229,699,8928
33968,Drusy,Kime,dkimeqy@unblog.fr,Financial Analyst,9429,1227,10656
33698,Edd,Platts,eplattsqz@springer.com,Statistician IV,9023,469,9492
33448,Bryce,Gillings,bgillingsr1@shinystat.com,Chemical Engineer,3643,1887,5530
33203,Ilyse,Sherar,isherarr6@ed.gov,Senior Quality Engineer,1917,359,2276
33665,Bartholomeus,Bondy,bbondyrc@tamu.edu,Health Coach III,5220,628,5848
33959,Joell,Dykas,jdykasrf@xrea.com,Information Systems Manager,2739,742,3481
33416,Jorry,Crawshaw,jcrawshawrj@smh.com.au,Structural Engineer,6992,1856,8848
33634,Ashley,Pitrelli,apitrellirk@mlb.com,Recruiting Manager,3016,389,3405
33958,Sydel,Mityushin,smityushinrl@spiegel.de,Electrical Engineer,8327,1562,9889
33334,Chelsea,Baudone,cbaudonerm@globo.com,Help Desk Technician,5059,928,5987
33390,Aurea,Gorries,agorriesrn@pinterest.com,Geologist IV,7764,203,7967
33896,Roberta,Orriss,rorrissro@tumblr.com,Human Resources Manager,2246,319,2565
33510,Belvia,Fanthom,bfanthomrr@columbia.edu,Product Engineer,7124,1537,8661
34117,Allistir,Shawcross,ashawcross0@adobe.com,Environmental Specialist,7026,1569,8595
34508,Mufinella,Verrier,mverrier1@clickbank.net,Administrative Officer,1292,200,1492
34810,Rriocard,Rickesies,rrickesies2@cdc.gov,Speech Pathologist,6459,1971,8430
34478,Bo,Povah,bpovah3@umich.edu,Web Developer III,1544,932,2476
34929,Lavinie,Syme,lsyme4@bbb.org,Media Manager II,4488,1999,6487
34960,Bianka,Snoxall,bsnoxall5@state.tx.us,Tax Accountant,8013,1480,9493
34341,Binni,Beaney,bbeaney6@slideshare.net,Account Coordinator,9254,871,10125
34203,Ginnifer,Fabbri,gfabbri7@icio.us,Software Consultant,9263,1792,11055
34688,Teirtza,Tommasuzzi,ttommasuzzi8@amazon.com,Programmer II,6344,1076,7420
34288,Eb,Dignan,edignan9@squidoo.com,Cost Accountant,2450,1813,4263
34540,Valenka,Puddifer,vpuddifera@marketwatch.com,Data Coordiator,9140,893,10033
34429,Bonnie,De Giorgio,bdegiorgiob@scribd.com,Automation Specialist III,4881,537,5418
34964,Eula,Gibling,egiblingc@vinaora.com,Electrical Engineer,2574,1632,4206
34053,Aviva,Whithalgh,awhithalghd@arstechnica.com,Legal Assistant,4367,1059,5426
34542,Kalinda,Michal,kmichale@tmall.com,Social Worker,1109,237,1346
34243,Kaycee,Ivashov,kivashovf@soundcloud.com,Programmer Analyst IV,4753,361,5114
34950,Othilie,Hallyburton,ohallyburtong@stumbleupon.com,Professor,7086,604,7690
34873,Kyle,Tankin,ktankinh@pen.io,Human Resources Assistant III,2354,452,2806
34427,Krista,Clelland,kclellandi@51.la,Payment Adjustment Coordinator,7764,1413,9177
34078,Kacy,Shrieve,kshrievej@icq.com,Professor,8918,1890,10808
34295,Mandel,Tomenson,mtomensonk@unesco.org,Financial Analyst,8771,1228,9999
34528,Devan,Gimblett,dgimblettl@army.mil,Librarian,6740,1208,7948
34095,Cleveland,Murr,cmurrm@hao123.com,Structural Analysis Engineer,8360,1115,9475
34301,Janet,Petrashov,jpetrashovn@alexa.com,Speech Pathologist,7126,577,7703
34294,Frank,Rockall,frockallo@ox.ac.uk,VP Accounting,5895,1025,6920
34437,Godfree,Meighan,gmeighanp@bigcartel.com,Nurse,7152,385,7537
34466,Cecelia,Arnowicz,carnowiczq@hostgator.com,Research Associate,4823,367,5190
34986,Herman,Meadway,hmeadwayr@exblog.jp,Automation Specialist IV,3001,519,3520
34180,Giuseppe,Knappett,gknappetts@wunderground.com,Teacher,9003,1509,10512
34886,Ezra,Mager,emagert@oaic.gov.au,Staff Accountant IV,6915,408,7323
34290,Carmela,Suthren,csuthrenu@taobao.com,Senior Developer,1892,495,2387
34144,Dev,Czaple,dczaplev@nsw.gov.au,Administrative Officer,5785,1147,6932
34780,Dermot,Fechnie,dfechniew@wordpress.org,Professor,2358,959,3317
34160,Isacco,Ranald,iranaldx@loc.gov,Structural Analysis Engineer,3096,1095,4191
34280,Sasha,Yewdale,syewdaley@blog.com,Quality Engineer,5211,988,6199
34596,Jemie,Pargeter,jpargeterz@edublogs.org,Information Systems Manager,1038,1578,2616
34202,Derrik,Linsley,dlinsley10@reuters.com,Staff Accountant IV,1456,1867,3323
34687,Tracy,Wildt,twildt11@kickstarter.com,Pharmacist,8992,897,9889
34476,Carver,Peace,cpeace12@elpais.com,General Manager,4473,1208,5681
34798,Angelita,Shall,ashall13@netscape.com,Marketing Manager,4373,643,5016
34968,Imojean,Valentelli,ivalentelli14@1und1.de,VP Accounting,2173,861,3034
34079,Joelle,Dast,jdast15@tinypic.com,Desktop Support Technician,9414,781,10195
34818,Collete,Rapier,crapier16@nba.com,VP Product Management,7689,1227,8916
34699,Laurianne,Trousdell,ltrousdell17@yelp.com,Software Consultant,5917,808,6725
34980,Stanley,Klees,sklees18@list-manage.com,Payment Adjustment Coordinator,2359,1947,4306
34733,Lotte,Shakshaft,lshakshaft19@netscape.com,Data Coordiator,8187,1283,9470
34323,Christye,Abrashkin,cabrashkin1a@apple.com,Financial Advisor,8504,719,9223
34835,Jeno,Dansken,jdansken1b@infoseek.co.jp,Actuary,5064,1198,6262
34098,Lannie,Corter,lcorter1c@imdb.com,Senior Financial Analyst,7235,1525,8760
34093,Mayor,Elwell,melwell1d@telegraph.co.uk,Research Assistant III,2499,1578,4077
34641,Dianemarie,Coyte,dcoyte1e@friendfeed.com,Marketing Assistant,7886,1911,9797
34740,Thomas,Rorke,trorke1f@fda.gov,Research Nurse,8555,1932,10487
34468,Cosette,Ebbin,cebbin1g@blogger.com,Geological Engineer,7771,492,8263
34510,Portia,McGahern,pmcgahern1h@bandcamp.com,Software Engineer I,1356,1249,2605
34131,Tonye,Ducker,tducker1i@ameblo.jp,Registered Nurse,2198,1433,3631
34973,Kenneth,Jellybrand,kjellybrand1j@cpanel.net,Operator,5915,1016,6931
34719,Kasper,Fishley,kfishley1k@w3.org,Project Manager,1369,1775,3144
34277,Roosevelt,Pracy,rpracy1l@cbc.ca,Financial Analyst,2044,829,2873
34235,Dyan,Leeke,dleeke1m@feedburner.com,VP Marketing,6379,1768,8147
34188,Florry,Cristofalo,fcristofalo1n@posterous.com,VP Sales,9337,404,9741
34238,Neile,Doorbar,ndoorbar1o@ted.com,Graphic Designer,5657,1818,7475
34404,Paxon,Swendell,pswendell1p@purevolume.com,Financial Advisor,1379,1133,2512
34157,Fernando,Elleray,felleray1q@guardian.co.uk,Senior Quality Engineer,5607,686,6293
34240,Binky,De la Yglesias,bdelayglesias1r@senate.gov,Administrative Officer,6367,698,7065
34174,Maddalena,Burbidge,mburbidge1s@springer.com,Chemical Engineer,5952,504,6456
34696,Frankie,Veale,fveale1t@zimbio.com,Design Engineer,8898,763,9661
34289,Lorinda,Pedycan,lpedycan1u@acquirethisname.com,General Manager,6001,1012,7013
34595,Ignacio,Tunno,itunno1v@cbc.ca,Compensation Analyst,3328,1846,5174
34581,Charity,Braganca,cbraganca1w@theglobeandmail.com,Health Coach III,9169,265,9434
34539,Ninnette,Ferro,nferro1x@unicef.org,Business Systems Development Analyst,9792,302,10094
34480,Juan,Lagen,jlagen1y@washingtonpost.com,Recruiting Manager,7065,1288,8353
34291,Ezekiel,Stummeyer,estummeyer1z@drupal.org,Marketing Assistant,2850,1222,4072
34579,Jeremie,Keiley,jkeiley20@seattletimes.com,Director of Sales,4195,280,4475
34016,Brandtr,Meads,bmeads21@apple.com,Budget/Accounting Analyst III,6010,303,6313
34072,Xymenes,Stockdale,xstockdale22@stumbleupon.com,Electrical Engineer,3371,596,3967
34650,Carrol,Brundall,cbrundall23@java.com,Software Consultant,7672,1286,8958
34666,Nadine,Aimable,naimable24@noaa.gov,Chief Design Engineer,4140,651,4791
34304,Willi,Bossel,wbossel25@canalblog.com,Assistant Professor,2380,866,3246
34128,Dell,Oboy,doboy26@globo.com,Professor,2474,774,3248
34827,Jarrad,Laible,jlaible27@webeden.co.uk,VP Sales,3247,479,3726
34488,Shadow,Pauncefoot,spauncefoot28@paypal.com,Registered Nurse,1777,1007,2784
34734,Timmy,Claughton,tclaughton29@businesswire.com,Software Test Engineer III,8654,896,9550
34511,Alayne,Enever,aenever2a@ucsd.edu,Clinical Specialist,7963,1292,9255
34355,Ingram,Lummis,ilummis2b@psu.edu,Speech Pathologist,1877,1111,2988
34997,Artemis,Bingle,abingle2c@who.int,Senior Editor,6025,694,6719
34705,Dorie,O'Halloran,dohalloran2d@booking.com,Occupational Therapist,3967,1358,5325
34149,Mead,Marciskewski,mmarciskewski2e@bloomberg.com,VP Sales,2572,1655,4227
34566,Perl,Ackred,packred2f@ucsd.edu,Systems Administrator II,2339,1907,4246
34620,Sela,Rosgen,srosgen2g@howstuffworks.com,Paralegal,8865,1204,10069
34191,Cloe,Rylett,crylett2h@technorati.com,Senior Quality Engineer,7400,570,7970
34642,Freemon,Reddihough,freddihough2i@networksolutions.com,Financial Advisor,2947,1818,4765
34250,Ingrid,Goodfellowe,igoodfellowe2j@cloudflare.com,Graphic Designer,8600,1135,9735
34701,Idaline,Coombe,icoombe2k@over-blog.com,Community Outreach Specialist,3333,1211,4544
34159,Constantine,Hum,chum2l@google.co.uk,Accounting Assistant IV,5992,952,6944
34531,Bond,Wharfe,bwharfe2m@blogspot.com,Biostatistician III,4475,1615,6090
34569,Beale,Skillitt,bskillitt2o@networksolutions.com,Research Associate,1595,1519,3114
34629,Mattias,Housin,mhousin2q@skype.com,Occupational Therapist,4559,1857,6416
34246,Ardelis,Pattlel,apattlel2r@economist.com,Graphic Designer,7972,1585,9557
34446,Gerladina,Martinelli,gmartinelli2s@opensource.org,Design Engineer,1629,754,2383
34565,Mayne,Holdforth,mholdforth2t@google.cn,Chief Design Engineer,1727,867,2594
34330,Shela,Hankard,shankard2u@sourceforge.net,Senior Cost Accountant,7846,1786,9632
34587,Wood,Hawyes,whawyes2v@vkontakte.ru,Financial Advisor,2437,1997,4434
34394,Meghan,Olenikov,molenikov2w@google.pl,Sales Associate,5923,856,6779
34582,Roby,Crockett,rcrockett2x@devhub.com,Software Test Engineer III,2257,531,2788
34627,Carly,Stithe,cstithe2y@github.io,Community Outreach Specialist,7955,1983,9938
34410,Cosme,Godbert,cgodbert2z@va.gov,Geologist IV,4556,1271,5827
34316,Samara,Lightwing,slightwing30@github.com,Financial Advisor,7302,366,7668
34170,Drusie,Giamuzzo,dgiamuzzo31@cargocollective.com,Internal Auditor,2197,1825,4022
34822,Welby,Goldbourn,wgoldbourn33@desdev.cn,Recruiting Manager,2821,1953,4774
34353,Kellyann,Cousins,kcousins34@zdnet.com,Software Test Engineer II,2932,1428,4360
34487,Buck,Langfield,blangfield35@ycombinator.com,Statistician I,8126,420,8546
34832,Briana,Dello,bdello36@istockphoto.com,Occupational Therapist,5986,624,6610
34177,Em,Summerskill,esummerskill37@cam.ac.uk,Human Resources Assistant I,2369,1109,3478
34814,Ferdinande,Martini,fmartini39@last.fm,Compensation Analyst,2712,539,3251
34996,Shelli,Alenichicov,salenichicov3a@arstechnica.com,Registered Nurse,9884,1110,10994
34444,Gert,Peckett,gpeckett3b@jigsy.com,Mechanical Systems Engineer,9314,275,9589
34759,Wendall,Semon,wsemon3d@posterous.com,Electrical Engineer,4382,780,5162
34074,Mimi,Bohlens,mbohlens3e@sogou.com,Senior Sales Associate,1237,1172,2409
34614,Yasmeen,Norcock,ynorcock3f@msu.edu,Environmental Tech,8691,385,9076
34773,Emalee,Pinare,epinare3g@unicef.org,Assistant Media Planner,5947,576,6523
34726,Roma,Griffoen,rgriffoen3h@utexas.edu,Assistant Professor,4796,282,5078
34754,Lisha,Vernau,lvernau3j@plala.or.jp,Speech Pathologist,9671,392,10063
34400,Sayres,Drinkhall,sdrinkhall3m@epa.gov,Web Developer II,6126,451,6577
34223,Florina,Hardy,fhardy3n@sohu.com,Engineer III,1593,591,2184
34315,Ardine,Blampied,ablampied3p@google.co.jp,Financial Analyst,3303,653,3956
34104,Ashely,Cramond,acramond3q@e-recht24.de,Assistant Media Planner,3191,416,3607
34482,Paige,Heis,pheis3r@oaic.gov.au,Automation Specialist II,6597,1957,8554
34050,Liva,Sollas,lsollas3t@youtube.com,Civil Engineer,9426,1332,10758
34826,Jean,Flew,jflew3v@fastcompany.com,Design Engineer,2508,854,3362
34970,Evy,Yekel,eyekel3w@soundcloud.com,Help Desk Operator,4451,1943,6394
34232,Nana,Teaze,nteaze3x@shutterfly.com,Editor,4406,1496,5902
34947,Ralph,Chidwick,rchidwick3y@livejournal.com,VP Product Management,9045,826,9871
34937,Katerine,Hirche,khirche40@ocn.ne.jp,Recruiter,4684,608,5292
34902,Dal,Davydoch,ddavydoch41@twitpic.com,Legal Assistant,6407,1803,8210
34602,Gwyn,Balaizot,gbalaizot42@howstuffworks.com,Social Worker,4561,732,5293
34760,Sauveur,Lamond,slamond43@canalblog.com,Developer IV,5034,228,5262
34068,Tedie,Spon,tspon44@webnode.com,Analyst Programmer,4179,966,5145
34343,Faustine,Mapstone,fmapstone45@wikipedia.org,Technical Writer,4647,1163,5810
34858,Krishnah,Ellingsworth,kellingsworth47@wikimedia.org,Web Designer III,1375,1704,3079
34396,Leeland,Pulford,lpulford48@marriott.com,Food Chemist,5549,1512,7061
34229,Jeanelle,Pavkovic,jpavkovic49@netlog.com,Research Nurse,7120,1765,8885
34055,Juliann,Fass,jfass4b@slate.com,VP Marketing,6843,1765,8608
34265,Edgardo,De Beauchemp,edebeauchemp4c@abc.net.au,Web Developer IV,5331,1209,6540
34453,Kathye,Rumming,krumming4d@archive.org,Web Designer I,7886,609,8495
34896,Neil,Warren,nwarren4e@dailymail.co.uk,Computer Systems Analyst I,8980,983,9963
34845,Chancey,Kubyszek,ckubyszek4g@smh.com.au,Environmental Tech,1167,1474,2641
34260,Beverie,Meany,bmeany4h@prlog.org,VP Sales,5941,315,6256
34512,Constantina,McCarthy,cmccarthy4i@nhs.uk,Assistant Media Planner,6397,385,6782
34557,Jeffy,Trunks,jtrunks4j@time.com,Registered Nurse,1240,878,2118
34830,Rodrick,Shoobridge,rshoobridge4k@oracle.com,Programmer Analyst IV,9045,1690,10735
34329,Morgan,Midghall,mmidghall4l@java.com,Community Outreach Specialist,4624,1016,5640
34913,Iolanthe,Jearum,ijearum4m@smh.com.au,Research Nurse,2682,870,3552
34114,Cathy,Bendan,cbendan4n@macromedia.com,Accounting Assistant II,7347,608,7955
34442,Lay,Eadie,leadie4o@usa.gov,Senior Sales Associate,6832,1681,8513
34047,Rustin,Cory,rcory4p@webs.com,Geologist II,9627,1629,11256
34231,Gasparo,Toth,gtoth4q@virginia.edu,Desktop Support Technician,2413,1689,4102
34555,Selie,Boyet,sboyet4s@youku.com,Web Designer I,3317,740,4057
34791,Bert,Oakenfield,boakenfield4t@deviantart.com,Senior Developer,2190,432,2622
34530,Damiano,Daile,ddaile4u@aol.com,Software Consultant,8600,473,9073
34011,Ingeborg,Beretta,iberetta4w@walmart.com,Structural Analysis Engineer,2271,1281,3552
34296,Ertha,Clamp,eclamp4x@imageshack.us,Accountant III,8934,1342,10276
34678,Art,Jaher,ajaher4y@telegraph.co.uk,VP Product Management,2578,1013,3591
34362,Curtice,McAlinden,cmcalinden50@last.fm,Software Consultant,6908,791,7699
34889,Cesar,Barraclough,cbarraclough51@elpais.com,Senior Editor,1846,1713,3559
34227,Jerad,Speirs,jspeirs52@php.net,Senior Cost Accountant,6033,845,6878
34337,Toni,Scrace,tscrace53@sciencedaily.com,Staff Accountant II,5188,1945,7133
34624,Wilhelmina,Chipperfield,wchipperfield54@ustream.tv,Social Worker,3407,562,3969
34544,Selestina,Cocozza,scocozza55@google.it,Design Engineer,6842,970,7812
34877,Peyton,Muckeen,pmuckeen56@twitter.com,Database Administrator I,4775,606,5381
34920,Marian,Faustian,mfaustian58@dmoz.org,Help Desk Technician,7501,934,8435
34087,Silvia,Patterfield,spatterfield59@altervista.org,Junior Executive,8866,1876,10742
34115,Ansley,Chaff,achaff5a@harvard.edu,Legal Assistant,3301,884,4185
34916,Chico,Sprull,csprull5b@yelp.com,Structural Engineer,5688,1908,7596
34186,Estel,Hulance,ehulance5c@webnode.com,Account Coordinator,9220,1717,10937
34113,Wald,O'Dunneen,wodunneen5d@goodreads.com,Chemical Engineer,1573,428,2001
34567,Hyacinthia,Buston,hbuston5e@who.int,Teacher,9630,1935,11565
34004,Belva,Dran,bdran5f@bluehost.com,Civil Engineer,4699,1758,6457
34613,Hebert,Vassel,hvassel5g@over-blog.com,Office Assistant I,8860,1414,10274
34112,Tades,Kirrens,tkirrens5h@tumblr.com,Graphic Designer,2260,1112,3372
34189,Orsola,Tungay,otungay5j@ucsd.edu,Accounting Assistant III,4404,1530,5934
34110,Griselda,Nash,gnash5k@ted.com,Financial Advisor,9229,506,9735
34541,Kym,McGraw,kmcgraw5l@dell.com,Systems Administrator I,8234,381,8615
34794,Corby,Wittering,cwittering5m@telegraph.co.uk,Dental Hygienist,3280,1005,4285
34082,Gail,Kendal,gkendal5n@umich.edu,Librarian,4936,1603,6539
34165,Wally,Doughill,wdoughill5p@gov.uk,Tax Accountant,9244,1226,10470
34234,Sindee,Tuck,stuck5q@utexas.edu,Research Assistant IV,4111,755,4866
34735,Gabriel,Openshaw,gopenshaw5r@elpais.com,VP Accounting,2326,1375,3701
34184,Tybi,Spendlove,tspendlove5s@paypal.com,Computer Systems Analyst IV,4770,1988,6758
34228,Sigfried,Covotto,scovotto5t@ifeng.com,Database Administrator II,6831,1959,8790
34001,Valerye,Sharplin,vsharplin5u@hexun.com,Compensation Analyst,3917,1846,5763
34712,Alan,Westphal,awestphal5v@themeforest.net,Help Desk Technician,7926,1537,9463
34003,Tyne,Gunson,tgunson5x@theatlantic.com,Editor,5182,751,5933
34369,Jordana,Gerrett,jgerrett5y@admin.ch,Marketing Manager,3334,1705,5039
34867,Shanda,Silverstone,ssilverstone5z@homestead.com,Analog Circuit Design manager,7531,238,7769
34720,Rozella,Manvell,rmanvell60@ustream.tv,Tax Accountant,9043,960,10003
34395,Archibald,Chiplen,achiplen61@icio.us,VP Marketing,3993,1486,5479
34335,Chance,Cleevely,ccleevely62@storify.com,Engineer II,3212,1375,4587
34216,Eulalie,Found,efound63@springer.com,Marketing Manager,8510,1175,9685
34825,Wini,Garthshore,wgarthshore64@wikia.com,Analog Circuit Design manager,2066,961,3027
34038,Cathy,Thomton,cthomton65@ehow.com,Senior Sales Associate,7595,340,7935
34935,Odele,Di Bernardo,odibernardo66@washingtonpost.com,Editor,5097,1932,7029
34957,Berti,Edowes,bedowes68@ycombinator.com,Financial Advisor,6754,734,7488
34856,Ermengarde,Luker,eluker69@smh.com.au,Director of Sales,3590,664,4254
34903,Ferdie,Alcock,falcock6a@bloomberg.com,Executive Secretary,8872,1145,10017
34784,Jonas,Harkess,jharkess6b@webmd.com,Financial Advisor,9965,1203,11168
34841,Alix,Longfut,alongfut6c@ehow.com,Computer Systems Analyst II,7806,713,8519
34715,Che,Wherry,cwherry6d@toplist.cz,Administrative Officer,2885,1936,4821
34570,Clayborne,O'Doherty,codoherty6e@baidu.com,Nurse Practicioner,5100,808,5908
34403,Will,Reubbens,wreubbens6f@wp.com,Marketing Manager,9651,521,10172
34006,Der,Sliman,dsliman6g@scientificamerican.com,Editor,2495,224,2719
34673,Inglis,Ansley,iansley6i@businessinsider.com,Occupational Therapist,2960,800,3760
34644,Ainslie,Hoofe,ahoofe6l@printfriendly.com,Senior Editor,4568,1457,6025
34075,Colin,Rosencwaig,crosencwaig6n@facebook.com,Office Assistant III,7904,1222,9126
34607,Sylvia,Pittel,spittel6q@globo.com,Nurse,1454,576,2030
34988,Dory,Thresher,dthresher6s@cornell.edu,Research Nurse,8028,1168,9196
34500,Chucho,O'Doogan,codoogan6t@foxnews.com,Design Engineer,6873,920,7793
34182,Lilllie,Pawel,lpawel6u@is.gd,Sales Representative,7222,1521,8743
34860,Gaven,Rudman,grudman6v@rakuten.co.jp,Data Coordiator,7658,1237,8895
34504,Jo ann,Raymen,jraymen6w@usda.gov,Professor,1126,1832,2958
34781,Jacqueline,Millichip,jmillichip6x@dell.com,Junior Executive,9004,1114,10118
34423,Kippie,Scapens,kscapens6y@pen.io,Design Engineer,2340,1886,4226
34044,Gallagher,Simmans,gsimmans6z@cnet.com,Project Manager,9794,1648,11442
34388,Della,Ruckledge,druckledge70@examiner.com,Marketing Manager,3485,958,4443
34594,Jon,Kitching,jkitching72@telegraph.co.uk,VP Sales,3906,612,4518
34268,Jake,Pelman,jpelman73@java.com,Professor,8027,982,9009
34406,Ricki,Prettjohn,rprettjohn74@stanford.edu,Computer Systems Analyst I,7812,1150,8962
34402,Babara,Dmitrievski,bdmitrievski75@delicious.com,Account Executive,5683,1839,7522
34599,Dorian,Hanham,dhanham79@fotki.com,Environmental Specialist,9712,355,10067
34239,Mickie,Jolliff,mjolliff7b@fda.gov,Editor,4967,631,5598
34976,Emmerich,Rowet,erowet7c@unblog.fr,Junior Executive,7126,1183,8309
34507,Hayley,Wallworke,hwallworke7e@t.co,Account Coordinator,9160,1974,11134
34533,Duffy,Yashin,dyashin7f@naver.com,Director of Sales,2947,1959,4906
34806,Oralie,Gowanson,ogowanson7g@oakley.com,Recruiting Manager,1131,1145,2276
34222,Win,Rubinsaft,wrubinsaft7h@whitehouse.gov,Food Chemist,2842,245,3087
34065,Vinnie,Pudan,vpudan7i@foxnews.com,Payment Adjustment Coordinator,3799,1739,5538
34314,Regine,Bansal,rbansal7j@paypal.com,Recruiting Manager,8687,334,9021
34145,Mireille,Abbess,mabbess7k@stanford.edu,Executive Secretary,6633,1637,8270
34900,Katheryn,Muffett,kmuffett7l@bbb.org,Paralegal,1820,1128,2948
34683,Shirline,Forgie,sforgie7m@squidoo.com,Environmental Specialist,6008,505,6513
34857,Brion,Krolik,bkrolik7o@delicious.com,Budget/Accounting Analyst III,2831,1427,4258
34495,Cordell,Louth,clouth7r@themeforest.net,Account Representative II,3536,526,4062
34365,Cleon,Fidgeon,cfidgeon7s@irs.gov,Web Developer III,6783,913,7696
34534,Meredithe,Ilyuchyov,milyuchyov7t@gnu.org,Physical Therapy Assistant,2104,1832,3936
34019,Donny,Boch,dboch7v@sogou.com,VP Accounting,1221,1627,2848
34225,Hedwiga,Dabels,hdabels7x@ycombinator.com,Engineer IV,2685,666,3351
34708,Corinna,Lorman,clorman7z@bluehost.com,Biostatistician IV,8177,368,8545
34359,Marcel,Frankish,mfrankish80@mit.edu,Speech Pathologist,4823,814,5637
34606,Koralle,Yonge,kyonge81@linkedin.com,Director of Sales,7594,1832,9426
34496,Janean,Barette,jbarette82@ycombinator.com,Speech Pathologist,3643,539,4182
34634,Helenelizabeth,Fyldes,hfyldes83@spiegel.de,Mechanical Systems Engineer,8509,869,9378
34771,Avram,Lewsam,alewsam84@ed.gov,GIS Technical Architect,6488,452,6940
34625,Galven,Chard,gchard85@apple.com,Database Administrator IV,6771,1478,8249
34665,Court,Willgoss,cwillgoss86@boston.com,Graphic Designer,1862,1290,3152
34100,Julietta,Trippett,jtrippett87@woothemes.com,Analog Circuit Design manager,9721,869,10590
34022,Emanuel,Cattini,ecattini88@chronoengine.com,Staff Accountant II,7328,1190,8518
34271,Thorvald,Witnall,twitnall89@is.gd,VP Marketing,1655,1252,2907
34600,Bea,Monck,bmonck8a@va.gov,Executive Secretary,8586,995,9581
34012,Bert,Atwool,batwool8b@adobe.com,Senior Sales Associate,8726,614,9340
34273,Janetta,Drable,jdrable8c@kickstarter.com,Mechanical Systems Engineer,3343,442,3785
34143,Kaile,Rizzardini,krizzardini8e@sun.com,VP Product Management,8719,603,9322
34392,Jill,Bittlestone,jbittlestone8f@engadget.com,Actuary,5872,201,6073
34529,Bonnibelle,Hazelden,bhazelden8g@geocities.jp,Design Engineer,7501,1673,9174
34283,Haleigh,Helsby,hhelsby8i@shareasale.com,Marketing Assistant,6888,702,7590
34194,Rory,Dabling,rdabling8j@mapquest.com,VP Quality Control,7379,771,8150
34040,Pepito,Alway,palway8k@flavors.me,Software Consultant,1963,1304,3267
34763,Vitia,Rape,vrape8l@ed.gov,Software Consultant,5468,1681,7149
34497,Muire,Offa,moffa8m@devhub.com,Design Engineer,9939,853,10792
34233,Helenka,Gowrie,hgowrie8n@weather.com,Paralegal,1258,1121,2379
34532,Rhodie,Trehearne,rtrehearne8o@ihg.com,Director of Sales,7464,713,8177
34654,Nathanael,Earwaker,nearwaker8p@virginia.edu,Software Test Engineer II,3683,1889,5572
34655,Katrine,Ruseworth,kruseworth8q@ed.gov,Project Manager,5933,1194,7127
34505,Bliss,Danels,bdanels8r@vkontakte.ru,Senior Financial Analyst,6722,632,7354
34746,Hillary,Barwell,hbarwell8s@booking.com,Dental Hygienist,5484,463,5947
34045,Laurel,Gummory,lgummory8t@blogtalkradio.com,Environmental Tech,9686,1776,11462
34572,Jamesy,Bareford,jbareford8u@vkontakte.ru,Account Executive,3846,1957,5803
34030,Eamon,Spoure,espoure8v@liveinternet.ru,Senior Quality Engineer,8700,348,9048
34578,Ansel,Whimpenny,awhimpenny8w@buzzfeed.com,Media Manager I,7662,687,8349
34399,Friederike,Billson,fbillson8x@independent.co.uk,Teacher,5086,1643,6729
34604,Zonnya,Frodsam,zfrodsam8y@psu.edu,VP Quality Control,9823,368,10191
34069,Cybil,Cholmondeley,ccholmondeley8z@unesco.org,Help Desk Operator,3767,1600,5367
34977,Bridgette,Northey,bnorthey90@dyndns.org,Statistician IV,1325,702,2027
34987,Waldemar,Biesty,wbiesty92@yandex.ru,Analyst Programmer,2225,1695,3920
34938,Sterne,Sutherington,ssutherington93@theatlantic.com,Structural Analysis Engineer,6882,407,7289
34212,Norby,Theodoris,ntheodoris95@webs.com,Registered Nurse,1010,1029,2039
34982,Jennie,Reder,jreder96@vk.com,Office Assistant IV,9629,1209,10838
34836,Cathryn,Assiter,cassiter99@hibu.com,Administrative Officer,2053,1626,3679
34445,Noni,Philps,nphilps9a@sphinn.com,Financial Analyst,5487,1191,6678
34226,Annemarie,Anton,aanton9c@rediff.com,Account Executive,3101,1493,4594
34008,Nolie,Polo,npolo9d@mysql.com,Software Engineer I,3488,1335,4823
34632,Felecia,Menguy,fmenguy9f@oracle.com,Dental Hygienist,8663,1457,10120
34084,Sherry,McKeowon,smckeowon9g@feedburner.com,Nurse,4329,1731,6060
34349,Frank,Mahomet,fmahomet9h@linkedin.com,Director of Sales,6732,724,7456
34010,Issie,Ryley,iryley9i@scientificamerican.com,Mechanical Systems Engineer,6517,508,7025
34070,Persis,Milsap,pmilsap9j@google.com.br,Professor,6748,682,7430
34868,Delmore,Sulter,dsulter9l@linkedin.com,VP Marketing,3201,1149,4350
34346,Gisela,Honacker,ghonacker9m@latimes.com,Geologist IV,4812,1753,6565
34722,Michell,Upchurch,mupchurch9n@google.com.hk,Nuclear Power Engineer,8049,431,8480
34689,Quincy,Heller,qheller9p@sakura.ne.jp,Administrative Assistant I,9098,402,9500
34862,Erl,Leglise,eleglise9s@google.de,Software Test Engineer IV,1600,848,2448
34214,Caterina,Roxbrough,croxbrough9t@newsvine.com,Legal Assistant,7038,848,7886
34658,Rosemarie,Bastide,rbastide9u@bbc.co.uk,Teacher,7242,1005,8247
34456,Sayre,Goulston,sgoulston9w@imdb.com,Assistant Professor,4682,1177,5859
34384,Gustave,Svanetti,gsvanetti9x@hud.gov,Structural Analysis Engineer,8926,1978,10904
34779,Rolph,Schwartz,rschwartz9y@gov.uk,General Manager,4201,330,4531
34661,Tades,MacPadene,tmacpadene9z@gravatar.com,Budget/Accounting Analyst III,9303,463,9766
34807,Ferdinande,Walak,fwalaka1@skyrock.com,Automation Specialist III,4245,1029,5274
34367,Larisa,O'Donoghue,lodonoghuea3@marriott.com,Administrative Officer,9584,786,10370
34589,Yalonda,Ferryman,yferrymana4@live.com,Structural Engineer,2249,1884,4133
34853,Kaylyn,Mangam,kmangama5@fda.gov,Budget/Accounting Analyst IV,9293,768,10061
34390,Sydney,Gillice,sgillicea6@ycombinator.com,Technical Writer,3455,1270,4725
34215,Merle,Echlin,mechlina7@bizjournals.com,Financial Analyst,9610,1384,10994
34631,Myrilla,Burtenshaw,mburtenshawa8@vk.com,Associate Professor,3512,1481,4993
34728,Neddie,Basson,nbassonaa@ca.gov,Safety Technician IV,3175,787,3962
34354,Bree,Iwanowicz,biwanowiczab@statcounter.com,Safety Technician II,7754,372,8126
34052,Kristien,Covill,kcovillae@mashable.com,Director of Sales,8664,356,9020
34972,Marco,Antonomoli,mantonomoliag@tinypic.com,Tax Accountant,9509,293,9802
34360,Sinclare,Biset,sbisetai@nasa.gov,Database Administrator II,8463,1030,9493
34571,Francoise,Golborn,fgolbornaj@google.pl,Account Representative I,7117,1576,8693
34364,Byram,Rowswell,browswellal@webnode.com,Sales Representative,4989,1192,6181
34716,Field,Crosswaite,fcrosswaiteam@google.it,Design Engineer,9536,1382,10918
34979,Guenna,Endrici,gendriciao@furl.net,VP Accounting,3498,1937,5435
34334,Lura,Isaac,lisaacap@nhs.uk,Clinical Specialist,6585,1728,8313
34230,Carlo,Pugsley,cpugsleyaq@wikipedia.org,Editor,9902,1412,11314
34326,Worth,Bowich,wbowichar@zdnet.com,Clinical Specialist,9880,1647,11527
34603,Noel,MacDermand,nmacdermandat@sbwire.com,Research Nurse,7050,254,7304
34517,Sherlocke,Piggen,spiggenav@discovery.com,Design Engineer,7604,1887,9491
34684,Rosetta,Burgh,rburghaw@rediff.com,Dental Hygienist,5071,1283,6354
34187,Korella,Wallentin,kwallentinax@spotify.com,Nurse,2253,1484,3737
34649,Joanie,Birtonshaw,jbirtonshaway@weibo.com,Environmental Specialist,9498,1728,11226
34894,Rosalie,Snozzwell,rsnozzwellb0@ucoz.ru,Biostatistician I,7169,556,7725
34804,Robbie,Eakin,reakinb1@live.com,Accountant II,6635,1896,8531
34455,Alia,Joel,ajoelb4@4shared.com,Budget/Accounting Analyst II,2229,658,2887
34351,Carlene,Darlington,cdarlingtonb5@biglobe.ne.jp,Senior Editor,8403,1355,9758
34332,Penn,Almak,palmakb8@ucla.edu,Senior Financial Analyst,5156,1884,7040
34850,Arlie,D'Angeli,adangelib9@ihg.com,Product Engineer,3670,365,4035
34197,Verney,Reed,vreedbb@weibo.com,Assistant Manager,8995,693,9688
34154,Farrand,Found,ffoundbc@google.de,Accountant I,3412,1286,4698
34450,Lari,Hordle,lhordlebd@japanpost.jp,Legal Assistant,3536,1395,4931
34136,Nicky,Wilkin,nwilkinbe@wordpress.org,Health Coach II,1598,717,2315
34419,Andrei,Lythgoe,alythgoebf@about.com,Accountant II,4303,1978,6281
34219,Dodi,Murrell,dmurrellbg@diigo.com,Structural Engineer,9343,1075,10418
34951,Duane,Falkinder,dfalkinderbh@biglobe.ne.jp,Internal Auditor,7594,1466,9060
34792,Addy,Corpes,acorpesbj@yolasite.com,Social Worker,2032,955,2987
34711,Alexio,Bowery,abowerybk@hubpages.com,Sales Representative,1208,1575,2783
34546,Willa,Gazzard,wgazzardbl@sciencedaily.com,Business Systems Development Analyst,9143,1785,10928
34952,Merla,MacKinnon,mmackinnonbm@shareasale.com,Internal Auditor,1403,1825,3228
34671,Foss,Hune,fhunebn@purevolume.com,VP Product Management,2022,632,2654
34483,Thor,Ashfull,tashfullbq@elegantthemes.com,Nurse Practicioner,7666,1286,8952
34435,Chauncey,Rottery,crotterybr@ox.ac.uk,VP Marketing,1743,1296,3039
34586,Dougie,Dumini,dduminibs@berkeley.edu,Quality Engineer,5064,1669,6733
34598,Even,Sans,esansbt@about.me,Web Designer II,6499,807,7306
34924,Melosa,Poolman,mpoolmanbu@engadget.com,Environmental Specialist,7087,238,7325
34377,Zebedee,Davitti,zdavittibx@github.com,Statistician I,6266,1570,7836
34405,Karel,Lambard,klambardbz@howstuffworks.com,Media Manager II,1101,422,1523
34849,Forbes,Chaudret,fchaudretc0@de.vu,General Manager,8878,1518,10396
34915,Devonna,Brosnan,dbrosnanc1@springer.com,Administrative Officer,5721,1851,7572
34382,Taite,Wilshere,twilsherec2@pinterest.com,Physical Therapy Assistant,6043,1688,7731
34953,Eilis,Thorsen,ethorsenc3@weather.com,Structural Engineer,1549,959,2508
34127,Aridatha,Menicomb,amenicombc4@sogou.com,Media Manager IV,6278,532,6810
34891,Libbi,Boodell,lboodellc5@sbwire.com,Assistant Media Planner,2484,1565,4049
34772,Salaidh,Laffling,slafflingc6@homestead.com,Software Test Engineer II,1717,1712,3429
34949,Kania,Scherer,kschererc7@thetimes.co.uk,Compensation Analyst,5457,1921,7378
34906,Karla,Kinsley,kkinsleyc8@cmu.edu,Occupational Therapist,1147,483,1630
34551,Ambrose,Doddrell,adoddrellca@skyrock.com,Design Engineer,3079,1591,4670
34965,Shaw,Bartoleyn,sbartoleyncb@nih.gov,Computer Systems Analyst I,6665,354,7019
34984,Horst,Blois,hbloiscc@geocities.com,Help Desk Technician,9496,378,9874
34256,Ali,Mounsey,amounseycd@weather.com,Senior Sales Associate,7179,1826,9005
34305,Annora,Ivanyushkin,aivanyushkince@cbslocal.com,Marketing Manager,3532,1339,4871
34796,Trevar,Simcock,tsimcockch@umn.edu,Physical Therapy Assistant,7128,687,7815
34085,Yancy,Fortey,yforteyci@mozilla.org,Marketing Manager,9065,1185,10250
34413,Penny,O'Dempsey,podempseycj@bbb.org,Financial Analyst,5809,749,6558
34623,Ebba,Hammerman,ehammermancl@hao123.com,Programmer Analyst II,5996,891,6887
34762,Mirelle,Bowley,mbowleycm@zdnet.com,Programmer Analyst I,3326,203,3529
34299,Koressa,Leif,kleifcn@jalbum.net,Technical Writer,8436,1278,9714
34592,Leonore,Bentote,lbentoteco@exblog.jp,Project Manager,5902,1893,7795
34993,Inez,Leeke,ileekecp@hubpages.com,Registered Nurse,4346,420,4766
34107,Mariana,Spillett,mspillettcq@comsenz.com,Research Assistant IV,5653,1114,6767
34020,Carlotta,Coburn,ccoburncr@angelfire.com,Cost Accountant,5123,474,5597
34560,Ervin,Cambell,ecambellcs@google.com.hk,Developer III,7919,1619,9538
34919,Roxane,Sinkin,rsinkincu@xing.com,Marketing Assistant,7871,463,8334
34048,Tadio,Rillett,trillettcv@usnews.com,Senior Developer,1929,1382,3311
34211,Chicky,Dumelow,cdumelowcw@weather.com,Product Engineer,8740,1947,10687
34370,Lara,Jewkes,ljewkescz@moonfruit.com,Structural Engineer,1545,1071,2616
34073,Kirby,Gotliffe,kgotliffed0@huffingtonpost.com,Geological Engineer,3211,1452,4663
34559,Quinlan,Bockin,qbockind4@hao123.com,VP Product Management,5041,1064,6105
34870,Babara,Braghini,bbraghinid5@pen.io,Computer Systems Analyst II,1446,1061,2507
34151,Eryn,Ladbrooke,eladbrooked6@surveymonkey.com,Senior Sales Associate,3038,529,3567
34371,Rufe,Arundell,rarundelld8@goo.gl,Civil Engineer,6060,1225,7285
34647,Cristi,Redmore,credmored9@epa.gov,Environmental Specialist,3812,1073,4885
34831,Benny,Bellinger,bbellingerda@weibo.com,Sales Associate,9852,778,10630
34307,Penrod,Micklem,pmicklemdb@howstuffworks.com,Media Manager II,1444,207,1651
34975,Addie,Bartos,abartosdc@dailymail.co.uk,Database Administrator III,5024,727,5751
34682,Clarie,McCollum,cmccollumdd@freewebs.com,Registered Nurse,7204,1206,8410
34795,Jacky,Merigeau,jmerigeaude@mtv.com,Speech Pathologist,4531,523,5054
34556,Dieter,Lockier,dlockierdi@wikimedia.org,Research Nurse,5603,1934,7537
34805,Charyl,Brayn,cbrayndm@desdev.cn,Financial Advisor,3721,1357,5078
34736,Alix,Grigori,agrigoridn@cbsnews.com,Programmer I,6468,1795,8263
34490,Winfred,Abbate,wabbatedo@woothemes.com,VP Sales,7384,1857,9241
34668,Jerrome,Leadston,jleadstondp@shutterfly.com,Geological Engineer,1941,742,2683
34088,Inna,Quarlis,iquarlisds@bandcamp.com,Occupational Therapist,6057,785,6842
34576,Stefanie,Chadwen,schadwendv@springer.com,Nuclear Power Engineer,5379,617,5996
34974,Eward,Cassin,ecassindw@furl.net,Product Engineer,3495,656,4151
34601,Lonnie,Fiddiman,lfiddimane4@telegraph.co.uk,General Manager,1246,452,1698
34770,Tanitansy,Halward,thalwarde5@privacy.gov.au,Office Assistant III,3917,850,4767
34348,Jenna,Zannutti,jzannuttie6@twitter.com,Database Administrator I,9063,480,9543
34909,Guillema,Phalip,gphalipea@discuz.net,Project Manager,4592,1826,6418
34213,Maris,Blakeslee,mblakesleeeb@google.com,Research Associate,4300,895,5195
34111,Terry,Tovey,ttoveyed@ow.ly,Assistant Media Planner,4533,1651,6184
35000,Kessiah,Philpots,kphilpotsee@ca.gov,Administrative Officer,5739,1521,7260
34416,Almeria,Rawet,araweteg@dot.gov,Project Manager,5435,1056,6491
34911,Libbey,Dybald,ldybaldej@blog.com,Environmental Specialist,4555,974,5529
34816,Wain,Kelbie,wkelbieek@devhub.com,Programmer Analyst II,7960,1926,9886
34340,Katherine,Balding,kbaldingem@livejournal.com,Senior Financial Analyst,7823,786,8609
34605,Valentijn,Dedden,vdeddeneq@so-net.ne.jp,Research Associate,6348,271,6619
34506,Eudora,Lemary,elemaryer@china.com.cn,Director of Sales,6107,1473,7580
34558,Rolfe,Cranfield,rcranfieldet@photobucket.com,Marketing Manager,9234,1694,10928
34983,Ebenezer,Oloman,eolomaneu@jugem.jp,Help Desk Operator,3588,385,3973
34264,Claiborn,Elphinstone,celphinstoneew@freewebs.com,Research Nurse,9567,1352,10919
34553,Patience,Wadley,pwadleyex@diigo.com,Professor,6457,1664,8121
34755,Hyatt,Honeywood,hhoneywoodez@furl.net,Teacher,4444,374,4818
34119,Nicola,O'Looney,nolooneyf0@tinypic.com,Technical Writer,3932,1943,5875
34472,Gwenore,McCosker,gmccoskerf1@goo.gl,Community Outreach Specialist,8493,960,9453
34522,Ron,Izakoff,rizakofff2@whitehouse.gov,Help Desk Operator,5436,1356,6792
34744,Harrietta,Berzon,hberzonf5@zimbio.com,Business Systems Development Analyst,9458,735,10193
34643,Melamie,Alderwick,malderwickf7@addtoany.com,Editor,3801,1105,4906
34732,Martyn,Temprell,mtemprellf8@homestead.com,Geologist IV,4877,690,5567
34309,Amerigo,Calladine,acalladinef9@shareasale.com,Staff Scientist,7044,809,7853
34981,Cindie,Donaldson,cdonaldsonfb@cam.ac.uk,Recruiting Manager,4279,1043,5322
34126,Minne,Tingey,mtingeyfc@webnode.com,Associate Professor,6798,452,7250
34195,Evaleen,Shippey,eshippeyfd@xinhuanet.com,Product Engineer,1425,469,1894
34969,George,Mayte,gmayteff@home.pl,VP Accounting,2835,1136,3971
34196,Vilma,Gyurkovics,vgyurkovicsfg@ed.gov,VP Sales,4019,1760,5779
34786,Lebbie,Grinham,lgrinhamfh@alexa.com,Staff Scientist,1141,1874,3015
34324,Amara,Lawrenceson,alawrencesonfi@yolasite.com,Internal Auditor,3972,531,4503
34731,Desdemona,Thouless,dthoulessfj@blogs.com,Web Developer II,8757,936,9693
34750,Titus,Ollerenshaw,tollerenshawfl@mayoclinic.com,Engineer III,1412,1709,3121
34617,Davy,Cranston,dcranstonfp@nasa.gov,Registered Nurse,9276,1027,10303
34859,Lara,McCaffrey,lmccaffreyfr@purevolume.com,Accounting Assistant I,9343,1323,10666
34041,Susannah,Sapena,ssapenafs@mail.ru,Operator,2429,1287,3716
34414,Stormy,Wellstead,swellsteadft@meetup.com,Marketing Assistant,3025,745,3770
34785,Rakel,Cancutt,rcancuttfu@goo.ne.jp,Human Resources Manager,2022,212,2234
34458,Talya,Gooch,tgoochfx@slideshare.net,Sales Associate,3944,795,4739
34844,Rosette,Poleye,rpoleyefy@weibo.com,Software Engineer I,2782,1308,4090
34443,Perry,MacAdam,pmacadamg0@biblegateway.com,Nurse Practicioner,4526,1627,6153
34725,Caprice,Looby,cloobyg2@ibm.com,Media Manager IV,4942,836,5778
34462,Emelita,Needham,eneedhamg4@unc.edu,Librarian,3674,289,3963
34440,Mordecai,McRonald,mmcronaldg5@vk.com,Associate Professor,5902,515,6417
34094,Josiah,Enoch,jenochg6@issuu.com,Sales Associate,8368,864,9232
34959,Coretta,Lanfere,clanfereg8@shop-pro.jp,Accountant III,9842,528,10370
34501,Letisha,Meredith,lmeredithg9@tumblr.com,Safety Technician I,5763,1859,7622
34470,Norean,Hindmore,nhindmoregb@alibaba.com,Environmental Specialist,5289,1274,6563
34585,Evaleen,Sivess,esivessge@com.com,Engineer II,2875,1615,4490
34080,Rubie,Lacase,rlacasegf@disqus.com,Assistant Manager,1693,886,2579
34749,Minnnie,Scothron,mscothrongi@mozilla.com,Physical Therapy Assistant,7923,1017,8940
34199,Vannie,Gordon,vgordongj@cocolog-nifty.com,Physical Therapy Assistant,2183,281,2464
34934,Peter,Aloway,palowaygl@ycombinator.com,Recruiting Manager,9837,1287,11124
34538,Charline,Anthoine,canthoinegm@cbc.ca,Statistician I,1694,241,1935
34220,Saree,Covey,scoveygn@ted.com,Financial Advisor,3712,1432,5144
34485,Dickie,Francello,dfrancellogp@weibo.com,Paralegal,1882,462,2344
34991,Christie,Rivelin,crivelingr@woothemes.com,Office Assistant II,2227,407,2634
34431,Davis,MacAnulty,dmacanultygu@noaa.gov,Technical Writer,6997,1337,8334
34863,Joellen,Gepson,jgepsongv@nasa.gov,Executive Secretary,6912,1797,8709
34207,Christie,Glastonbury,cglastonburygw@blogspot.com,Financial Advisor,2300,1290,3590
34899,Niccolo,Laffin,nlaffingx@discuz.net,GIS Technical Architect,8768,550,9318
34471,Hermia,Berrick,hberrickgy@ucoz.com,VP Accounting,6760,1656,8416
34516,Marika,Squirrel,msquirrelgz@altervista.org,Technical Writer,2137,697,2834
34897,Link,Thing,lthingh0@ameblo.jp,Civil Engineer,3934,1270,5204
34777,Fredrika,Topliss,ftoplissh3@php.net,Clinical Specialist,4340,998,5338
34344,Vail,Vertigan,vvertiganh7@themeforest.net,Marketing Assistant,9511,912,10423
34764,Rabi,Ateridge,rateridgeh8@is.gd,Environmental Tech,3628,1425,5053
34489,Caprice,Posselt,cposseltha@clickbank.net,Editor,7759,929,8688
34669,Valina,Ferrier,vferrierhd@netvibes.com,Database Administrator I,1503,288,1791
34834,Sauncho,Chomiszewski,schomiszewskihe@youtu.be,Software Consultant,4480,220,4700
34428,Bobbee,Dashkovich,bdashkovichhf@wsj.com,Quality Engineer,8789,875,9664
34248,Zoe,Dresser,zdresserhg@usda.gov,Programmer Analyst IV,4186,234,4420
34685,Nisse,Stuckow,nstuckowhi@cbsnews.com,Operator,4352,1601,5953
34910,Blisse,Siddeley,bsiddeleyhk@mlb.com,VP Product Management,5438,675,6113
34106,Alvan,Learoid,alearoidhm@tinyurl.com,Community Outreach Specialist,5006,1627,6633
34023,Arlene,Videler,avidelerhn@nyu.edu,Electrical Engineer,8942,1263,10205
34932,Guy,Breckell,gbreckellhq@irs.gov,Marketing Assistant,7467,1996,9463
34173,Bearnard,Sherwell,bsherwellhs@paypal.com,Geological Engineer,5072,360,5432
34679,Missie,Blackmore,mblackmorehu@is.gd,Tax Accountant,5142,240,5382
34352,Rossy,McOnie,rmconiehz@hao123.com,Desktop Support Technician,5668,1759,7427
34646,Gunar,Headey,gheadeyi0@walmart.com,VP Accounting,9277,1839,11116
34282,Brandise,Samsonsen,bsamsonseni1@gravatar.com,Payment Adjustment Coordinator,9131,913,10044
34018,Agustin,Crocumbe,acrocumbei2@networkadvertising.org,Accounting Assistant III,2847,1637,4484
34063,Yevette,McGooch,ymcgoochi3@time.com,Staff Scientist,2575,1631,4206
34209,Loree,Coats,lcoatsi4@slate.com,Nurse Practicioner,4957,1678,6635
34389,Catharine,Neighbour,cneighbouri6@123-reg.co.uk,Business Systems Development Analyst,3900,1795,5695
34839,Grove,Daens,gdaensi7@yahoo.com,Business Systems Development Analyst,2067,1370,3437
34361,Kale,McMurrugh,kmcmurrughi8@hhs.gov,Speech Pathologist,4454,1368,5822
34927,Melicent,Korda,mkordaia@sciencedaily.com,Junior Executive,9001,1307,10308
34385,Robinett,De La Cote,rdelacoteib@pbs.org,Senior Developer,1613,1152,2765
34164,Sibley,O'Dee,sodeeie@un.org,VP Accounting,5898,372,6270
34657,Genovera,Brannon,gbrannonif@hibu.com,Teacher,3741,207,3948
34966,Elmira,McDermot,emcdermotig@addtoany.com,Web Developer IV,8114,1779,9893
34714,Kelci,McCorley,kmccorleyih@moonfruit.com,Pharmacist,1559,475,2034
34713,Tabby,Dockrey,tdockreyii@imgur.com,Accounting Assistant II,8750,1362,10112
34918,Cleo,Dillinton,cdillintonil@gravatar.com,Health Coach IV,3603,1881,5484
34843,Mellisent,Anstice,mansticeio@vistaprint.com,Help Desk Technician,7313,356,7669
34125,Fancy,Walling,fwallingiq@yelp.com,Compensation Analyst,5924,908,6832
34745,Herrick,Orto,hortoir@moonfruit.com,Analyst Programmer,4226,397,4623
34438,Ky,Dottrell,kdottrellis@photobucket.com,Accountant II,3144,1539,4683
34102,Rooney,Sharrocks,rsharrocksiv@infoseek.co.jp,Physical Therapy Assistant,5324,1140,6464
34179,Loleta,Kroll,lkrolliy@artisteer.com,Editor,4952,415,5367
34493,Thomas,Stanwix,tstanwixiz@pbs.org,Recruiting Manager,9983,1555,11538
34718,Rivy,Thirlwall,rthirlwallj0@homestead.com,Civil Engineer,9594,1706,11300
34590,Ransom,Arnoldi,rarnoldij1@quantcast.com,Geologist I,1007,586,1593
34766,Bell,Buttler,bbuttlerj2@mlb.com,Pharmacist,3708,1863,5571
34998,Ginevra,Kleanthous,gkleanthousj3@cbc.ca,Teacher,5816,844,6660
34013,Leonerd,Kenward,lkenwardj4@dell.com,Financial Advisor,5203,1120,6323
34819,Hanan,Paolino,hpaolinoj6@google.cn,Web Designer III,6868,1343,8211
34875,Rab,Hasloch,rhaslochj7@pen.io,Civil Engineer,3030,1950,4980
34861,Sig,Blankman,sblankmanja@buzzfeed.com,Product Engineer,3962,1591,5553
34811,Meier,Brickner,mbricknerjc@nymag.com,Web Designer IV,9060,826,9886
34237,Dru,Yorath,dyorathjd@themeforest.net,Design Engineer,8155,1964,10119
34550,Torrin,Gateland,tgatelandje@dmoz.org,Quality Control Specialist,3957,582,4539
34150,Othilie,Kenwright,okenwrightjf@theatlantic.com,Statistician III,6830,1728,8558
34593,Hamlen,Fittis,hfittisjg@miitbeian.gov.cn,Quality Control Specialist,2072,564,2636
34628,Kandace,Martschik,kmartschikjh@sakura.ne.jp,Administrative Assistant I,4554,1584,6138
34884,Cordi,Juggings,cjuggingsjl@bloomberg.com,Internal Auditor,8672,1255,9927
34433,Roobbie,Levesley,rlevesleyjo@msn.com,Automation Specialist I,9450,1033,10483
34675,Robbie,Durtnell,rdurtnelljp@upenn.edu,Recruiter,6206,584,6790
34549,Johna,Littrick,jlittrickjq@hp.com,Technical Writer,6172,1060,7232
34840,Caron,Gilchrest,cgilchrestju@etsy.com,Legal Assistant,2302,1847,4149
34017,Bryan,Mattimoe,bmattimoejw@adobe.com,Staff Accountant IV,9945,710,10655
34373,Rhianna,Maroney,rmaroneyjx@multiply.com,Mechanical Systems Engineer,9738,1042,10780
34618,Brew,Wilsdon,bwilsdonk0@cam.ac.uk,Senior Financial Analyst,6630,1817,8447
34381,Gregg,Scatcher,gscatcherk1@issuu.com,Senior Financial Analyst,9596,857,10453
34865,Brigg,Hull,bhullk3@zimbio.com,Assistant Media Planner,8714,1152,9866
34686,Ludovico,Mollon,lmollonk6@businesswire.com,Administrative Officer,9702,368,10070
34962,Cherida,Slesser,cslesserk8@unc.edu,Human Resources Assistant III,9129,1726,10855
34259,Hadleigh,Kelbie,hkelbieka@irs.gov,Assistant Media Planner,7337,1274,8611
34887,Carce,McKall,cmckallkc@last.fm,Health Coach I,7657,550,8207
34287,Martie,Lehrle,mlehrlekh@histats.com,Editor,4957,863,5820
34681,Anastasie,Winstone,awinstonekk@amazon.de,Help Desk Technician,7146,1843,8989
34066,Darius,Welton,dweltonkn@go.com,Compensation Analyst,7574,395,7969
34723,Valdemar,Dominy,vdominykp@stumbleupon.com,Executive Secretary,4889,1132,6021
34254,Valene,Huccaby,vhuccabykr@last.fm,Data Coordiator,1996,1459,3455
34729,Royal,Hirche,rhircheks@baidu.com,Environmental Tech,6477,350,6827
34660,Cobb,Naughton,cnaughtonkt@google.es,Quality Control Specialist,2687,1134,3821
34492,Jaquenette,Sillars,jsillarskw@cyberchimps.com,Community Outreach Specialist,2499,447,2946
34821,Aleen,Gover,agoverkz@oakley.com,Geologist I,4696,1371,6067
34167,Lek,Flaune,lflaunel1@hubpages.com,Biostatistician III,9793,1770,11563
34936,Miran,Gutman,mgutmanl7@constantcontact.com,VP Accounting,9632,1519,11151
34293,Phil,Oxenbury,poxenburyl9@infoseek.co.jp,Executive Secretary,5370,1698,7068
34002,Julietta,Deary,jdearylb@wordpress.org,Occupational Therapist,3922,373,4295
34469,Amara,Morphey,amorpheylc@360.cn,Professor,8394,700,9094
34775,Alice,Bollom,abollomlh@wunderground.com,Accounting Assistant I,2378,914,3292
34690,Laney,Eighteen,leighteenlm@cbsnews.com,Paralegal,2369,832,3201
34028,Wright,Lowndes,wlowndesln@baidu.com,Associate Professor,7140,1416,8556
34333,Cayla,Bertl,cbertllr@ask.com,Engineer III,1052,1966,3018
34608,Giavani,Stollery,gstollerylu@ning.com,Help Desk Operator,7837,298,8135
34518,Kalindi,Raiment,kraimentlv@ucsd.edu,Compensation Analyst,6109,1324,7433
34486,Ricki,Pepineaux,rpepineauxlw@redcross.org,Project Manager,3927,1939,5866
34917,Randi,MacDaid,rmacdaidlx@ameblo.jp,Account Representative III,2722,1689,4411
34788,Any,Dewett,adewettm1@google.co.jp,Editor,3728,1389,5117
34401,Juliet,Dawidowitz,jdawidowitzm3@zimbio.com,Executive Secretary,2870,1218,4088
34799,Maryellen,Assaf,massafm4@shop-pro.jp,Nurse Practicioner,1063,357,1420
34584,Evania,Cavaney,ecavaneym5@furl.net,Paralegal,7235,1709,8944
34869,Deny,Sainz,dsainzm7@bizjournals.com,Account Coordinator,4277,1672,5949
34491,Caresa,McCaughey,cmccaugheym9@xrea.com,Senior Financial Analyst,1911,1415,3326
34904,Shani,Maxweell,smaxweellma@sciencedaily.com,Health Coach I,5926,1579,7505
34347,Thalia,Basile,tbasilemd@house.gov,Executive Secretary,3073,1873,4946
34802,Shanta,Jays,sjaysme@prweb.com,Research Assistant IV,4925,419,5344
34245,Jermaine,Agett,jagettmf@twitpic.com,Research Assistant III,3984,1088,5072
34561,Dotty,Geleman,dgelemanmh@php.net,Speech Pathologist,8476,1554,10030
34535,Lynne,Kidder,lkiddermo@bravesites.com,Teacher,3148,1484,4632
34142,Brigida,Goddard,bgoddardms@elpais.com,Research Assistant II,7302,1109,8411
34693,Doralin,Finden,dfindenmt@apache.org,Account Representative IV,9640,254,9894
34417,Cathyleen,Gibard,cgibardmx@miibeian.gov.cn,Engineer IV,9516,1949,11465
34907,Gar,Jindacek,gjindacekn1@usatoday.com,Teacher,9071,1081,10152
34741,Luca,McCrostie,lmccrostien2@instagram.com,VP Product Management,7852,1814,9666
34967,Clayborn,Colvill,ccolvilln5@hexun.com,Web Developer III,5542,351,5893
34060,Hervey,Eslinger,heslingern6@artisteer.com,Occupational Therapist,5651,1661,7312
34954,Gwyneth,Lambourne,glambournen7@rambler.ru,Media Manager I,4664,922,5586
34610,Prudi,Lowmass,plowmassnb@si.edu,Senior Editor,2068,1626,3694
34059,Mirabelle,Batson,mbatsonne@toplist.cz,VP Product Management,2624,1054,3678
34166,Binny,Ottosen,bottosenng@msn.com,Recruiting Manager,9051,1975,11026
34748,Jorry,Jina,jjinanx@bbc.co.uk,Developer III,7407,1703,9110
34872,Mada,Dyson,mdysonnz@thetimes.co.uk,Internal Auditor,3371,632,4003
34132,Cicily,Cromly,ccromlyo1@cisco.com,Engineer III,7629,340,7969
34236,Lisetta,MacPake,lmacpakeo2@umn.edu,Senior Cost Accountant,2773,1542,4315
34944,Somerset,Varden,svardeno5@ow.ly,Environmental Specialist,6475,1657,8132
34710,Bertrando,End,bendo7@ask.com,Internal Auditor,2203,221,2424
34521,Waite,Foulis,wfouliso8@cmu.edu,Operator,7727,890,8617
34183,Pamelina,Samwayes,psamwayeso9@mayoclinic.com,Graphic Designer,1269,1241,2510
34039,Barbabra,Dukelow,bdukelowoc@reuters.com,Senior Financial Analyst,2717,1858,4575
34206,Corette,Kees,ckeesoe@clickbank.net,Marketing Manager,1190,444,1634
34697,Lorelei,Gauntlett,lgauntlettof@forbes.com,Budget/Accounting Analyst III,7043,1987,9030
34527,Lester,Matysik,lmatysikoh@tumblr.com,Structural Engineer,3621,946,4567
34525,Anthe,Louca,aloucaom@joomla.org,Professor,9896,467,10363
34272,Reid,Zecchini,rzecchinion@newyorker.com,Engineer III,4264,1155,5419
34426,Beverley,Flowith,bflowithoq@kickstarter.com,Account Coordinator,4814,1823,6637
34024,Fielding,Edbrooke,fedbrookeos@berkeley.edu,Research Associate,7636,1175,8811
34090,Shaun,Phippin,sphippinot@google.nl,Civil Engineer,3437,1329,4766
34812,Sabrina,Hollington,shollingtonou@google.com.au,Computer Systems Analyst II,4543,548,5091
34994,Oralee,Aries,oariesov@ft.com,Developer IV,4945,1053,5998
34193,Arch,Mc Mechan,amcmechanox@springer.com,Environmental Specialist,8024,1576,9600
34357,Othella,Gaucher,ogaucheroy@marketwatch.com,Financial Advisor,8969,802,9771
34135,Odette,Sawden,osawdenp0@1und1.de,Account Coordinator,7715,546,8261
34275,Hewitt,Abelovitz,habelovitzp4@gravatar.com,Librarian,5592,1561,7153
34467,Tabitha,Sides,tsidesp7@blogs.com,Account Representative I,7028,935,7963
34477,Nathanial,Halgarth,nhalgarthpa@alibaba.com,Occupational Therapist,2705,1459,4164
34358,Shel,Visco,sviscopc@msn.com,Programmer III,1111,1479,2590
34854,Lil,Ollie,lollieph@zdnet.com,Dental Hygienist,1829,1844,3673
34171,Carissa,Deas,cdeaspj@smugmug.com,Web Designer IV,8233,1154,9387
34320,Emelda,Kaine,ekainepl@sphinn.com,Accounting Assistant IV,8871,579,9450
34823,Nessie,Grzeskowski,ngrzeskowskipn@xrea.com,VP Sales,4291,430,4721
34941,Paulie,Evill,pevillpo@slideshare.net,Editor,2395,294,2689
34338,Nicola,Dioniso,ndionisopp@cbslocal.com,Web Designer IV,4527,1499,6026
34118,Barbey,Epelett,bepelettpq@ehow.com,Pharmacist,7625,1078,8703
34883,Javier,Willimont,jwillimontpr@oracle.com,Human Resources Assistant IV,3547,493,4040
34457,Hakeem,Storey,hstoreypv@time.com,Budget/Accounting Analyst IV,6573,1014,7587
34885,Merrie,Collar,mcollarpw@behance.net,Cost Accountant,7786,1726,9512
34284,Nessie,Eustis,neustispy@over-blog.com,Research Nurse,8058,1554,9612
34269,Ingram,Guillerman,iguillermanq1@weibo.com,Teacher,9771,1056,10827
34503,Jarad,Middlemass,jmiddlemassq7@ft.com,Information Systems Manager,5086,1660,6746
34372,Fraze,Grindall,fgrindallq9@ucla.edu,Accounting Assistant IV,6763,780,7543
34257,Tristam,MacGilpatrick,tmacgilpatrickqd@usatoday.com,Operator,8456,610,9066
34452,Else,Doctor,edoctorqf@weibo.com,Research Associate,9881,212,10093
34198,Lin,Johnston,ljohnstonqg@businesswire.com,Administrative Assistant II,2973,1298,4271
34547,Odessa,Lusted,olustedqh@princeton.edu,Senior Cost Accountant,5172,1218,6390
34042,Danna,Endean,dendeanqk@discovery.com,Engineer III,3220,474,3694
34753,Bria,Hammatt,bhammattqr@blogtalkradio.com,Assistant Media Planner,8181,1327,9508
34302,Nadiya,Probet,nprobetqt@umn.edu,Pharmacist,1829,394,2223
34813,Florie,Ballantine,fballantineqx@google.nl,Human Resources Assistant I,2375,408,2783
34097,Vaughan,Fardell,vfardellqy@odnoklassniki.ru,Technical Writer,5467,567,6034
34742,Loy,Fenner,lfennerr0@jimdo.com,Account Representative IV,8120,808,8928
34901,Poppy,Popland,ppoplandr3@walmart.com,Community Outreach Specialist,2870,787,3657
34032,Sallyann,Ocklin,socklinr5@stanford.edu,Software Engineer II,5033,1069,6102
34995,Violette,Ganderton,vgandertonr6@dropbox.com,Teacher,9675,521,10196
34051,Almeta,Baumert,abaumertr7@rediff.com,Account Executive,7129,1149,8278
34101,Milo,Duchart,mduchartrf@mapy.cz,VP Product Management,7541,1667,9208
34391,Shayne,Turbern,sturbernrg@51.la,Food Chemist,9495,1521,11016
34680,Alfie,Tenniswood,atenniswoodrj@cpanel.net,Accounting Assistant IV,6149,1105,7254
34963,Brittany,Fairhall,bfairhallrl@imgur.com,Registered Nurse,2070,1828,3898
34459,Von,Presnell,vpresnellrp@mozilla.org,Systems Administrator II,8914,547,9461
35048,Cthrine,Joutapavicius,cjoutapavicius0@dailymail.co.uk,Engineer I,3129,1124,4253
35139,Gracie,Dupre,gdupre1@go.com,Developer I,1292,1739,3031
35007,Jo ann,Snarr,jsnarr2@amazon.co.uk,Internal Auditor,5465,1828,7293
35291,Bessie,Bennedsen,bbennedsen3@arstechnica.com,VP Quality Control,2734,417,3151
35689,Bevon,Clever,bclever4@newsvine.com,Senior Developer,8125,348,8473
35889,Regan,Scamadine,rscamadine5@reuters.com,VP Product Management,6692,1030,7722
35231,Maddie,Childes,mchildes6@hostgator.com,Dental Hygienist,6773,1797,8570
35017,Gabbie,Lafaye,glafaye7@canalblog.com,Media Manager II,8197,1324,9521
35652,Andy,Deaconson,adeaconson8@shutterfly.com,Human Resources Manager,4420,1442,5862
35983,Kaye,Vahey,kvahey9@livejournal.com,Financial Analyst,3944,466,4410
35247,Simone,Luquet,sluqueta@weebly.com,Programmer Analyst III,4819,334,5153
35682,Meredeth,Dilrew,mdilrewb@youtu.be,Actuary,8139,1827,9966
35324,Pip,Cuchey,pcucheyc@blogspot.com,Environmental Specialist,5853,518,6371
35911,Tadeo,Dowyer,tdowyerd@bloomberg.com,Software Test Engineer II,8613,629,9242
35170,Desmund,De Rechter,dderechtere@icio.us,Financial Analyst,7860,693,8553
35461,Jasmine,Kellie,jkellief@cam.ac.uk,Financial Analyst,7763,1747,9510
35087,Johann,Mahy,jmahyg@ocn.ne.jp,Social Worker,9862,1574,11436
35382,Corenda,Zelake,czelakeh@reddit.com,Environmental Tech,4714,292,5006
35665,Tad,Shoulders,tshouldersi@privacy.gov.au,Assistant Manager,1498,558,2056
35926,Kirstin,New,knewj@bizjournals.com,Environmental Tech,7239,629,7868
35339,Rancell,Haskey,rhaskeyk@house.gov,Research Assistant III,8145,840,8985
35960,Joelie,De Michetti,jdemichettil@networkadvertising.org,Accountant I,3462,655,4117
35604,Brenn,Trammel,btrammelm@usda.gov,Assistant Media Planner,4887,1312,6199
35698,Batsheva,Waterworth,bwaterworthn@chronoengine.com,Web Designer IV,9670,1057,10727
35364,Aryn,Thomasson,athomassono@utexas.edu,VP Marketing,3878,337,4215
35696,Clementia,Ross,crossp@opera.com,Biostatistician III,3278,926,4204
35749,Fayth,Squires,fsquiresq@mayoclinic.com,Software Consultant,3294,1754,5048
35640,Barnebas,Kaasmann,bkaasmannr@cnet.com,Recruiter,5803,756,6559
35668,Ardith,Bootell,abootells@w3.org,Database Administrator I,5964,836,6800
35807,Jenn,Looney,jlooneyt@goodreads.com,Nurse,3231,900,4131
35335,Abner,Batchelour,abatchelouru@nhs.uk,Civil Engineer,7887,1493,9380
35880,Maynard,Lough,mloughv@japanpost.jp,Help Desk Technician,6959,1629,8588
35845,Sibby,Thorius,sthoriusw@vistaprint.com,GIS Technical Architect,3674,1782,5456
35989,Lancelot,Bearsmore,lbearsmorex@oracle.com,Dental Hygienist,4505,1564,6069
35267,Zena,Ginty,zgintyy@so-net.ne.jp,Desktop Support Technician,1210,525,1735
35543,Marty,Salman,msalmanz@liveinternet.ru,Paralegal,2875,855,3730
35388,Idelle,Milella,imilella10@toplist.cz,VP Accounting,5835,276,6111
35783,Demetre,Baraclough,dbaraclough11@cbslocal.com,Junior Executive,8948,1581,10529
35512,Starr,Nobbs,snobbs12@ucsd.edu,Executive Secretary,3055,404,3459
35497,Andie,Renner,arenner13@usa.gov,Biostatistician II,2810,720,3530
35440,Marcy,Records,mrecords14@godaddy.com,Product Engineer,4582,990,5572
35986,Dori,Bafford,dbafford16@1688.com,Sales Representative,7872,379,8251
35641,Margy,Battleson,mbattleson17@independent.co.uk,Graphic Designer,2770,942,3712
35734,Myrvyn,Meanwell,mmeanwell18@goo.ne.jp,Research Nurse,7047,435,7482
35238,Bethanne,Jacmard,bjacmard19@amazon.co.jp,Editor,5513,1119,6632
35046,Roanna,Larmuth,rlarmuth1a@ning.com,Environmental Tech,2927,1507,4434
35827,Ashlie,Saffin,asaffin1b@4shared.com,Software Consultant,4191,1428,5619
35430,Harry,Dixcee,hdixcee1c@wufoo.com,Director of Sales,1852,1146,2998
35503,Mike,Glassard,mglassard1d@dyndns.org,Safety Technician I,6821,1243,8064
35950,Katharina,Blazynski,kblazynski1e@unc.edu,Administrative Assistant II,1466,240,1706
35976,Cyndie,Thal,cthal1f@nydailynews.com,Web Designer IV,1495,1980,3475
35102,Sherie,De Domenici,sdedomenici1g@amazon.com,Developer I,4391,942,5333
35101,Germaine,Jirasek,gjirasek1i@prnewswire.com,Nurse Practicioner,5165,425,5590
35808,Tara,Rosencrantz,trosencrantz1j@cdc.gov,Teacher,7733,705,8438
35202,Marco,Dressel,mdressel1k@amazon.co.uk,Research Assistant III,8340,1474,9814
35860,Carley,Gherarducci,cgherarducci1l@oracle.com,Executive Secretary,2862,1198,4060
35347,Rickard,Pawfoot,rpawfoot1m@yolasite.com,Clinical Specialist,7483,1213,8696
35906,Valene,Binch,vbinch1n@ehow.com,Account Coordinator,9349,318,9667
35679,Bayard,Snooks,bsnooks1o@apache.org,Human Resources Manager,1736,528,2264
35405,Harlen,Forri,hforri1p@time.com,Geological Engineer,7846,1257,9103
35531,Hale,Simeoli,hsimeoli1q@earthlink.net,VP Accounting,1344,1632,2976
35439,Bryn,Heigl,bheigl1r@ebay.co.uk,Sales Associate,1438,1218,2656
35515,Dyanne,Penas,dpenas1s@jugem.jp,Accountant IV,5311,1650,6961
35459,Linn,Minillo,lminillo1t@rambler.ru,Food Chemist,5482,1306,6788
35241,Willetta,Yankin,wyankin1u@ycombinator.com,Recruiter,3511,1174,4685
35756,Lorry,Vigours,lvigours1v@latimes.com,Safety Technician I,6810,930,7740
35340,Benjamin,Ginn,bginn1w@mapy.cz,Statistician II,8556,828,9384
35961,Lowrance,Brimblecombe,lbrimblecombe1x@indiegogo.com,Community Outreach Specialist,2547,1058,3605
35932,Aidan,Gayton,agayton1y@lulu.com,VP Product Management,1135,1502,2637
35326,Yvon,Bettington,ybettington1z@desdev.cn,Senior Financial Analyst,9996,1805,11801
35270,Sarine,Culverhouse,sculverhouse20@latimes.com,Research Assistant II,6606,254,6860
35567,Gavra,Shury,gshury21@merriam-webster.com,Assistant Media Planner,6558,496,7054
35207,Farlie,Hollier,fhollier22@home.pl,Software Engineer I,2203,1524,3727
35237,Arne,Negri,anegri23@privacy.gov.au,Senior Quality Engineer,4733,402,5135
35088,Carolyn,Rattrie,crattrie24@youku.com,Help Desk Operator,2412,1871,4283
35579,Donetta,Bassick,dbassick25@usa.gov,Marketing Manager,7102,1451,8553
35709,Albrecht,Blaber,ablaber26@businessinsider.com,Geologist II,5110,675,5785
35984,Candi,Brimicombe,cbrimicombe27@last.fm,Developer I,6752,382,7134
35019,Hannis,Dewing,hdewing28@alibaba.com,Recruiter,4368,723,5091
35498,Berk,Hurdedge,bhurdedge29@icio.us,Senior Cost Accountant,1521,1424,2945
35016,Foster,Corzon,fcorzon2a@diigo.com,Financial Analyst,4914,1494,6408
35365,Lawton,Syversen,lsyversen2b@reverbnation.com,Registered Nurse,7682,788,8470
35317,Leesa,Thirlwall,lthirlwall2c@tripod.com,GIS Technical Architect,6733,1807,8540
35481,Claudius,Shovell,cshovell2d@issuu.com,Marketing Assistant,4059,1402,5461
35809,Leo,Uden,luden2e@oaic.gov.au,Recruiter,3221,1196,4417
35400,Rozina,Chazerand,rchazerand2f@fc2.com,Nurse,7968,1350,9318
35418,Creighton,Costello,ccostello2g@nydailynews.com,Computer Systems Analyst IV,6474,1878,8352
35626,Arron,Seviour,aseviour2h@hugedomains.com,Software Test Engineer II,1266,1814,3080
35774,Gerik,Copyn,gcopyn2i@tiny.cc,Quality Control Specialist,8107,546,8653
35924,Ame,Luckman,aluckman2j@amazon.co.uk,Quality Control Specialist,1964,971,2935
35818,Melodie,Kenward,mkenward2k@shop-pro.jp,Budget/Accounting Analyst I,5398,513,5911
35624,Michal,Lightman,mlightman2l@flickr.com,Developer III,1485,1314,2799
35028,Sue,Baulch,sbaulch2m@over-blog.com,Recruiter,6125,920,7045
35217,Masha,Crinidge,mcrinidge2n@canalblog.com,GIS Technical Architect,7919,705,8624
35173,Matty,Wrathmell,mwrathmell2o@cargocollective.com,Occupational Therapist,3205,1062,4267
35897,Edie,Kryzhov,ekryzhov2p@mit.edu,GIS Technical Architect,9573,461,10034
35325,Marius,Maginn,mmaginn2q@shop-pro.jp,VP Product Management,6745,859,7604
35979,Bridie,Okenfold,bokenfold2s@jigsy.com,Registered Nurse,5427,556,5983
35029,Delbert,Vowden,dvowden2t@toplist.cz,Analyst Programmer,6716,868,7584
35586,Sunny,Bayly,sbayly2v@businessinsider.com,Senior Developer,1078,1617,2695
35158,Jorge,Murcutt,jmurcutt2w@t-online.de,Nurse Practicioner,2935,620,3555
35662,Dianne,Chittie,dchittie2y@ibm.com,Budget/Accounting Analyst II,6416,1620,8036
35863,Lesley,Carse,lcarse2z@ihg.com,Technical Writer,8185,1680,9865
35033,Ermin,Springall,espringall30@soundcloud.com,Technical Writer,4998,1633,6631
35590,Nady,Haggus,nhaggus31@xing.com,Software Consultant,7979,891,8870
35978,Rolando,Gutherson,rgutherson32@weibo.com,Financial Advisor,8402,1610,10012
35683,Cacilia,Westrip,cwestrip33@networkadvertising.org,Media Manager I,5916,605,6521
35547,Dukey,Howett,dhowett34@epa.gov,Occupational Therapist,8864,1829,10693
35922,Kliment,Kynston,kkynston36@dropbox.com,Financial Advisor,4909,1725,6634
35826,Rhonda,Monnelly,rmonnelly37@shinystat.com,Design Engineer,3418,1902,5320
35693,Stacia,Pinchon,spinchon38@t-online.de,Data Coordiator,2602,1891,4493
35189,Rycca,Tribell,rtribell39@gmpg.org,VP Accounting,4435,1479,5914
35616,Emalee,Berka,eberka3a@disqus.com,Web Designer II,5516,304,5820
35293,Jehanna,Caddens,jcaddens3b@oracle.com,Software Test Engineer II,5758,338,6096
35025,Livy,Dulanty,ldulanty3d@reuters.com,Account Representative III,7335,711,8046
35095,Cristi,Champken,cchampken3e@dion.ne.jp,Research Assistant II,3538,1961,5499
35982,Woody,Flatt,wflatt3f@ow.ly,Account Executive,3873,207,4080
35451,Caitlin,Hue,chue3g@europa.eu,Business Systems Development Analyst,6677,1859,8536
35673,Abbey,Brussels,abrussels3h@infoseek.co.jp,Web Developer IV,2300,1911,4211
35837,Roana,Revens,rrevens3j@github.com,Financial Advisor,7755,464,8219
35560,Harmonie,Pollastrone,hpollastrone3k@g.co,Help Desk Technician,5337,875,6212
35786,Mandy,Horney,mhorney3l@jalbum.net,Financial Analyst,4864,1675,6539
35952,Winnie,Sancto,wsancto3m@imgur.com,Recruiting Manager,5770,1857,7627
35900,Sydelle,Sweetmore,ssweetmore3n@pen.io,Occupational Therapist,2326,996,3322
35514,Ketti,Grosvenor,kgrosvenor3o@google.cn,Business Systems Development Analyst,1640,1683,3323
35766,Cosmo,Daleman,cdaleman3p@qq.com,Health Coach IV,8488,1649,10137
35681,Waldon,Michele,wmichele3q@ted.com,Internal Auditor,8248,1559,9807
35545,Lorene,Ugo,lugo3t@irs.gov,Recruiting Manager,8218,1066,9284
35254,Elnar,Ebdin,eebdin3u@berkeley.edu,GIS Technical Architect,9733,1689,11422
35919,Corabel,Boshere,cboshere3v@auda.org.au,Assistant Professor,5597,798,6395
35392,Marius,Camsey,mcamsey3w@yahoo.com,Business Systems Development Analyst,1708,678,2386
35721,Blinni,Broadfield,bbroadfield3x@usa.gov,Mechanical Systems Engineer,9329,881,10210
35887,Reube,Goodswen,rgoodswen3y@ning.com,Health Coach IV,8563,371,8934
35255,Jonathan,Kleinsinger,jkleinsinger3z@google.pl,Programmer I,8539,1699,10238
35329,Candi,Lively,clively40@house.gov,Chemical Engineer,4806,887,5693
35283,Cyrill,Pelman,cpelman41@mac.com,Administrative Assistant II,4208,1199,5407
35727,Cissy,Llewhellin,cllewhellin42@mtv.com,GIS Technical Architect,4528,1314,5842
35527,Norah,Redington,nredington43@pagesperso-orange.fr,Accountant IV,7825,942,8767
35399,Adham,Larrett,alarrett44@ft.com,Software Engineer III,6488,1034,7522
35856,Care,Krolle,ckrolle45@cbslocal.com,Chief Design Engineer,2143,222,2365
35915,Maxim,Ratie,mratie46@behance.net,Nurse,8085,1240,9325
35480,Sybille,Jantot,sjantot48@comcast.net,Editor,5602,1348,6950
35788,Danette,Waltering,dwaltering49@amazon.co.jp,Marketing Assistant,7549,1341,8890
35937,Waite,Say,wsay4a@twitpic.com,Librarian,2147,1900,4047
35666,Marlow,Nitto,mnitto4b@foxnews.com,Associate Professor,9737,478,10215
35395,Kevin,Nichols,knichols4c@ucoz.com,Senior Quality Engineer,4813,1993,6806
35123,Gui,Eaglesham,geaglesham4d@bravesites.com,Account Executive,5957,1086,7043
35944,Jaquenetta,Shearwood,jshearwood4f@wsj.com,Pharmacist,7542,1245,8787
35486,Solly,Cayzer,scayzer4g@earthlink.net,Health Coach III,8387,941,9328
35110,Cosette,Kobieriecki,ckobieriecki4i@guardian.co.uk,VP Product Management,7922,933,8855
35161,Buffy,Othen,bothen4j@liveinternet.ru,Compensation Analyst,7824,1186,9010
35185,Bliss,Ransbury,bransbury4k@msu.edu,Software Test Engineer II,1389,547,1936
35538,Dunstan,Spearett,dspearett4l@gnu.org,Business Systems Development Analyst,4406,379,4785
35129,Norton,Coetzee,ncoetzee4m@tripod.com,Geologist I,7865,1950,9815
35149,Fax,Erricker,ferricker4n@vinaora.com,Automation Specialist I,2076,815,2891
35729,Porter,Woodall,pwoodall4o@dailymail.co.uk,Professor,3226,1855,5081
35769,Bertrand,Whicher,bwhicher4p@360.cn,General Manager,5105,1550,6655
35634,Lulita,McVee,lmcvee4q@skype.com,Media Manager IV,4309,1745,6054
35397,Jessie,Cotty,jcotty4s@go.com,Senior Cost Accountant,4751,1875,6626
35847,Morty,Phettiplace,mphettiplace4t@jiathis.com,Junior Executive,5598,616,6214
35062,Vinni,Jepson,vjepson4u@yolasite.com,Geologist II,7273,877,8150
35075,Boyce,Tocqueville,btocqueville4v@narod.ru,Software Test Engineer IV,3024,509,3533
35997,Huey,Monkton,hmonkton4w@blog.com,Systems Administrator IV,9681,406,10087
35406,Gena,Balmadier,gbalmadier4z@ihg.com,Administrative Officer,1956,512,2468
35688,Emmery,Winterbourne,ewinterbourne50@t-online.de,Automation Specialist IV,6460,1969,8429
35933,Zita,Sell,zsell51@walmart.com,Dental Hygienist,7461,1893,9354
35795,Kevyn,Pascall,kpascall52@wufoo.com,Speech Pathologist,4536,1482,6018
35277,Wash,Clappison,wclappison53@addthis.com,Clinical Specialist,4567,961,5528
35692,Jaquenetta,Sainte Paul,jsaintepaul54@mtv.com,Research Associate,2119,861,2980
35070,Aubrey,Leipoldt,aleipoldt55@hc360.com,Engineer II,1665,1067,2732
35810,Jess,Nattrass,jnattrass56@wikimedia.org,Paralegal,1286,1738,3024
35510,Marilyn,Gladyer,mgladyer57@woothemes.com,VP Quality Control,9579,1160,10739
35821,Maddy,Howlin,mhowlin59@dropbox.com,Marketing Assistant,4956,1510,6466
35290,Killie,Luisetti,kluisetti5a@amazon.com,Associate Professor,4235,1983,6218
35842,Harriot,Robertsson,hrobertsson5b@engadget.com,Product Engineer,5175,354,5529
35589,Janeta,Blacksland,jblacksland5g@webmd.com,Software Test Engineer IV,4981,1617,6598
35611,Rosalinda,Cleverley,rcleverley5i@jimdo.com,VP Sales,5926,737,6663
35111,Zonda,Tinmouth,ztinmouth5l@yahoo.co.jp,Civil Engineer,6582,816,7398
35835,Carl,Stoter,cstoter5m@xrea.com,Business Systems Development Analyst,5686,808,6494
35253,Rodger,Childes,rchildes5p@craigslist.org,Graphic Designer,9083,1878,10961
35746,Bambie,Boulton,bboulton5q@nature.com,Health Coach III,5715,491,6206
35056,Jerad,Mothersdale,jmothersdale5r@sitemeter.com,Social Worker,8604,414,9018
35115,Ronalda,Mapis,rmapis5s@phoca.cz,Account Coordinator,5057,1404,6461
35519,Hubie,Thurner,hthurner5t@netvibes.com,Junior Executive,5620,835,6455
35138,Egon,Bernardotti,ebernardotti5u@plala.or.jp,Mechanical Systems Engineer,9954,1468,11422
35613,Barbara,Flippelli,bflippelli5v@forbes.com,Staff Scientist,1054,1695,2749
35311,Ced,Zammett,czammett5w@hatena.ne.jp,Geological Engineer,2979,1356,4335
35690,Percival,Spera,pspera5x@simplemachines.org,Payment Adjustment Coordinator,5078,1053,6131
35936,Ty,Quilligan,tquilligan5y@opensource.org,Desktop Support Technician,2939,952,3891
35899,Sheridan,Hanster,shanster5z@apache.org,Health Coach I,9241,1645,10886
35718,Erhart,Frude,efrude60@deviantart.com,Administrative Officer,4307,1230,5537
35750,Dennie,D'Ambrogi,ddambrogi61@free.fr,Sales Representative,7177,384,7561
35736,Mirabel,Sunderland,msunderland62@paginegialle.it,Electrical Engineer,7820,1052,8872
35891,Obed,Twist,otwist64@google.de,Financial Advisor,3471,580,4051
35667,Blaire,Bett,bbett65@feedburner.com,Systems Administrator I,8317,468,8785
35226,Brynna,Bullimore,bbullimore67@hubpages.com,Nurse,5406,587,5993
35051,Teddie,Sandlin,tsandlin68@istockphoto.com,Developer III,8395,1806,10201
35999,Nicky,Catton,ncatton69@ustream.tv,Paralegal,3239,1445,4684
35402,Hedvig,Varcoe,hvarcoe6a@ucoz.ru,Librarian,5315,710,6025
35730,Naoma,Kleinhaut,nkleinhaut6b@tinyurl.com,Office Assistant IV,1400,604,2004
35071,Bobby,Sibbson,bsibbson6c@samsung.com,Accountant II,8892,1176,10068
35741,Lissie,Ghidotti,lghidotti6d@epa.gov,Web Designer III,2938,1997,4935
35605,Terrance,Dudney,tdudney6e@microsoft.com,Director of Sales,9002,745,9747
35596,Lurette,Jaher,ljaher6f@mtv.com,Geologist IV,8233,1927,10160
35181,Saxon,Tolland,stolland6i@economist.com,Research Associate,7969,460,8429
35276,Laverna,Mac Geaney,lmacgeaney6j@etsy.com,Quality Engineer,1034,593,1627
35372,Maia,Casillas,mcasillas6k@istockphoto.com,Database Administrator III,1925,363,2288
35336,Maison,Strewthers,mstrewthers6l@un.org,Statistician IV,2613,1857,4470
35574,Abie,Acreman,aacreman6m@unesco.org,Design Engineer,4847,1779,6626
35417,Euell,Loweth,eloweth6n@cargocollective.com,Administrative Assistant IV,2999,1227,4226
35546,Roxana,Widmore,rwidmore6o@bing.com,Help Desk Technician,9594,713,10307
35975,Larisa,Shutler,lshutler6p@about.me,Administrative Officer,6380,1972,8352
35167,Robby,Pask,rpask6q@wikispaces.com,Editor,9767,1298,11065
35773,Cora,Scafe,cscafe6r@domainmarket.com,Quality Engineer,6138,1525,7663
35089,Phillida,Wingeatt,pwingeatt6s@bloomberg.com,Programmer IV,8221,1568,9789
35205,Chanda,Emanulsson,cemanulsson6t@illinois.edu,Senior Financial Analyst,1870,1660,3530
35740,Holly,Overland,hoverland6u@europa.eu,Speech Pathologist,5007,1168,6175
35843,Neal,Pimlott,npimlott6v@theatlantic.com,Help Desk Technician,7878,847,8725
35920,Demetre,Vobes,dvobes6w@webmd.com,Biostatistician I,1064,1428,2492
35642,Fabio,Viollet,fviollet6y@slate.com,Editor,5979,950,6929
35888,Hyacinthe,Saltsberg,hsaltsberg6z@behance.net,Social Worker,7053,662,7715
35300,Edee,Eggerton,eeggerton71@studiopress.com,Civil Engineer,6900,458,7358
35261,Tomaso,Joliffe,tjoliffe72@php.net,Project Manager,9685,1934,11619
35544,Grady,Featherstone,gfeatherstone73@i2i.jp,Quality Engineer,7019,1248,8267
35636,Sherry,Benmore,sbenmore75@soup.io,VP Product Management,5208,434,5642
35748,Lanni,Gavini,lgavini76@independent.co.uk,Health Coach I,7014,421,7435
35154,Kin,Ginnelly,kginnelly77@reddit.com,Senior Sales Associate,1050,805,1855
35715,Bartlet,Trodd,btrodd78@free.fr,Director of Sales,8080,872,8952
35263,Aimee,oldey,aoldey79@mayoclinic.com,Tax Accountant,8703,1752,10455
35320,Paulette,Pobjoy,ppobjoy7a@shinystat.com,Associate Professor,4201,1948,6149
35995,Georas,Whittlesea,gwhittlesea7c@biblegateway.com,Tax Accountant,3369,634,4003
35637,Zacharia,Greaterex,zgreaterex7d@mayoclinic.com,Data Coordiator,9558,1254,10812
35011,Bobbie,Wilkowski,bwilkowski7g@sohu.com,Geological Engineer,5784,929,6713
35213,Luella,Swetland,lswetland7h@phoca.cz,Assistant Professor,5699,1264,6963
35820,Janet,Canavan,jcanavan7j@virginia.edu,Mechanical Systems Engineer,7862,925,8787
35084,Akim,Maty,amaty7k@altervista.org,Actuary,9252,478,9730
35561,Nina,Rainbird,nrainbird7l@pcworld.com,Speech Pathologist,1002,440,1442
35929,Yulma,Baldin,ybaldin7m@ucoz.com,Legal Assistant,4706,1527,6233
35501,Tiff,Batman,tbatman7n@amazon.com,Software Engineer II,5284,583,5867
35009,Nomi,Kenny,nkenny7o@si.edu,Clinical Specialist,9679,1181,10860
35530,Kalle,Reubel,kreubel7p@shinystat.com,Web Designer III,2541,1569,4110
35309,Else,Blackeby,eblackeby7q@sbwire.com,Senior Cost Accountant,4272,1866,6138
35529,Bobbette,Hallahan,bhallahan7s@ed.gov,Mechanical Systems Engineer,4364,903,5267
35735,Wake,Prazer,wprazer7t@goodreads.com,VP Accounting,9133,570,9703
35001,Domingo,Tarry,dtarry7u@delicious.com,Dental Hygienist,4412,668,5080
35691,Vonnie,Goodreid,vgoodreid7x@baidu.com,Community Outreach Specialist,4391,808,5199
35096,Pattie,Gergolet,pgergolet7y@cmu.edu,Food Chemist,2862,682,3544
35069,Joellyn,Axtell,jaxtell7z@howstuffworks.com,Programmer III,7768,1301,9069
35672,Galven,Haddinton,ghaddinton80@squidoo.com,Senior Sales Associate,6665,967,7632
35733,Elicia,Chappelow,echappelow81@tinyurl.com,Project Manager,3356,1875,5231
35093,Leeann,McKimm,lmckimm82@tinyurl.com,Civil Engineer,1487,999,2486
35390,Egor,Huggens,ehuggens84@reference.com,Accounting Assistant III,1702,412,2114
35460,Debbie,Kilban,dkilban85@phoca.cz,Computer Systems Analyst I,4827,457,5284
35122,Trisha,Chaikovski,tchaikovski86@accuweather.com,Accounting Assistant II,7784,1739,9523
35043,Saxon,Vispo,svispo87@redcross.org,Software Test Engineer II,3676,1976,5652
35896,Hendrika,Rudgard,hrudgard8a@jugem.jp,Software Consultant,2181,1771,3952
35356,Melony,Leaming,mleaming8b@youtube.com,Civil Engineer,8136,1102,9238
35934,Bartlet,Pusill,bpusill8f@addthis.com,Database Administrator III,7740,1996,9736
35423,Dot,Chappell,dchappell8g@mozilla.org,Health Coach II,3691,827,4518
35165,Humphrey,Tudhope,htudhope8h@xinhuanet.com,Automation Specialist II,3175,1196,4371
35834,Clea,Dmitriev,cdmitriev8i@europa.eu,Clinical Specialist,6849,1581,8430
35953,Monte,Malacrida,mmalacrida8k@plala.or.jp,Technical Writer,3138,471,3609
35036,Batsheva,Jaycocks,bjaycocks8l@npr.org,Recruiter,7349,845,8194
35463,Hester,Dance,hdance8m@comsenz.com,Office Assistant III,8822,374,9196
35629,Daffie,Diben,ddiben8p@npr.org,Electrical Engineer,2029,449,2478
35894,Yettie,Kingsman,ykingsman8q@bbc.co.uk,Accounting Assistant IV,7972,289,8261
35434,Myrwyn,Skeats,mskeats8r@wix.com,Chief Design Engineer,9456,516,9972
35726,Mil,Pilsworth,mpilsworth8s@psu.edu,Accountant II,6544,1968,8512
35723,Quintana,Falkner,qfalkner8t@phoca.cz,VP Sales,3602,440,4042
35977,Brooke,Ianetti,bianetti8u@phoca.cz,Structural Engineer,8112,1210,9322
35758,Brigida,Lisle,blisle8v@webeden.co.uk,Senior Quality Engineer,7234,1734,8968
35445,Kean,Jeremiah,kjeremiah8w@ca.gov,Registered Nurse,7559,795,8354
35687,Bentley,De Beneditti,bdebeneditti8x@whitehouse.gov,Administrative Officer,6998,1472,8470
35128,Sonny,Yekel,syekel8y@pbs.org,Recruiting Manager,4548,1747,6295
35197,Hugo,Santus,hsantus90@sun.com,Professor,1287,264,1551
35260,Opalina,Shapcote,oshapcote91@nbcnews.com,Accountant III,7403,391,7794
35868,Estelle,Le Prevost,eleprevost92@ask.com,Senior Sales Associate,1756,1846,3602
35186,Lola,Burling,lburling93@pinterest.com,Web Designer III,7995,1228,9223
35239,Alika,Tibbles,atibbles94@huffingtonpost.com,Quality Engineer,9652,397,10049
35435,Fancie,Asquith,fasquith95@geocities.com,Nurse Practicioner,9687,1043,10730
35322,Rube,Rown,rrown96@soundcloud.com,Senior Sales Associate,4667,554,5221
35256,Calhoun,Gillham,cgillham97@slideshare.net,Human Resources Assistant IV,3730,907,4637
35103,Alisa,Reeday,areeday98@smh.com.au,Registered Nurse,7958,550,8508
35844,Ryley,Aizlewood,raizlewood99@latimes.com,Web Developer II,7487,1948,9435
35342,Cinderella,Ethelston,cethelston9a@opensource.org,Chemical Engineer,1289,611,1900
35157,Andi,Southernwood,asouthernwood9d@tumblr.com,Paralegal,5924,310,6234
35257,Kelcey,Thomason,kthomason9e@cloudflare.com,Design Engineer,4164,1234,5398
35042,Moshe,Stonestreet,mstonestreet9f@springer.com,VP Quality Control,2754,562,3316
35943,Marika,Asche,masche9g@creativecommons.org,Mechanical Systems Engineer,2673,802,3475
35321,Neilla,Kitchingman,nkitchingman9i@addthis.com,VP Sales,3657,918,4575
35841,Benetta,Wildgoose,bwildgoose9j@homestead.com,Junior Executive,9835,364,10199
35279,Beniamino,Feldmesser,bfeldmesser9o@wp.com,Compensation Analyst,2758,1803,4561
35035,Patten,Rennocks,prennocks9p@vistaprint.com,Help Desk Technician,4252,1084,5336
35571,Kareem,Burkhill,kburkhill9q@unesco.org,Account Executive,8552,1483,10035
35472,Roxine,Burles,rburles9r@flavors.me,Clinical Specialist,8275,489,8764
35475,Angeli,Dingwall,adingwall9t@auda.org.au,Social Worker,5054,1523,6577
35762,Neda,MacFaell,nmacfaell9u@booking.com,VP Sales,9286,1429,10715
35444,Vikky,Sherville,vsherville9w@1688.com,Nuclear Power Engineer,6388,956,7344
35060,Ruperto,Levet,rlevet9x@npr.org,Business Systems Development Analyst,1916,1959,3875
35271,Virgil,Alberts,valberts9y@japanpost.jp,GIS Technical Architect,3331,1636,4967
35396,Jarad,Reace,jreacea0@geocities.jp,Business Systems Development Analyst,6075,505,6580
35849,Ben,Rockcliffe,brockcliffea1@histats.com,Systems Administrator I,9365,1183,10548
35027,Alla,Kmieciak,akmieciaka2@unicef.org,Nuclear Power Engineer,8242,1357,9599
35438,Cherice,Dennant,cdennanta6@so-net.ne.jp,Electrical Engineer,3885,1734,5619
35558,Kori,Blyth,kblytha8@washington.edu,Financial Advisor,3300,1467,4767
35705,Frederick,Fransman,ffransmana9@fema.gov,Database Administrator II,3372,1431,4803
35895,Drusi,Dyet,ddyetab@wikia.com,Occupational Therapist,7210,278,7488
35499,Issie,Coppard,icoppardad@twitter.com,Actuary,2583,715,3298
35385,Dianemarie,Worcs,dworcsae@gizmodo.com,Civil Engineer,8796,215,9011
36000,Gabie,McGilvra,gmcgilvraaf@icio.us,Sales Associate,7343,402,7745
35572,Demetris,Petrak,dpetrakah@webs.com,Financial Analyst,3226,1007,4233
35513,Gerri,Melin,gmelinai@lulu.com,Administrative Officer,4801,1076,5877
35777,Rolf,Dilleway,rdillewayaj@springer.com,Accountant II,3724,1531,5255
35272,Ellswerth,Allchin,eallchinak@psu.edu,Human Resources Assistant IV,8225,935,9160
35269,Gothart,Tenny,gtennyal@xinhuanet.com,Design Engineer,3427,1791,5218
35034,Angela,Haily,ahailyam@php.net,Design Engineer,2347,699,3046
35554,Vanni,Anker,vankeran@java.com,Nurse,8062,1300,9362
35076,Harold,Roddan,hroddanao@archive.org,Senior Cost Accountant,4738,1944,6682
35306,Saundra,Traynor,straynorap@wordpress.com,Recruiter,3923,381,4304
35663,Sheilah,Fairs,sfairsaq@geocities.jp,Health Coach II,1544,1799,3343
35628,Aloisia,Cadore,acadorear@rakuten.co.jp,Editor,8614,573,9187
35264,Bethanne,Swepstone,bswepstoneas@stanford.edu,Data Coordiator,2837,468,3305
35159,Ransom,Espadero,respaderoat@engadget.com,Research Associate,4512,1652,6164
35124,Mikael,Mowlam,mmowlamau@state.tx.us,Research Assistant I,7198,1893,9091
35333,Nigel,Budleigh,nbudleighaw@cocolog-nifty.com,Budget/Accounting Analyst II,2128,1411,3539
35442,Othelia,Dike,odikeax@disqus.com,Programmer Analyst I,9472,1840,11312
35203,Red,Twiggins,rtwigginsb2@economist.com,Systems Administrator IV,9440,1264,10704
35905,Skell,Bacon,sbaconb3@flickr.com,Civil Engineer,1127,555,1682
35072,Ragnar,McCombe,rmccombeb5@prweb.com,Desktop Support Technician,3482,1971,5453
35850,Dominique,Battabee,dbattabeeb7@mozilla.com,Research Assistant I,5327,1600,6927
35297,Hildagarde,Tansley,htansleyb9@usa.gov,Registered Nurse,1022,1098,2120
35707,Torrey,Larrosa,tlarrosaba@nba.com,Payment Adjustment Coordinator,9482,635,10117
35184,Paton,Mullineux,pmullineuxbc@umich.edu,Geologist IV,4892,1383,6275
35874,Irv,Northrop,inorthropbd@cmu.edu,Computer Systems Analyst III,6324,1530,7854
35954,Giulio,Fochs,gfochsbf@boston.com,Civil Engineer,2062,1154,3216
35112,Loni,Blais,lblaisbg@jugem.jp,Teacher,5034,461,5495
35044,Agnes,Wathey,awatheybh@netvibes.com,Help Desk Operator,9978,1261,11239
35308,Jayne,Haughey,jhaugheybj@sfgate.com,Software Consultant,3657,1230,4887
35174,Bunnie,McElory,bmcelorybk@yelp.com,Senior Quality Engineer,6017,826,6843
35910,Pieter,Martineau,pmartineaubl@instagram.com,Editor,1220,1821,3041
35160,Gilbertine,Aslam,gaslambm@woothemes.com,Teacher,6969,391,7360
35318,Tobye,Arnell,tarnellbn@oracle.com,Web Developer IV,2709,1183,3892
35907,Linda,Ottewill,lottewillbp@yellowbook.com,Statistician III,8160,833,8993
35398,Clovis,Hinz,chinzbr@rediff.com,Compensation Analyst,8941,1050,9991
35836,Domenic,Ferrar,dferrarbs@miitbeian.gov.cn,Account Coordinator,3709,1424,5133
35714,Deloris,Wanek,dwanekbt@whitehouse.gov,Marketing Assistant,3456,1859,5315
35021,Irena,D'Ambrosi,idambrosibv@usnews.com,Accountant IV,5193,427,5620
35235,Dorthy,Pebworth,dpebworthbw@mapy.cz,Administrative Assistant II,2998,1714,4712
35506,Mavra,Moreing,mmoreingbx@google.es,Electrical Engineer,2175,1090,3265
35064,Allyce,Lemerie,alemerieby@marketwatch.com,Marketing Manager,7038,394,7432
35913,Pepi,Martinello,pmartinelloc0@mozilla.com,Marketing Manager,2158,492,2650
35854,Tania,Dawidowitz,tdawidowitzc1@ox.ac.uk,Marketing Assistant,1305,1442,2747
35164,Tammy,Ben,tbenc3@wired.com,Physical Therapy Assistant,9466,811,10277
35745,Janaya,Stanning,jstanningc4@businesswire.com,Senior Quality Engineer,5475,1254,6729
35701,Cornela,Grote,cgrotec5@bbb.org,Civil Engineer,6597,1230,7827
35215,Josephina,Meaker,jmeakerc7@china.com.cn,Systems Administrator III,8847,931,9778
35778,Vic,Cockell,vcockellc8@globo.com,Staff Scientist,2054,799,2853
35635,Kile,Covington,kcovingtonc9@webmd.com,Staff Accountant III,5494,1465,6959
35182,Fredek,Du Hamel,fduhamelcf@mac.com,Analog Circuit Design manager,6298,1684,7982
35209,Maribel,McShea,mmcsheacj@360.cn,Editor,4977,1529,6506
35576,Zilvia,Edgeon,zedgeonck@mashable.com,Nurse,4607,644,5251
35220,Valenka,Hammerson,vhammersoncl@comsenz.com,Professor,3758,758,4516
35383,Arni,Barclay,abarclayco@ibm.com,Tax Accountant,3436,1841,5277
35603,Andre,Filipczynski,afilipczynskicq@twitter.com,Programmer II,4801,1044,5845
35775,Bonni,Riggey,briggeycr@photobucket.com,Recruiter,8546,1990,10536
35079,Daryl,Chappelle,dchappellecs@blogspot.com,Marketing Assistant,3143,625,3768
35281,Liesa,Johnigan,ljohnigancu@deliciousdays.com,Tax Accountant,7597,1741,9338
35425,Paulie,Simkins,psimkinscw@washington.edu,Research Assistant IV,9892,674,10566
35581,Ingra,Milbourne,imilbournecx@economist.com,Social Worker,1312,1906,3218
35509,Murial,Sneezum,msneezumcy@reference.com,Civil Engineer,4827,1651,6478
35422,Vonnie,Caghan,vcaghancz@oracle.com,Accounting Assistant I,2649,824,3473
35295,Lyda,Janikowski,ljanikowskid0@qq.com,Librarian,8196,1696,9892
35020,Bard,Vosper,bvosperd1@google.pl,Assistant Media Planner,8203,436,8639
35456,Margot,Langer,mlangerd3@indiatimes.com,Speech Pathologist,8773,912,9685
35752,Ikey,MacDermid,imacdermidd4@mtv.com,Nurse,9912,692,10604
35414,Izzy,Gallacher,igallacherd5@wordpress.org,Financial Analyst,4879,1811,6690
35794,Andrej,Hicks,ahicksd7@wired.com,Senior Quality Engineer,9064,715,9779
35870,Jemmy,Bussey,jbusseyd9@barnesandnoble.com,Staff Scientist,5635,660,6295
35625,Mufi,Keyzor,mkeyzorda@engadget.com,Health Coach I,7505,1902,9407
35646,Codie,Baumer,cbaumerdb@tamu.edu,Structural Engineer,3716,1901,5617
35799,Ulrica,Ivannikov,uivannikovdc@miibeian.gov.cn,Environmental Tech,1056,1004,2060
35307,Sephira,Spendley,sspendleydd@opensource.org,Help Desk Technician,3293,1613,4906
35061,Raoul,Jacobbe,rjacobbedf@constantcontact.com,Sales Representative,7546,336,7882
35204,Fabien,Annear,fanneardg@cocolog-nifty.com,Nurse Practicioner,3798,723,4521
35862,Jennifer,Mawd,jmawddh@i2i.jp,Librarian,9167,1529,10696
35931,Nanette,Tulip,ntulipdj@samsung.com,Human Resources Assistant II,7282,428,7710
35565,Molli,Abriani,mabrianidk@ovh.net,Senior Quality Engineer,4051,525,4576
35923,Mair,Cuseick,mcuseickdm@lulu.com,Information Systems Manager,6383,1093,7476
35994,April,Corke,acorkedn@example.com,Automation Specialist III,3107,1034,4141
35468,Yasmin,Braisher,ybraisherdo@ning.com,Assistant Manager,3521,1356,4877
35012,Zacharie,Calow,zcalowdq@homestead.com,Speech Pathologist,2644,841,3485
35619,Corrie,Minocchi,cminocchids@noaa.gov,Help Desk Technician,2117,428,2545
35785,Shara,Questier,squestierdv@usgs.gov,Administrative Officer,2216,1959,4175
35191,Ardella,Cottem,acottemdx@prnewswire.com,Executive Secretary,9855,1043,10898
35876,Brietta,Mayers,bmayersdz@so-net.ne.jp,Cost Accountant,4466,345,4811
35869,Yalonda,Cuerda,ycuerdae0@nhs.uk,Assistant Manager,9929,424,10353
35073,Stefanie,Doick,sdoicke2@yellowbook.com,Senior Developer,1603,1397,3000
35614,Gayla,Galbreath,ggalbreathe3@discovery.com,Librarian,5402,244,5646
35049,Pace,Peaurt,ppeaurte4@tripadvisor.com,Sales Associate,9021,1577,10598
35819,Wernher,Fullilove,wfullilovee6@vimeo.com,Senior Editor,7208,1986,9194
35109,Vevay,Keast,vkeastea@skyrock.com,Assistant Media Planner,5773,546,6319
35650,Drew,Helliar,dhelliareb@about.com,Cost Accountant,9440,1602,11042
35031,Dominga,Ciccarelli,dciccarelliec@studiopress.com,Quality Control Specialist,2488,695,3183
35014,Skipton,Dahlbom,sdahlbomef@fema.gov,Staff Accountant II,2357,1716,4073
35588,Waite,Scaice,wscaiceeh@technorati.com,Help Desk Technician,5984,1242,7226
35346,Rex,Klimp,rklimpei@webnode.com,Research Associate,8197,418,8615
35142,Margarete,Glassup,mglassupej@ft.com,Librarian,2726,467,3193
35408,Prescott,Liddon,pliddonen@sakura.ne.jp,GIS Technical Architect,2702,762,3464
35055,Jordon,Blackham,jblackhamer@yelp.com,Sales Representative,3665,734,4399
35244,Patrizio,Kibel,pkibeles@delicious.com,VP Sales,8826,1841,10667
35026,Adelaida,Lucks,alucksey@icio.us,Business Systems Development Analyst,2902,1115,4017
35871,Berny,Shilstone,bshilstonef0@bbc.co.uk,Internal Auditor,9733,1040,10773
35551,Bendicty,Crawford,bcrawfordf1@goo.ne.jp,Help Desk Operator,7924,303,8227
35285,Land,Tockell,ltockellf3@phpbb.com,Speech Pathologist,9393,1459,10852
35386,Lombard,Kneafsey,lkneafseyf6@wikipedia.org,Dental Hygienist,1886,1920,3806
35284,Wells,Conachie,wconachief7@github.io,Software Engineer I,3618,662,4280
35678,Jaquenette,Laverick,jlaverickf8@irs.gov,Help Desk Technician,8087,605,8692
35229,Ermanno,Debling,edeblingf9@yolasite.com,Associate Professor,3193,434,3627
35359,Marice,Martschke,mmartschkefa@shop-pro.jp,Marketing Assistant,9825,206,10031
35767,Helen,McClaurie,hmcclauriefb@sciencedirect.com,Executive Secretary,4430,644,5074
35533,Bernetta,Snar,bsnarfc@fda.gov,Software Test Engineer III,6522,1944,8466
35597,Shelli,Whitechurch,swhitechurchfd@digg.com,Media Manager II,9314,610,9924
35700,Griselda,Salman,gsalmanff@accuweather.com,Health Coach I,4363,223,4586
35273,Harv,Stainson,hstainsonfi@nature.com,Technical Writer,1117,802,1919
35343,Ahmed,Quadling,aquadlingfk@multiply.com,Account Executive,9866,1172,11038
35211,Pepillo,Sherwin,psherwinfl@timesonline.co.uk,Senior Financial Analyst,7238,324,7562
35504,Maybelle,Tabour,mtabourfp@europa.eu,Chemical Engineer,6865,708,7573
35177,Meyer,Lavender,mlavenderfq@sourceforge.net,Web Designer III,7353,1534,8887
35537,Allina,Quincey,aquinceyfs@networksolutions.com,Help Desk Operator,6670,942,7612
35487,Alphonso,Watkiss,awatkissft@dion.ne.jp,Help Desk Operator,4011,1913,5924
35187,Jerald,Larter,jlarterfv@home.pl,Automation Specialist II,9454,1690,11144
35548,Mareah,Peggram,mpeggramfx@jiathis.com,Librarian,3271,1453,4724
35912,Sharline,McRobert,smcrobertfy@arstechnica.com,Quality Engineer,6919,1958,8877
35853,Ingram,Stollberger,istollbergerfz@typepad.com,Clinical Specialist,7250,1393,8643
35680,Kathy,Flewitt,kflewittg0@gizmodo.com,Food Chemist,9613,1210,10823
35782,Leigh,Barensky,lbarenskyg3@salon.com,Account Executive,1953,1301,3254
35050,Zorah,Leyzell,zleyzellg5@squarespace.com,Financial Analyst,9290,557,9847
35230,Harris,Slator,hslatorg6@icq.com,Research Nurse,9123,1435,10558
35113,Ali,O'Kerin,aokering7@shareasale.com,VP Quality Control,5095,1810,6905
35792,Melessa,Quin,mquing8@huffingtonpost.com,Senior Quality Engineer,9469,567,10036
35761,Tierney,Moyser,tmoyserg9@disqus.com,Recruiting Manager,8676,308,8984
35568,Christoffer,Whitney,cwhitneygb@tiny.cc,Software Test Engineer I,1399,498,1897
35100,Addy,Pote,apotegc@artisteer.com,Nurse,2097,1950,4047
35305,Reginauld,Wyrill,rwyrillgd@artisteer.com,Assistant Professor,2749,1490,4239
35694,Othilia,Creffeild,ocreffeildge@ed.gov,Nuclear Power Engineer,6711,1904,8615
35078,Rand,Allot,rallotgf@godaddy.com,Budget/Accounting Analyst III,7993,705,8698
35131,Andre,Pitts,apittsgi@studiopress.com,Senior Sales Associate,3489,1274,4763
35566,Milka,Gott,mgottgj@paginegialle.it,Safety Technician I,1025,1529,2554
35617,Vina,De Matteis,vdematteisgk@4shared.com,Desktop Support Technician,7716,1696,9412
35216,Steve,Donson,sdonsongl@mashable.com,Software Test Engineer II,2572,946,3518
35010,Annabella,Ingre,aingregm@ehow.com,Recruiting Manager,6495,832,7327
35674,Winston,Gockeler,wgockelergn@prnewswire.com,Paralegal,2915,1906,4821
35846,Consuela,Yearne,cyearnegp@samsung.com,Research Assistant III,3186,1315,4501
35638,Essa,Wakes,ewakesgr@ocn.ne.jp,Information Systems Manager,4251,1598,5849
35470,Christyna,Allcoat,callcoatgs@bloglines.com,Geologist III,1388,1027,2415
35393,Harmony,Nix,hnixgt@addtoany.com,Senior Sales Associate,4432,691,5123
35751,Dedie,Revie,dreviegu@google.com.hk,Mechanical Systems Engineer,4410,528,4938
35212,Charley,Kirsche,ckirschegv@bigcartel.com,Web Developer IV,9511,1544,11055
35411,Dieter,Carn,dcarngw@booking.com,Project Manager,5366,1584,6950
35832,Celesta,Sleightholm,csleightholmgx@nydailynews.com,Registered Nurse,6939,1407,8346
35245,Giulio,Kelso,gkelsogy@spiegel.de,Analyst Programmer,1687,1746,3433
35363,Ardra,Bowkett,abowketth0@constantcontact.com,Civil Engineer,6802,572,7374
35428,Corby,Lambeth,clambethh1@topsy.com,Senior Financial Analyst,8564,952,9516
35780,Ebeneser,Esch,eeschh2@mapquest.com,Safety Technician IV,5480,1017,6497
35724,Jimmy,Purver,jpurverh3@unc.edu,Structural Engineer,4685,1207,5892
35083,Lucio,Pledge,lpledgeh4@pbs.org,Payment Adjustment Coordinator,5252,351,5603
35647,Adena,Kingswold,akingswoldh5@123-reg.co.uk,Recruiter,8494,257,8751
35987,Prudi,Nairne,pnairneh6@e-recht24.de,Mechanical Systems Engineer,2589,206,2795
35327,Ike,Sams,isamsh8@istockphoto.com,Librarian,10000,877,10877
35738,Jourdan,Poulsum,jpoulsumhd@time.com,Design Engineer,6912,972,7884
35633,Ardra,Dummer,adummerhf@google.com.br,Quality Engineer,9636,1407,11043
35695,Ellene,Honnicott,ehonnicotthg@vistaprint.com,Technical Writer,4938,308,5246
35126,Paulette,Canny,pcannyhh@meetup.com,Pharmacist,7363,357,7720
35491,Celestine,Dykes,cdykeshi@facebook.com,Senior Quality Engineer,1233,1446,2679
35632,Allianora,Woodroofe,awoodroofehj@dailymail.co.uk,Food Chemist,5074,838,5912
35082,Niccolo,Frake,nfrakehl@uiuc.edu,Registered Nurse,1046,1541,2587
35805,Camella,Aysh,cayshhm@google.nl,Physical Therapy Assistant,3896,1835,5731
35312,Richardo,Tremberth,rtremberthhp@google.ca,Marketing Assistant,2591,958,3549
35047,Leif,Bosanko,lbosankohs@narod.ru,Account Coordinator,6991,296,7287
35484,Cyril,Dillaway,cdillawayht@ning.com,Human Resources Assistant II,8669,1967,10636
35669,Samara,Brekonridge,sbrekonridgehu@i2i.jp,Clinical Specialist,5434,1999,7433
35609,Gerald,Edmett,gedmetthx@sourceforge.net,Geological Engineer,4012,1942,5954
35801,Zebadiah,Yousef,zyousefhy@spiegel.de,Analyst Programmer,2844,637,3481
35314,Suki,Millson,smillsoni1@blogspot.com,Senior Financial Analyst,6498,556,7054
35116,Chase,Palfree,cpalfreei2@latimes.com,Senior Sales Associate,9345,1516,10861
35058,Oswald,Pues,opuesi3@rediff.com,Senior Editor,4802,1000,5802
35105,Adolphus,Snawdon,asnawdoni4@nationalgeographic.com,Web Developer II,5108,1373,6481
35373,Ive,Berk,iberki5@nyu.edu,Marketing Manager,3360,807,4167
35250,Reidar,Horley,rhorleyi7@pcworld.com,Recruiter,1340,1180,2520
35467,Gauthier,Darker,gdarkeri9@howstuffworks.com,Operator,5019,927,5946
35904,Ailee,Pearsall,apearsallia@devhub.com,Junior Executive,1351,1886,3237
35176,Georges,Clee,gcleeid@woothemes.com,Research Assistant II,8982,1272,10254
35045,Agustin,Sheavills,asheavillsie@princeton.edu,Nurse Practicioner,1089,787,1876
35918,Aimil,Severwright,aseverwrightif@berkeley.edu,Systems Administrator II,9204,1506,10710
35593,Nannie,Frowde,nfrowdeig@abc.net.au,Systems Administrator III,1883,1518,3401
35966,Bernadene,Bugdell,bbugdellih@bluehost.com,Programmer II,5893,644,6537
35958,Tarrance,Have,thaveij@ameblo.jp,Software Engineer II,2217,1853,4070
35857,Hurleigh,Joscelyne,hjoscelyneil@ihg.com,Information Systems Manager,8824,625,9449
35833,Any,Killiner,akillinerim@nps.gov,VP Sales,3968,303,4271
35996,Devonna,Nulty,dnultyin@skyrock.com,Developer III,7448,1371,8819
35337,Julius,Crippin,jcrippinio@bloglines.com,Health Coach II,5108,457,5565
35516,Devan,Jarmaine,djarmaineiq@yelp.com,Internal Auditor,3289,1506,4795
35193,Fenelia,Heinzler,fheinzlerir@istockphoto.com,Paralegal,4004,519,4523
35804,Anthia,Balk,abalkis@icq.com,Computer Systems Analyst II,4486,420,4906
35488,Lea,Haisell,lhaiselliu@youku.com,Chief Design Engineer,6072,950,7022
35119,Karry,Haime,khaimeiw@desdev.cn,Senior Financial Analyst,8556,1672,10228
35214,Misty,Reinert,mreinertix@dailymail.co.uk,Civil Engineer,3486,1131,4617
35608,Meredith,Cucinotta,mcucinottaiy@exblog.jp,Junior Executive,3554,1404,4958
35621,Page,Vahl,pvahliz@phoca.cz,Safety Technician I,5847,894,6741
35742,Clive,Tabram,ctabramj3@auda.org.au,Cost Accountant,9493,958,10451
35872,Jaclyn,Pykerman,jpykermanj7@google.nl,Staff Scientist,6221,321,6542
35938,Jacklyn,Blunn,jblunnj9@psu.edu,Assistant Media Planner,5653,1077,6730
35494,Marlene,Illiston,millistonja@engadget.com,Chemical Engineer,3510,1981,5491
35223,Alethea,Menel,ameneljd@phoca.cz,Accounting Assistant I,9021,358,9379
35816,Vincenty,Broadberry,vbroadberryje@wikipedia.org,Occupational Therapist,3157,928,4085
35477,Devonne,Whymark,dwhymarkjf@w3.org,Geological Engineer,8492,1395,9887
35552,Margit,Coule,mcoulejg@1und1.de,VP Accounting,3466,1823,5289
35755,Roosevelt,Teasell,rteaselljj@ifeng.com,VP Product Management,2341,1743,4084
35210,Tawnya,Kitley,tkitleyjk@indiegogo.com,Automation Specialist II,6306,1191,7497
35195,Martina,Shapter,mshapterjm@patch.com,Teacher,4717,724,5441
35600,Teddie,Guyan,tguyanjo@kickstarter.com,VP Accounting,6421,1121,7542
35168,Yvon,Planque,yplanquejp@surveymonkey.com,Junior Executive,9002,297,9299
35410,Drusy,Aynsley,daynsleyjq@ehow.com,Speech Pathologist,6892,826,7718
35059,Darcey,Cronchey,dcroncheyjv@icio.us,Chemical Engineer,6207,631,6838
35006,Darren,Dymocke,ddymockejw@g.co,Clinical Specialist,5359,1730,7089
35328,Jordain,Wallwood,jwallwoodjy@discuz.net,Editor,1305,1517,2822
35813,Ardeen,Niesing,aniesingk0@marriott.com,Automation Specialist IV,7412,1714,9126
35639,Knox,Sidwell,ksidwellk1@youku.com,VP Product Management,5689,1940,7629
35719,Olive,Curran,ocurrank5@illinois.edu,Research Assistant I,8487,1180,9667
35282,Tess,Burnitt,tburnittk8@csmonitor.com,Teacher,4679,640,5319
35618,Rodi,Tarte,rtartekb@nba.com,Analyst Programmer,6034,1012,7046
35338,Colet,McClean,cmccleankc@europa.eu,Clinical Specialist,4961,1652,6613
35077,Caspar,Loughnan,cloughnankd@miibeian.gov.cn,Financial Analyst,1055,1866,2921
35433,Ignace,Baelde,ibaeldekf@yelp.com,Accountant III,4690,1821,6511
35448,Margeaux,O'Rodane,morodaneki@prweb.com,Marketing Assistant,5032,229,5261
35118,Rog,Glaysher,rglaysherkj@pen.io,Junior Executive,7523,1464,8987
35757,Barbara-anne,Harper,bharperkk@exblog.jp,Research Associate,1919,846,2765
35378,Tania,Giddings,tgiddingskl@dedecms.com,Chemical Engineer,8042,1882,9924
35935,Jeramie,Wolfendale,jwolfendalekq@linkedin.com,Account Representative I,8561,1299,9860
35563,Maryellen,McCarlie,mmccarlieks@who.int,Nurse,2797,884,3681
35005,Silvia,Pledger,spledgerku@house.gov,Nurse,8604,1827,10431
35627,Chariot,Matis,cmatiskw@gravatar.com,Information Systems Manager,4099,1150,5249
35814,Marlow,Fassman,mfassmankz@t.co,Programmer Analyst III,4926,1370,6296
35713,Joni,Chartre,jchartrel3@mail.ru,Senior Quality Engineer,8731,393,9124
35710,Byran,Leghorn,bleghornl4@google.ru,Automation Specialist IV,3177,357,3534
35973,Rabbi,Linsey,rlinseyl7@mapy.cz,Food Chemist,5225,677,5902
35743,Sile,Glazer,sglazerl8@state.gov,Geological Engineer,9065,1619,10684
35921,Goraud,Alphege,galphegelc@adobe.com,Account Coordinator,2364,1621,3985
35803,Annabella,Heijne,aheijneli@com.com,Product Engineer,1178,829,2007
35754,Oralee,Olivia,oolivialk@netvibes.com,Database Administrator III,5473,1542,7015
35830,Adele,Wix,awixll@shinystat.com,VP Accounting,5098,882,5980
35015,Licha,Engelbrecht,lengelbrechtlo@cmu.edu,Account Representative II,5711,1740,7451
35776,Sibbie,Jiruca,sjirucalq@go.com,Staff Scientist,5142,1349,6491
35716,Fenelia,Shipcott,fshipcottls@seesaa.net,Professor,5723,1527,7250
35517,Amabelle,Fourman,afourmanlt@hhs.gov,Desktop Support Technician,2676,1690,4366
35875,Joanna,Monckton,jmoncktonlv@va.gov,Librarian,9892,411,10303
35127,Brianna,Tuite,btuitelx@free.fr,Administrative Assistant II,3416,325,3741
35823,Loleta,Dragonette,ldragonettelz@themeforest.net,Recruiting Manager,7342,1331,8673
35037,Jorey,Sackey,jsackeym0@51.la,Director of Sales,5432,1527,6959
35797,Ebenezer,Nyssen,enyssenm1@google.com,Programmer I,3742,1684,5426
35968,Dacey,LAbbet,dlabbetm3@blinklist.com,Associate Professor,5400,342,5742
35464,Giff,Gazzard,ggazzardm4@xrea.com,Speech Pathologist,7562,1874,9436
35190,Lucius,Whittick,lwhittickm6@mozilla.org,Human Resources Manager,2630,1802,4432
35366,Lee,Burgoine,lburgoinem7@artisteer.com,VP Quality Control,4081,1682,5763
35274,Chancey,Aizikovich,caizikovichm8@smh.com.au,Dental Hygienist,9296,660,9956
35573,Melvyn,Eusden,meusdenm9@eepurl.com,Help Desk Operator,7453,1074,8527
35898,Julio,Gianolo,jgianoloma@house.gov,Actuary,2454,1739,4193
35233,Margit,Covell,mcovellmb@blogtalkradio.com,Pharmacist,2657,1294,3951
35242,Esdras,Arrundale,earrundalemc@newsvine.com,Dental Hygienist,3660,626,4286
35368,Wilone,McLewd,wmclewdmg@washingtonpost.com,Automation Specialist IV,4257,288,4545
35890,Noe,Danielis,ndanielismi@hubpages.com,Project Manager,2751,252,3003
35948,Jamima,Ricciardi,jricciardimj@blogtalkradio.com,General Manager,1802,1242,3044
35965,Nicola,Boddis,nboddismn@sbwire.com,Chief Design Engineer,7507,827,8334
35959,Neel,Lindner,nlindnermo@networksolutions.com,Research Assistant II,7164,852,8016
35224,Brandon,De Matteis,bdematteismr@businesswire.com,Accountant III,9918,279,10197
35292,Vance,Messruther,vmessruthermw@yahoo.co.jp,Financial Analyst,6013,1104,7117
35298,Mead,Greve,mgrevemx@google.cn,Environmental Specialist,5359,455,5814
35376,Hannis,Gerrets,hgerretsn0@nhs.uk,Paralegal,7944,1889,9833
35465,Maridel,Gun,mgunn9@cloudflare.com,Environmental Specialist,6726,910,7636
35380,Mitzi,Skellern,mskellernnc@kickstarter.com,Staff Scientist,4318,429,4747
35661,Karol,Treverton,ktrevertonni@blogspot.com,Software Engineer II,6254,821,7075
35030,Mignon,Corthes,mcorthesnk@whitehouse.gov,VP Sales,3463,808,4271
35409,Hortense,Heeley,hheeleynp@diigo.com,Senior Cost Accountant,9049,1972,11021
35991,Derby,Domoni,ddomonins@ameblo.jp,Professor,7041,391,7432
35606,Nettle,Cullen,ncullennw@baidu.com,Chemical Engineer,8226,1675,9901
35492,Malissa,Marland,mmarlandny@japanpost.jp,VP Marketing,2606,638,3244
35377,Gram,Faldoe,gfaldoeo0@quantcast.com,Senior Developer,6594,1605,8199
35623,Hamid,Ottawell,hottawello1@chron.com,Computer Systems Analyst IV,6312,487,6799
35360,Libby,Rielly,lriellyo4@illinois.edu,Account Executive,7582,1191,8773
35357,Keriann,Lafford,klaffordo7@skype.com,Compensation Analyst,7710,684,8394
35413,Jenilee,Boncore,jboncoreo8@foxnews.com,Human Resources Manager,2386,495,2881
35108,Gaultiero,Walsh,gwalsho9@admin.ch,Payment Adjustment Coordinator,3673,1633,5306
35622,Evangeline,Cullity,ecullityoc@patch.com,Developer III,8365,661,9026
35104,Nessa,Sausman,nsausmanod@free.fr,Human Resources Assistant IV,5992,914,6906
35081,Risa,Lodevick,rlodevickog@cmu.edu,Editor,1498,1134,2632
35940,Philippine,Tatters,ptattersoj@github.com,Database Administrator II,8072,1825,9897
35341,Jaimie,Jope,jjopeol@npr.org,Automation Specialist IV,5173,1148,6321
35299,Lizzy,Mendes,lmendeson@nymag.com,Desktop Support Technician,3013,817,3830
35587,Ari,Martonfi,amartonfiot@gov.uk,Administrative Officer,5442,675,6117
35401,Joannes,Greger,jgregerox@ucsd.edu,Sales Associate,9270,1034,10304
35381,Jamey,Ferreira,jferreiraoz@goo.gl,Director of Sales,3795,553,4348
35266,Renaldo,Purselow,rpurselowp0@homestead.com,Information Systems Manager,9876,274,10150
35893,Liam,Bowcock,lbowcockp1@narod.ru,Geological Engineer,1029,1571,2600
35643,Dun,Leaf,dleafp4@pbs.org,Teacher,2156,292,2448
35188,Storm,Lambrechts,slambrechtsp5@oracle.com,Geologist III,6294,1572,7866
35553,Timothy,Vala,tvalap8@trellian.com,Editor,3917,1098,5015
35945,Orelia,Connell,oconnellp9@intel.com,Nurse,7080,627,7707
35303,Kent,Stitwell,kstitwellpd@amazonaws.com,VP Product Management,9881,695,10576
35582,Marni,Ind,mindpg@washington.edu,Teacher,7230,246,7476
35222,Terese,Bagnall,tbagnallph@seesaa.net,Mechanical Systems Engineer,5567,1582,7149
35379,Ludwig,Heeran,lheeranpj@miitbeian.gov.cn,Assistant Media Planner,9930,915,10845
35355,Raf,Dagnan,rdagnanpr@wordpress.com,Web Designer IV,8665,1705,10370
35753,Krystyna,Gillard,kgillardpt@is.gd,Help Desk Operator,5537,239,5776
35878,Myrle,Dibbert,mdibbertpu@cafepress.com,Physical Therapy Assistant,5322,1022,6344
35246,Genny,Rozzier,grozzierpv@xinhuanet.com,Research Nurse,2025,964,2989
35175,Kellia,O'Scollain,koscollainpx@so-net.ne.jp,Speech Pathologist,8610,1101,9711
35708,Link,Stowe,lstowepz@nature.com,Executive Secretary,7872,1099,8971
35908,Georgia,Coppenhall,gcoppenhallq8@bandcamp.com,Account Coordinator,3695,1014,4709
35902,Jacobo,Edensor,jedensorqa@aboutads.info,Food Chemist,8825,930,9755
35234,Ardath,Cushe,acusheqg@bbc.co.uk,Assistant Professor,5104,1249,6353
35787,Skip,Levick,slevickqh@army.mil,Recruiting Manager,4527,1739,6266
35446,Danell,Vest,dvestqi@vk.com,Financial Analyst,6161,1697,7858
35179,Celie,Dunnett,cdunnettqj@go.com,Occupational Therapist,9832,540,10372
35310,Jaye,Olivo,jolivoqk@paginegialle.it,Account Coordinator,1119,1344,2463
35882,Jilleen,Ruggs,jruggsql@instagram.com,Financial Analyst,4312,1201,5513
35121,Jasmine,Stryde,jstrydeqn@chicagotribune.com,Senior Cost Accountant,3639,981,4620
35505,Ardelia,Bransby,abransbyqs@auda.org.au,Media Manager III,7446,270,7716
35140,Stephie,Peiro,speiroqu@parallels.com,Registered Nurse,3689,1232,4921
35861,Vinny,Lent,vlentqv@mit.edu,Software Engineer I,3650,1794,5444
35288,Tull,Bellenie,tbellenieqw@google.com.hk,Senior Financial Analyst,6857,1594,8451
35227,Nicolle,Giannoni,ngiannoniqy@paginegialle.it,Editor,7644,516,8160
35144,Godfry,Daubeny,gdaubenyqz@alexa.com,Accountant III,9914,364,10278
35768,Alric,Abrahart,aabrahartr3@symantec.com,Quality Engineer,4134,1810,5944
35620,Debee,Hansen,dhansenr4@msu.edu,Data Coordiator,8033,1725,9758
35524,Mikaela,Poundsford,mpoundsfordr5@bbc.co.uk,Registered Nurse,6786,894,7680
35784,Euell,Pryde,epryder9@furl.net,Web Developer III,9073,742,9815
35471,Toni,Ganing,tganingrd@printfriendly.com,Account Coordinator,5566,385,5951
35584,Kinnie,Osgood,kosgoodrf@diigo.com,Director of Sales,1356,1639,2995
35450,Courtney,Bulcock,cbulcockrg@slideshare.net,Biostatistician I,8141,411,8552
35145,Lind,Yetts,lyettsrj@indiegogo.com,Desktop Support Technician,4646,1503,6149
35323,Edy,Balmforth,ebalmforthrm@so-net.ne.jp,Speech Pathologist,1420,753,2173
36956,Evie,Pechard,epechard0@cnn.com,Nuclear Power Engineer,4404,868,5272
36859,Arlen,Aaronson,aaaronson1@bloglovin.com,Data Coordiator,6709,1079,7788
36337,Sophronia,Dunphy,sdunphy2@tiny.cc,Structural Engineer,2311,1419,3730
36471,Cody,Gailor,cgailor3@hao123.com,Payment Adjustment Coordinator,1660,1264,2924
36117,Maynord,Louche,mlouche4@oaic.gov.au,Human Resources Manager,5066,1997,7063
36983,Gaile,Bertot,gbertot5@i2i.jp,Business Systems Development Analyst,5814,1658,7472
36924,Jamey,Gelderd,jgelderd6@wiley.com,Chief Design Engineer,8422,570,8992
36234,Florance,Crossland,fcrossland7@fastcompany.com,Environmental Specialist,7524,601,8125
36290,Nissy,Conneely,nconneely8@t-online.de,Account Representative III,9170,1522,10692
36447,Trumann,Sparrowhawk,tsparrowhawk9@toplist.cz,Payment Adjustment Coordinator,4062,293,4355
36339,Benetta,Vynall,bvynalla@examiner.com,VP Quality Control,1195,805,2000
36725,Dennie,Kermon,dkermonb@yahoo.co.jp,Recruiter,5934,1954,7888
36977,Marika,Coggon,mcoggonc@woothemes.com,Programmer Analyst III,3025,1892,4917
36750,Witty,Wyman,wwymand@xrea.com,Quality Engineer,6530,1748,8278
36110,Kelsi,Haack,khaacke@macromedia.com,Assistant Manager,5522,856,6378
36601,Elliott,Crayke,ecraykef@yellowpages.com,Senior Developer,4287,925,5212
36027,Kattie,Aspray,kasprayg@squarespace.com,Senior Quality Engineer,2672,966,3638
36644,Georas,Corrison,gcorrisonh@dailymail.co.uk,VP Quality Control,1195,425,1620
36174,Dianne,Ashby,dashbyi@economist.com,Operator,3085,1674,4759
36714,Humfrid,Euels,heuelsj@goo.ne.jp,Web Designer I,6082,404,6486
36322,Mahalia,Winwood,mwinwoodk@jiathis.com,Human Resources Manager,7168,1698,8866
36537,Selene,Beminster,sbeminsterl@yelp.com,Pharmacist,7315,677,7992
36296,Zechariah,Alvarez,zalvarezn@mtv.com,Developer III,2852,674,3526
36199,Jeffry,Clampe,jclampeo@arstechnica.com,Physical Therapy Assistant,8305,324,8629
36667,Early,Ridsdole,eridsdoleq@oaic.gov.au,Physical Therapy Assistant,7601,817,8418
36682,Fayette,Reville,freviller@irs.gov,Chief Design Engineer,5680,1924,7604
36068,Lori,Helks,lhelkss@ibm.com,Product Engineer,5344,1694,7038
36618,Swen,Petegrew,spetegrewt@irs.gov,Account Representative IV,4889,917,5806
36948,Nealon,Reubens,nreubensu@friendfeed.com,Sales Associate,3148,537,3685
36371,Halsy,Cotterill,hcotterillv@spotify.com,Marketing Manager,6190,485,6675
36347,Shea,McKibben,smckibbenw@jiathis.com,Structural Engineer,4004,1505,5509
36556,Nefen,Langford,nlangfordx@studiopress.com,VP Quality Control,2671,1043,3714
36864,Edlin,Pettifer,epettifery@joomla.org,Analog Circuit Design manager,4683,860,5543
36196,Tore,Chsteney,tchsteneyz@acquirethisname.com,Desktop Support Technician,1570,1182,2752
36546,Thelma,Ingman,tingman10@people.com.cn,General Manager,7624,1163,8787
36728,Lucia,Lough,llough11@soup.io,Senior Cost Accountant,8377,738,9115
36854,Ed,Finlry,efinlry12@networkadvertising.org,Associate Professor,2294,754,3048
36345,Rorie,Hopewell,rhopewell13@themeforest.net,Web Designer IV,4872,1823,6695
36055,Jodi,Cushion,jcushion14@google.pl,Research Nurse,8105,775,8880
36538,Prudy,Sidey,psidey15@about.com,Mechanical Systems Engineer,4081,883,4964
36693,Dorise,Carley,dcarley17@utexas.edu,Marketing Assistant,2012,1838,3850
36726,Rasia,Creevy,rcreevy19@google.it,Actuary,3834,1137,4971
36189,Lianne,Sich,lsich1a@shareasale.com,Programmer IV,3648,1800,5448
36918,Norbert,Tapscott,ntapscott1b@economist.com,Staff Accountant III,4903,410,5313
36872,Veronique,Arington,varington1c@addthis.com,Design Engineer,6779,904,7683
36416,Dietrich,Banbrook,dbanbrook1d@amazon.co.jp,Assistant Media Planner,2677,1208,3885
36941,Theresita,Croci,tcroci1e@cbc.ca,GIS Technical Architect,2999,1741,4740
36061,Maxine,Duckham,mduckham1f@amazon.com,Account Coordinator,5901,1479,7380
36624,Isidor,Gooder,igooder1g@hugedomains.com,Marketing Manager,5379,204,5583
36206,Stephana,Chawner,schawner1h@jugem.jp,Programmer Analyst III,5516,361,5877
36250,Nolie,Atmore,natmore1j@illinois.edu,Pharmacist,2819,1339,4158
36931,Nedda,Matusovsky,nmatusovsky1k@prlog.org,Programmer I,6567,1339,7906
36858,Falito,Cronin,fcronin1l@smh.com.au,Graphic Designer,6231,805,7036
36694,Deeann,Helis,dhelis1m@google.com.au,Senior Sales Associate,3627,1638,5265
36034,Valery,Elcum,velcum1n@ow.ly,Statistician II,6839,458,7297
36383,Lexie,Casserly,lcasserly1o@google.com.hk,Professor,2953,709,3662
36844,Benni,Lanyon,blanyon1p@fema.gov,Help Desk Technician,8435,1740,10175
36152,Elena,Florentine,eflorentine1q@goo.ne.jp,Health Coach II,2847,1564,4411
36695,Rudolph,Klimke,rklimke1r@ihg.com,Business Systems Development Analyst,8495,1449,9944
36036,Kermy,Oxlee,koxlee1s@yelp.com,Community Outreach Specialist,2156,725,2881
36008,Loria,Waddilove,lwaddilove1t@stanford.edu,Software Engineer II,3410,1808,5218
36217,Godiva,Boston,gboston1u@so-net.ne.jp,Systems Administrator III,8304,1696,10000
36950,Anastasia,Ballchin,aballchin1v@prweb.com,Structural Analysis Engineer,6699,1085,7784
36623,Nevin,Gersam,ngersam1w@engadget.com,Structural Engineer,6434,343,6777
36441,Anett,Paxforde,apaxforde1x@blogtalkradio.com,Pharmacist,2024,256,2280
36282,Zondra,Humphrey,zhumphrey1y@skype.com,Financial Analyst,5720,999,6719
36022,James,Creffield,jcreffield1z@blogs.com,Nurse,9452,1185,10637
36478,Elita,Pepye,epepye20@yelp.com,Quality Control Specialist,5761,298,6059
36588,Sayre,Peskett,speskett21@facebook.com,Cost Accountant,7622,852,8474
36657,Katalin,Niaves,kniaves22@shinystat.com,Registered Nurse,4364,546,4910
36097,Cosmo,Giovani,cgiovani23@issuu.com,Director of Sales,1445,1929,3374
36329,Tessy,Macro,tmacro24@nydailynews.com,Administrative Officer,1667,828,2495
36594,Jessey,Krebs,jkrebs25@flavors.me,Associate Professor,5591,1506,7097
36429,Merry,Boate,mboate26@printfriendly.com,Community Outreach Specialist,2270,615,2885
36017,Elisabeth,Dunsire,edunsire27@naver.com,Chief Design Engineer,1522,1791,3313
36261,Ingelbert,Schenfisch,ischenfisch28@weibo.com,Food Chemist,3881,913,4794
36645,Alene,Corser,acorser29@nba.com,Chief Design Engineer,7778,532,8310
36216,Gage,Giffard,ggiffard2a@cnet.com,Research Assistant I,6283,1921,8204
36323,Zedekiah,Cubbon,zcubbon2b@forbes.com,Compensation Analyst,7412,1014,8426
36413,Lida,Beecheno,lbeecheno2c@go.com,Accountant III,2738,1742,4480
36572,Tanhya,Seson,tseson2d@examiner.com,Teacher,5471,992,6463
36109,Annette,O'Teague,aoteague2e@qq.com,Web Designer II,3101,997,4098
36248,Lane,Carlon,lcarlon2g@jiathis.com,General Manager,9016,500,9516
36884,Lind,McLaren,lmclaren2h@ted.com,Structural Engineer,8617,1259,9876
36242,Fanchon,Leer,fleer2j@nationalgeographic.com,Assistant Media Planner,9655,911,10566
36479,Kale,de Almeida,kdealmeida2k@example.com,Technical Writer,9998,1891,11889
36921,Imogen,Eborn,ieborn2l@exblog.jp,Technical Writer,6419,1316,7735
36962,Jo-ann,Roomes,jroomes2m@is.gd,Graphic Designer,4829,1789,6618
36685,Stoddard,Pimlock,spimlock2n@ted.com,Systems Administrator IV,1193,1750,2943
36135,Demetrius,Joss,djoss2o@state.gov,Programmer IV,4520,392,4912
36935,Justen,Harkins,jharkins2p@dmoz.org,Account Representative I,9474,1607,11081
36738,Dewitt,Faccini,dfaccini2q@europa.eu,Recruiting Manager,8421,898,9319
36895,Dorine,Pellatt,dpellatt2r@huffingtonpost.com,Human Resources Assistant II,4628,848,5476
36521,Wandie,Stuart,wstuart2s@woothemes.com,Senior Cost Accountant,5800,1497,7297
36445,Natalie,Tape,ntape2u@dailymail.co.uk,Legal Assistant,8932,1001,9933
36614,Wilmar,Burrow,wburrow2v@a8.net,Account Executive,1342,356,1698
36078,Zedekiah,Tolworthy,ztolworthy2w@edublogs.org,Software Engineer III,1357,1408,2765
36493,Zerk,Ferrie,zferrie2x@google.ca,Graphic Designer,9874,715,10589
36352,Husein,Urian,hurian2y@cornell.edu,Help Desk Technician,9152,1683,10835
36627,Lola,Blewis,lblewis2z@europa.eu,Help Desk Technician,3793,1464,5257
36522,Hortense,Lovel,hlovel30@techcrunch.com,Human Resources Manager,1176,1335,2511
36519,Sam,Crissil,scrissil31@nbcnews.com,Civil Engineer,2786,938,3724
36365,Everett,McGlue,emcglue32@ed.gov,Account Coordinator,9829,1934,11763
36732,Dewie,Evens,devens33@icio.us,Assistant Manager,5768,1261,7029
36037,Rourke,Bowmen,rbowmen34@craigslist.org,Assistant Media Planner,2908,1801,4709
36041,Inger,Kmiec,ikmiec35@sina.com.cn,Financial Analyst,4823,356,5179
36133,Judye,Buttner,jbuttner37@apple.com,Data Coordiator,4946,922,5868
36664,Anita,Torn,atorn38@uiuc.edu,Social Worker,1574,1755,3329
36011,Mandy,McGlade,mmcglade39@merriam-webster.com,Physical Therapy Assistant,5804,208,6012
36861,Ancell,Aylmore,aaylmore3a@reverbnation.com,Media Manager IV,5658,1274,6932
36558,Reinhard,Hugues,rhugues3b@sohu.com,Account Executive,3905,1681,5586
36813,Marrissa,Sabey,msabey3d@hostgator.com,Financial Advisor,5261,1466,6727
36461,Janaya,Bischoff,jbischoff3e@sciencedaily.com,Junior Executive,4358,1319,5677
36778,Giulia,Sutherby,gsutherby3f@wired.com,Executive Secretary,6305,1128,7433
36842,Harmonie,Beardow,hbeardow3g@imgur.com,Financial Analyst,1377,1770,3147
36771,Pooh,Dobell,pdobell3h@aboutads.info,Senior Developer,1917,1610,3527
36224,Lynne,Blenkensop,lblenkensop3i@csmonitor.com,Sales Associate,4445,695,5140
36056,Robinson,Ivashinnikov,rivashinnikov3j@zdnet.com,Software Consultant,3273,397,3670
36001,Cordie,Beldan,cbeldan3k@geocities.com,Account Representative III,5527,1207,6734
36609,Diana,Lamb,dlamb3l@mapquest.com,Speech Pathologist,2488,342,2830
36231,Sydney,Lambarth,slambarth3m@economist.com,Internal Auditor,9324,1826,11150
36809,Dickie,Carsey,dcarsey3n@youtu.be,Marketing Assistant,4645,217,4862
36802,Dalila,Lamanby,dlamanby3o@symantec.com,Sales Associate,5145,483,5628
36287,Banky,Willisch,bwillisch3p@infoseek.co.jp,Payment Adjustment Coordinator,1033,350,1383
36568,Joli,Longcaster,jlongcaster3q@ehow.com,Account Executive,3367,1458,4825
36783,Jarred,Findlater,jfindlater3r@blogs.com,Recruiting Manager,4779,1683,6462
36092,Teriann,Marishenko,tmarishenko3s@netvibes.com,Software Consultant,5329,953,6282
36727,Leontine,Pedel,lpedel3t@redcross.org,Cost Accountant,5474,828,6302
36316,Gwendolin,Andrysiak,gandrysiak3v@bluehost.com,Assistant Professor,5011,1986,6997
36934,Allegra,Launder,alaunder3w@craigslist.org,Nurse,4199,1465,5664
36427,Doug,Rickaert,drickaert3x@disqus.com,Director of Sales,8693,1632,10325
36065,Karia,Willmont,kwillmont3y@wikia.com,Speech Pathologist,9755,1230,10985
36468,Evan,Jorden,ejorden3z@bizjournals.com,Web Designer III,8742,389,9131
36619,Findley,Kingsley,fkingsley40@discovery.com,Quality Engineer,5492,1255,6747
36115,Lucita,Jarrette,ljarrette41@creativecommons.org,Registered Nurse,5020,1253,6273
36197,Noelyn,Iannuzzelli,niannuzzelli42@howstuffworks.com,Senior Cost Accountant,1591,1765,3356
36825,Maris,Coney,mconey43@prlog.org,Director of Sales,8861,959,9820
36281,Perle,Bevan,pbevan44@networkadvertising.org,Senior Sales Associate,4782,306,5088
36830,Jed,Lidgertwood,jlidgertwood45@geocities.com,Financial Analyst,2663,1942,4605
36419,Duffie,Condie,dcondie46@chicagotribune.com,Quality Control Specialist,1412,506,1918
36397,Beaufort,Dury,bdury47@mediafire.com,Database Administrator II,8770,1221,9991
36279,Blake,Findon,bfindon48@delicious.com,Accounting Assistant III,9688,1097,10785
36665,Cristian,Jarrard,cjarrard49@sitemeter.com,Social Worker,5236,1317,6553
36368,Charmian,Guyot,cguyot4a@so-net.ne.jp,Structural Analysis Engineer,5870,1976,7846
36803,Chere,Catton,ccatton4b@hhs.gov,VP Quality Control,3966,1415,5381
36475,Ody,Pieche,opieche4d@chronoengine.com,Health Coach II,6985,1286,8271
36638,Cornelle,Neller,cneller4e@usa.gov,Environmental Tech,4916,752,5668
36782,Amata,Colleck,acolleck4f@moonfruit.com,Structural Analysis Engineer,9980,709,10689
36944,Deina,MacNally,dmacnally4g@unblog.fr,Web Designer I,4617,904,5521
36517,Roberta,Bapty,rbapty4h@adobe.com,Sales Representative,8514,778,9292
36049,Nanon,Zohrer,nzohrer4i@ibm.com,Nurse Practicioner,9940,1842,11782
36658,Shermy,Willerstone,swillerstone4k@ft.com,GIS Technical Architect,6192,1502,7694
36827,Nicoli,McGerraghty,nmcgerraghty4l@pen.io,Accountant IV,2351,1283,3634
36868,Gerrie,Outerbridge,gouterbridge4m@infoseek.co.jp,Research Associate,7945,1926,9871
36524,Carlie,Panther,cpanther4n@stanford.edu,Marketing Assistant,7451,1183,8634
36367,Jozef,Klaiser,jklaiser4p@archive.org,Business Systems Development Analyst,2136,792,2928
36905,Abby,Ferrini,aferrini4q@123-reg.co.uk,Registered Nurse,9839,566,10405
36442,Alia,Garling,agarling4r@woothemes.com,Graphic Designer,3424,1015,4439
36663,Vasili,McGilben,vmcgilben4s@squidoo.com,Environmental Specialist,8843,865,9708
36426,Sollie,Badland,sbadland4t@networkadvertising.org,Executive Secretary,4466,1006,5472
36327,Claybourne,Clever,cclever4u@abc.net.au,Help Desk Operator,8959,1833,10792
36790,Vita,Redgrove,vredgrove4x@wikia.com,Physical Therapy Assistant,7675,640,8315
36463,Free,Gorey,fgorey4y@cnet.com,Senior Sales Associate,9982,1813,11795
36355,Dallas,Oliff,doliff4z@ocn.ne.jp,Design Engineer,5700,1429,7129
36942,Arnoldo,Pardon,apardon50@dot.gov,Payment Adjustment Coordinator,8585,269,8854
36251,Cesaro,Cabrera,ccabrera51@rediff.com,Geological Engineer,7937,1033,8970
36545,Evie,Scamadine,escamadine52@wufoo.com,Structural Analysis Engineer,5072,221,5293
36191,Vinny,Capeloff,vcapeloff53@delicious.com,Office Assistant IV,3723,1912,5635
36219,Skipp,Pappi,spappi55@ucsd.edu,VP Sales,8016,803,8819
36812,Tremain,Kennicott,tkennicott56@topsy.com,Compensation Analyst,3928,769,4697
36096,Candis,Skellorne,cskellorne57@theatlantic.com,Sales Representative,4203,878,5081
36482,Hammad,Corser,hcorser58@economist.com,Financial Analyst,9145,942,10087
36060,Nikolos,Skarin,nskarin59@pagesperso-orange.fr,Senior Cost Accountant,4028,1318,5346
36145,Caitrin,Scotchmoor,cscotchmoor5a@dropbox.com,Director of Sales,3211,317,3528
36586,Dev,Romaint,dromaint5b@dagondesign.com,Pharmacist,6414,1635,8049
36582,Flory,Gayne,fgayne5c@ustream.tv,Information Systems Manager,7512,1157,8669
36789,Fin,Lisciardelli,flisciardelli5d@creativecommons.org,Professor,5373,467,5840
36712,Corella,Mitro,cmitro5e@fema.gov,Human Resources Assistant II,4347,207,4554
36483,Celka,Fiske,cfiske5g@mozilla.com,Technical Writer,7576,1254,8830
36066,Zared,Welling,zwelling5h@seesaa.net,Recruiter,3808,386,4194
36679,Carlynne,Cadden,ccadden5i@fema.gov,Administrative Officer,5498,681,6179
36354,Ronalda,Chetter,rchetter5j@oracle.com,Senior Developer,8903,1638,10541
36967,Kiel,Harflete,kharflete5k@ustream.tv,Quality Control Specialist,6838,1676,8514
36703,Oswell,Brekonridge,obrekonridge5l@earthlink.net,Environmental Specialist,5707,332,6039
36661,Zuzana,Caso,zcaso5m@amazon.co.jp,Nurse,5220,817,6037
36393,Benn,Lingfoot,blingfoot5n@omniture.com,Technical Writer,4053,1209,5262
36998,Britt,Morais,bmorais5o@aboutads.info,Engineer IV,4581,1828,6409
36901,Alverta,Bayle,abayle5p@behance.net,Structural Analysis Engineer,8532,1971,10503
36930,Kasper,Matisoff,kmatisoff5q@theglobeandmail.com,VP Quality Control,1905,226,2131
36832,Holli,Rennison,hrennison5r@opera.com,Accountant III,6432,421,6853
36312,Dulce,Ahren,dahren5t@aboutads.info,Research Nurse,5120,964,6084
36795,Estrella,Porter,eporter5u@technorati.com,Budget/Accounting Analyst III,1662,1592,3254
36144,Bab,Rankling,brankling5v@wsj.com,Sales Associate,8308,1499,9807
36989,Theresa,Ten Broek,ttenbroek5w@miibeian.gov.cn,Data Coordiator,1849,565,2414
36777,Michele,Nisuis,mnisuis5x@craigslist.org,Administrative Assistant I,5308,250,5558
36089,Abbey,Streak,astreak61@mayoclinic.com,Teacher,1195,985,2180
36721,Fonsie,Hargate,fhargate62@seattletimes.com,VP Marketing,4346,1850,6196
36127,Zilvia,O' Connell,zoconnell63@harvard.edu,Account Coordinator,4261,1192,5453
36504,Etta,Glaister,eglaister64@unblog.fr,Account Representative II,2842,1754,4596
36768,Dredi,Keesman,dkeesman65@pbs.org,Clinical Specialist,7425,879,8304
36043,Oona,Goodenough,ogoodenough66@i2i.jp,Graphic Designer,4735,1035,5770
36606,Eleonora,Matula,ematula67@youtube.com,Civil Engineer,5989,910,6899
36147,Sally,Espie,sespie6a@umn.edu,Research Nurse,7456,1459,8915
36583,Vincents,Lotterington,vlotterington6b@phpbb.com,Recruiter,1957,1377,3334
36899,Kristoforo,Manjin,kmanjin6c@bloglovin.com,VP Accounting,7112,1602,8714
36708,Gloriana,Haccleton,ghaccleton6e@addtoany.com,Account Coordinator,3705,1993,5698
36986,Kellie,Sutworth,ksutworth6f@vk.com,Operator,7699,1235,8934
36849,Courtnay,Ivashkov,civashkov6g@topsy.com,Accountant I,7870,1823,9693
36850,Burgess,Hugland,bhugland6h@amazon.com,Teacher,1777,1148,2925
36671,Duncan,Faulder,dfaulder6i@wordpress.org,Associate Professor,7371,662,8033
36691,Lolly,O'Loughlin,loloughlin6j@engadget.com,General Manager,1082,1789,2871
36552,Carny,Joberne,cjoberne6l@gmpg.org,Accountant I,3034,906,3940
36923,Jeth,Pardal,jpardal6m@flickr.com,Financial Advisor,2337,1809,4146
36829,Dulciana,Crummey,dcrummey6n@delicious.com,Chief Design Engineer,3442,418,3860
36816,Alden,Pratley,apratley6o@domainmarket.com,Computer Systems Analyst I,5084,317,5401
36338,Olav,Cobain,ocobain6p@360.cn,Quality Engineer,3691,1829,5520
36595,Brook,Telfer,btelfer6q@delicious.com,Developer IV,9421,1852,11273
36912,Levey,Fishbie,lfishbie6r@java.com,Help Desk Operator,6051,616,6667
36443,Anderea,Kneebone,akneebone6s@squidoo.com,Senior Editor,9518,1681,11199
36492,Jason,Yellep,jyellep6t@bandcamp.com,Physical Therapy Assistant,8602,1256,9858
36856,Odille,Tombleson,otombleson6u@vk.com,Desktop Support Technician,6208,2000,8208
36758,Pattie,Medland,pmedland6v@devhub.com,Environmental Specialist,3936,1594,5530
36239,Chane,McCarry,cmccarry6w@weather.com,Senior Developer,2392,285,2677
36742,Gussy,Ide,gide6y@slideshare.net,Quality Control Specialist,3127,701,3828
36747,Ema,Rees,erees6z@mlb.com,Librarian,5036,1284,6320
36823,Stoddard,Platfoot,splatfoot70@ibm.com,Food Chemist,7194,1659,8853
36247,Dicky,Coogan,dcoogan71@npr.org,VP Quality Control,8334,1181,9515
36157,Thibaut,Remmers,tremmers72@ft.com,Assistant Manager,8166,1928,10094
36970,Letitia,Wilcher,lwilcher73@house.gov,Senior Developer,4727,1914,6641
36073,Olivia,Roles,oroles75@fotki.com,VP Accounting,4942,918,5860
36360,Brinna,Ipplett,bipplett76@intel.com,Staff Accountant I,6809,921,7730
36487,Arin,Ceillier,aceillier79@de.vu,Biostatistician III,5546,725,6271
36130,Neil,Thrussell,nthrussell7a@meetup.com,Business Systems Development Analyst,6355,817,7172
36395,Iolanthe,Bruckner,ibruckner7b@mac.com,VP Accounting,1746,1506,3252
36313,Sheridan,Rheubottom,srheubottom7d@ucoz.ru,Statistician II,2145,347,2492
36997,Krissy,Schulken,kschulken7e@artisteer.com,Analog Circuit Design manager,7123,1386,8509
36589,Tristan,Conti,tconti7f@gizmodo.com,Assistant Professor,3885,1246,5131
36520,Vaughn,Posnette,vposnette7i@imgur.com,Software Test Engineer II,5857,960,6817
36647,Price,Airds,pairds7j@flavors.me,Chief Design Engineer,5320,1857,7177
36817,Myron,Sumpter,msumpter7k@imdb.com,Human Resources Assistant III,7396,680,8076
36822,Konstantin,Cordall,kcordall7m@ted.com,Librarian,3298,227,3525
36412,Jeffie,Elletson,jelletson7n@columbia.edu,Mechanical Systems Engineer,2658,907,3565
36730,Lucina,Screwton,lscrewton7o@arstechnica.com,Assistant Manager,2161,948,3109
36304,Bastien,Tureville,btureville7p@bluehost.com,VP Quality Control,7778,415,8193
36444,Dory,Kilmister,dkilmister7q@slate.com,Budget/Accounting Analyst II,9361,1422,10783
36760,Clotilda,Joslyn,cjoslyn7r@sohu.com,Community Outreach Specialist,6433,775,7208
36952,Madonna,Leivers,mleivers7s@admin.ch,Chemical Engineer,2863,1535,4398
36284,Andreana,Grzegorzewicz,agrzegorzewicz7t@washingtonpost.com,Quality Engineer,3741,1178,4919
36177,Emmit,Warricker,ewarricker7u@jigsy.com,Account Executive,5931,1843,7774
36681,Blakeley,Purse,bpurse7v@gmpg.org,Engineer IV,8478,600,9078
36786,Nance,Belverstone,nbelverstone7w@51.la,Structural Analysis Engineer,3362,1865,5227
36333,Sherlock,Iley,siley7x@google.com.au,Developer I,5606,1634,7240
36880,Lu,Botright,lbotright7y@foxnews.com,Programmer IV,6464,1173,7637
36168,Stacy,Dunford,sdunford7z@instagram.com,Financial Advisor,5770,967,6737
36380,Vaclav,Vasovic,vvasovic80@bigcartel.com,Computer Systems Analyst III,6680,1589,8269
36735,Jennee,Gryglewski,jgryglewski81@networkadvertising.org,Software Test Engineer I,3275,1618,4893
36516,Sileas,Sowood,ssowood82@angelfire.com,Senior Quality Engineer,3017,1863,4880
36063,Brennen,Duckett,bduckett83@wordpress.org,Geological Engineer,1654,1140,2794
36269,Adlai,Gabites,agabites85@kickstarter.com,Web Developer III,2350,472,2822
36985,Darby,Carrell,dcarrell86@oakley.com,Desktop Support Technician,8443,422,8865
36138,Teri,Spurret,tspurret87@webs.com,Mechanical Systems Engineer,6404,935,7339
36188,Belinda,Prophet,bprophet88@furl.net,General Manager,7326,1947,9273
36421,Kellsie,De Wolfe,kdewolfe8a@cloudflare.com,Senior Sales Associate,7882,259,8141
36626,Vonny,Truss,vtruss8b@lulu.com,Web Developer II,7023,1582,8605
36286,Purcell,Tinson,ptinson8c@ftc.gov,Senior Sales Associate,2997,282,3279
36026,Norton,Casetta,ncasetta8d@ifeng.com,Web Developer II,6136,1227,7363
36706,Donovan,Planks,dplanks8g@nytimes.com,Sales Representative,7765,614,8379
36610,Rickie,Pellew,rpellew8h@opera.com,Graphic Designer,5311,253,5564
36964,Humfrid,Unwin,hunwin8i@state.gov,Mechanical Systems Engineer,2698,626,3324
36153,Dur,Josupeit,djosupeit8j@symantec.com,Programmer I,2404,880,3284
36132,Radcliffe,Batch,rbatch8m@bloglovin.com,Information Systems Manager,5803,1149,6952
36933,Hilde,Werrilow,hwerrilow8n@newyorker.com,Administrative Officer,2741,1762,4503
36014,Dorian,Sinden,dsinden8p@angelfire.com,Cost Accountant,8882,767,9649
36205,Willey,Zorer,wzorer8r@upenn.edu,Assistant Manager,4893,1017,5910
36720,Dolf,Brockley,dbrockley8s@google.co.uk,VP Product Management,1637,1434,3071
36123,Tandy,Bulluck,tbulluck8t@e-recht24.de,Environmental Tech,9972,791,10763
36175,Sophey,Turfrey,sturfrey8u@de.vu,General Manager,5663,928,6591
36307,Sib,Spillett,sspillett8v@ning.com,Database Administrator IV,5071,643,5714
36509,Penny,Whistan,pwhistan8x@feedburner.com,Accountant III,3471,1149,4620
36631,Hetty,Connal,hconnal90@blog.com,Senior Cost Accountant,9114,1660,10774
36331,Brew,Lusty,blusty91@whitehouse.gov,Speech Pathologist,9190,969,10159
36653,Bendite,O'Driscole,bodriscole92@facebook.com,Design Engineer,6428,743,7171
36764,Joane,Dyson,jdyson95@newsvine.com,Tax Accountant,7367,1675,9042
36491,Carri,Drewitt,cdrewitt97@icio.us,Sales Representative,1089,1132,2221
36406,Thurstan,Bottrill,tbottrill99@hao123.com,Engineer IV,9396,462,9858
36958,Adoree,Maudett,amaudett9a@storify.com,Geologist I,2825,867,3692
36300,Kayla,Mc Trusty,kmctrusty9c@vistaprint.com,Clinical Specialist,8355,406,8761
36227,Enoch,Mettetal,emettetal9d@tinyurl.com,Teacher,7738,1550,9288
36330,Marguerite,Zorn,mzorn9e@deliciousdays.com,Actuary,8843,939,9782
36386,Binnie,Coneron,bconeron9f@altervista.org,Account Coordinator,2852,1972,4824
36763,Angele,Friend,afriend9g@wp.com,Chemical Engineer,6583,1791,8374
36666,Ham,Conrad,hconrad9h@1und1.de,Operator,9891,1315,11206
36400,Gary,Pavy,gpavy9i@accuweather.com,Senior Developer,3576,1761,5337
36100,Lodovico,O'Canavan,locanavan9j@amazon.co.jp,Senior Developer,5356,219,5575
36165,Dorena,Cannicott,dcannicott9k@twitpic.com,Cost Accountant,8256,933,9189
36532,Mace,Littlecote,mlittlecote9l@google.it,Environmental Tech,5323,1596,6919
36121,Dwain,Plumley,dplumley9m@purevolume.com,Compensation Analyst,2640,1273,3913
36502,Dinnie,Haresign,dharesign9n@godaddy.com,Account Coordinator,7570,1627,9197
36743,Olag,Dumphries,odumphries9o@goo.gl,Environmental Specialist,3599,1326,4925
36806,Aurea,Gladeche,agladeche9p@msu.edu,Sales Associate,6155,1741,7896
36605,Sheila,Espadero,sespadero9q@netvibes.com,Software Test Engineer IV,2219,1805,4024
36098,Olav,Maddrell,omaddrell9r@tinyurl.com,Director of Sales,8499,347,8846
36562,Clerissa,Hain,chain9s@nbcnews.com,Clinical Specialist,7826,1315,9141
36882,Bea,Mannakee,bmannakee9v@latimes.com,General Manager,4395,1935,6330
36228,Lian,Mulroy,lmulroy9w@nih.gov,Computer Systems Analyst IV,1554,1860,3414
36815,Irv,Etridge,ietridge9x@wisc.edu,Community Outreach Specialist,5030,1355,6385
36857,Aylmer,McCard,amccard9y@reuters.com,Geological Engineer,1687,223,1910
36012,Ephraim,Pinks,epinks9z@facebook.com,Research Associate,9668,1715,11383
36166,Reta,MacConneely,rmacconneelya3@pagesperso-orange.fr,Financial Analyst,2610,1007,3617
36366,Noel,Artois,nartoisa6@economist.com,Computer Systems Analyst III,8747,1094,9841
36951,Michale,Markwick,mmarkwicka7@apache.org,Account Coordinator,2479,1546,4025
36781,Leopold,Orteu,lorteuab@timesonline.co.uk,Financial Analyst,7183,922,8105
36994,Cletis,Motion,cmotionac@altervista.org,Assistant Manager,1938,1663,3601
36298,Morten,Edwicker,medwickerae@1und1.de,VP Product Management,3302,898,4200
36891,Seymour,Izacenko,sizacenkoaf@devhub.com,Sales Associate,6404,1562,7966
36264,Maddie,Frift,mfriftag@dailymail.co.uk,Database Administrator I,3872,489,4361
36616,Gail,Caherny,gcahernyak@latimes.com,Accounting Assistant I,6017,277,6294
36828,Anya,Rablin,arablinal@nytimes.com,Research Nurse,7314,553,7867
36271,Luke,Banasik,lbanasikan@aol.com,Statistician I,6063,268,6331
36399,Cobbie,Schimank,cschimankap@networkadvertising.org,Biostatistician I,6287,1918,8205
36159,Keane,Avramovic,kavramovicaq@psu.edu,Geological Engineer,3039,1219,4258
36765,Deanna,Jezzard,djezzardar@shop-pro.jp,Nurse,5383,1607,6990
36141,Oralle,Leamon,oleamonas@sogou.com,Actuary,3053,1003,4056
36893,Miguel,Oag,moagau@wired.com,Actuary,1075,1620,2695
36564,Chaddy,Cobbing,ccobbingax@godaddy.com,Research Nurse,8774,1217,9991
36574,Curt,MacSporran,cmacsporranay@europa.eu,Cost Accountant,9929,342,10271
36263,Winslow,Godon,wgodonaz@aol.com,Health Coach III,8650,1216,9866
36340,Myron,Hartright,mhartrightb1@about.me,Clinical Specialist,7788,755,8543
36095,Debbi,Fosdick,dfosdickb2@sun.com,Internal Auditor,1371,543,1914
36867,Darya,Edens,dedensb3@mozilla.org,Product Engineer,6847,307,7154
36084,Hermina,Renner,hrennerb4@g.co,Research Assistant III,5103,1601,6704
36241,Gaspar,Whittock,gwhittockb5@biglobe.ne.jp,Administrative Assistant I,5600,1359,6959
36401,Lisbeth,McNay,lmcnayb6@live.com,Senior Cost Accountant,9006,1708,10714
36866,Bernardine,Reuben,breubenb7@nbcnews.com,Business Systems Development Analyst,1035,1821,2856
36009,Alica,Clemendot,aclemendotb8@wp.com,GIS Technical Architect,9560,428,9988
36274,Alison,Duckit,aduckitb9@timesonline.co.uk,Financial Analyst,8389,1515,9904
36223,Rowe,Kernock,rkernockba@ebay.com,Financial Analyst,8050,1209,9259
36676,Cariotta,Dwire,cdwirebc@wufoo.com,Electrical Engineer,4093,1533,5626
36641,Rudolfo,Moncey,rmonceybd@fotki.com,Administrative Assistant III,3833,671,4504
36917,Arnold,Calrow,acalrowbf@marketwatch.com,Design Engineer,9975,1429,11404
36254,Marjie,Redon,mredonbg@fastcompany.com,Pharmacist,3024,442,3466
36409,Deerdre,Naper,dnaperbh@slideshare.net,Senior Quality Engineer,2656,1802,4458
36622,Price,Taffe,ptaffebi@t-online.de,VP Sales,9737,1660,11397
36054,Emmerich,McClenaghan,emcclenaghanbk@cafepress.com,Structural Analysis Engineer,2436,1544,3980
36161,Esmaria,Scrancher,escrancherbl@lycos.com,Computer Systems Analyst IV,2596,1513,4109
36860,Kylila,Wethered,kwetheredbm@paypal.com,Director of Sales,2352,1064,3416
36200,Patience,Piechnik,ppiechnikbn@etsy.com,Developer III,8149,691,8840
36511,Mab,Masurel,mmasurelbp@nationalgeographic.com,Occupational Therapist,1368,1417,2785
36649,Dalila,Friend,dfriendbr@moonfruit.com,Environmental Tech,8449,1967,10416
36433,Joletta,Brunnen,jbrunnenbu@ted.com,Research Assistant III,7268,1385,8653
36981,Sylas,Really,sreallybv@state.tx.us,Environmental Tech,2404,1288,3692
36928,Candie,Nanninini,cnannininibw@ca.gov,Financial Analyst,5464,435,5899
36375,Honoria,Narraway,hnarrawaybx@businessweek.com,Environmental Specialist,2478,1726,4204
36301,Iggie,Yeulet,iyeuletby@exblog.jp,Marketing Assistant,7477,398,7875
36547,Flinn,Carnier,fcarnierbz@mediafire.com,Clinical Specialist,4599,1487,6086
36785,Shaun,Elkin,selkinc0@linkedin.com,Junior Executive,9588,320,9908
36317,Adriane,Sexty,asextyc1@zdnet.com,Librarian,5790,1628,7418
36052,Rik,Plott,rplottc2@accuweather.com,Assistant Professor,5251,838,6089
36378,Marice,Augustus,maugustusc3@imgur.com,Administrative Assistant IV,6379,1127,7506
36762,Elinor,Balchin,ebalchinc4@cisco.com,Sales Associate,2462,1120,3582
36019,Guillemette,Oxe,goxec5@google.it,Marketing Assistant,7391,416,7807
36548,Dulcea,Antony,dantonyc6@barnesandnoble.com,Accounting Assistant I,8360,612,8972
36221,Arlene,Komorowski,akomorowskic8@seattletimes.com,Environmental Specialist,8818,975,9793
36651,Corabella,Shatliffe,cshatliffec9@printfriendly.com,VP Sales,4749,1746,6495
36902,Aldis,Gaskin,agaskinca@buzzfeed.com,Desktop Support Technician,2971,1233,4204
36256,Blake,Rowthorn,browthorncb@flickr.com,Web Developer III,7214,728,7942
36148,Garald,Sinyard,gsinyardcc@prnewswire.com,Civil Engineer,7333,1680,9013
36611,Marianna,Thecham,mthechamcd@msn.com,Research Assistant II,9683,1387,11070
36361,Raquela,Charlotte,rcharlottece@dot.gov,Recruiting Manager,6713,577,7290
36528,Gussy,Finch,gfinchcf@facebook.com,Social Worker,4097,970,5067
36646,Birk,Conti,bconticg@netscape.com,Associate Professor,8286,1244,9530
36038,Leonie,Barnshaw,lbarnshawcn@mapy.cz,Assistant Professor,3831,1201,5032
36466,Trace,Massei,tmasseicq@mlb.com,Director of Sales,7810,1836,9646
36272,Jeddy,Antuoni,jantuonicu@ovh.net,Community Outreach Specialist,3259,731,3990
36554,Nomi,Rengger,nrenggercw@pinterest.com,Associate Professor,3810,1796,5606
36834,Micheal,McGarrity,mmcgarritycy@marriott.com,VP Product Management,9387,394,9781
36053,Kerry,Skyrme,kskyrmecz@sitemeter.com,Graphic Designer,5957,954,6911
37000,Jeanne,Matusovsky,jmatusovskyd2@foxnews.com,Administrative Assistant I,4723,391,5114
36841,Gail,Babinski,gbabinskid3@cpanel.net,Paralegal,9718,318,10036
36167,Malcolm,Zamora,mzamorad5@abc.net.au,Business Systems Development Analyst,9808,1040,10848
36945,Dukey,Ezzell,dezzelld6@ehow.com,Payment Adjustment Coordinator,3768,550,4318
36592,Ailbert,Fealty,afealtyd7@cbsnews.com,Sales Representative,6806,854,7660
36170,Terza,Hubball,thubballd8@rediff.com,Web Developer I,4597,1937,6534
36164,Louie,Tungate,ltungated9@blinklist.com,Librarian,8035,833,8868
36635,Arni,Sturror,asturrordc@sphinn.com,Programmer Analyst IV,1595,1158,2753
36845,Dunn,Bryden,dbrydendd@lycos.com,Research Associate,2233,1807,4040
36971,Demetra,Ruoff,druoffde@squarespace.com,Mechanical Systems Engineer,1415,926,2341
36169,Enoch,Tremoulet,etremouletdf@ameblo.jp,Clinical Specialist,9291,521,9812
36800,Jewell,Latour,jlatourdg@globo.com,Developer III,8395,1921,10316
36238,Tracey,Tittershill,ttittershilldh@senate.gov,Safety Technician I,3285,311,3596
36212,Maye,Sommerling,msommerlingdk@blogtalkradio.com,Civil Engineer,7693,1114,8807
36705,Hadlee,Cafferky,hcafferkydm@fastcompany.com,Product Engineer,4661,592,5253
36633,Eal,Midson,emidsondn@mapy.cz,Speech Pathologist,1850,585,2435
36748,Aldous,Casterton,acastertondo@jiathis.com,Web Developer IV,3409,1351,4760
36489,Daveta,Gosnay,dgosnaydp@homestead.com,Pharmacist,6720,1912,8632
36677,Lorinda,Wint,lwintdq@hostgator.com,Food Chemist,7597,1383,8980
36602,Jone,Shulver,jshulverdr@plala.or.jp,Analyst Programmer,6970,1775,8745
36083,Wenonah,Grzes,wgrzesdu@nature.com,Senior Cost Accountant,6731,1351,8082
36184,Bent,Liptrot,bliptrotdy@amazonaws.com,Computer Systems Analyst III,2811,263,3074
36648,Rutter,Mollon,rmollondz@paypal.com,Web Designer IV,4752,1550,6302
36578,Noel,Brearty,nbreartye1@smugmug.com,Analyst Programmer,2440,1177,3617
36761,Robert,Pickerell,rpickerelle3@quantcast.com,Senior Financial Analyst,2396,1148,3544
36741,Abner,Rohfsen,arohfsene4@theglobeandmail.com,Occupational Therapist,8111,1825,9936
36033,Emmit,Lowers,elowerse5@cbslocal.com,Staff Scientist,9641,417,10058
36525,Marta,Rodd,mrodde9@ebay.com,Editor,1320,698,2018
36215,Umeko,O'Lenane,uolenaneea@auda.org.au,Actuary,3301,1433,4734
36526,Isabeau,Alf,ialfed@dell.com,Physical Therapy Assistant,4666,576,5242
36230,Rikki,Karolowski,rkarolowskiee@discovery.com,Senior Financial Analyst,3749,1878,5627
36551,Kara-lynn,Christophers,kchristopherseg@berkeley.edu,Assistant Professor,5247,604,5851
36779,Janaya,Domegan,jdomeganei@phoca.cz,Budget/Accounting Analyst III,6565,1347,7912
36002,Caldwell,Maystone,cmaystoneek@nydailynews.com,Project Manager,3027,1267,4294
36190,Arther,Normant,anormantel@vistaprint.com,Occupational Therapist,4259,224,4483
36974,Maurita,Stiven,mstivenem@google.co.uk,Nurse,2445,1078,3523
36978,Elizabet,Medling,emedlingen@bing.com,Food Chemist,2456,1925,4381
36128,Bernita,Vize,bvizeep@zimbio.com,Human Resources Manager,8681,1857,10538
36885,Eve,Klosges,eklosgeseq@wsj.com,Design Engineer,7643,1749,9392
36124,Bay,Peel,bpeelet@purevolume.com,Assistant Manager,3598,674,4272
36696,Galvan,Lohrensen,glohrenseneu@thetimes.co.uk,Account Coordinator,7878,584,8462
36171,Casar,Melbourne,cmelbourneev@uol.com.br,Recruiter,4554,1377,5931
36007,Delia,Dunan,ddunanew@google.pl,Associate Professor,5965,506,6471
36003,Bernhard,Vampouille,bvampouilleex@imageshack.us,Chief Design Engineer,5254,1494,6748
36193,Cal,McGarahan,cmcgarahaney@nationalgeographic.com,Safety Technician III,6128,791,6919
36021,Quincy,Candelin,qcandelinf1@prweb.com,Staff Accountant III,6555,630,7185
36172,Merla,Schirak,mschirakf4@pinterest.com,Junior Executive,9461,1217,10678
36736,Karney,McCaskell,kmccaskellf5@wp.com,Help Desk Technician,3671,297,3968
36047,Hammad,Critten,hcrittenf6@google.com,Research Assistant IV,4170,545,4715
36914,Dinnie,Shacklady,dshackladyf8@princeton.edu,Executive Secretary,4613,1626,6239
36107,Elyse,Eberts,eebertsf9@army.mil,Teacher,3150,269,3419
36086,Dominga,Buddington,dbuddingtonfb@epa.gov,Office Assistant I,4176,1873,6049
36719,Otes,Ailmer,oailmerfc@cbc.ca,Staff Accountant IV,1692,467,2159
36584,Janet,Blenkharn,jblenkharnfd@wisc.edu,Quality Engineer,4775,653,5428
36632,Rubia,Stairmand,rstairmandfe@guardian.co.uk,Financial Analyst,1907,1758,3665
36069,Ethelyn,Gaucher,egaucherfg@washingtonpost.com,Nuclear Power Engineer,9867,1402,11269
36414,Killy,McIlwaine,kmcilwainefh@uiuc.edu,VP Marketing,6604,1118,7722
36481,Debbie,Eitter,deitterfj@discuz.net,Office Assistant IV,8290,1032,9322
36848,Davida,De Filippo,ddefilippofo@linkedin.com,Database Administrator I,1800,1741,3541
36506,Cliff,Giroldo,cgiroldofp@whitehouse.gov,VP Sales,8791,264,9055
36640,Harley,Cranmor,hcranmorfq@jiathis.com,Software Engineer I,9025,1716,10741
36915,Muire,Messer,mmesserfr@vkontakte.ru,Help Desk Operator,5847,1547,7394
36289,Theo,Clavey,tclaveyfs@cloudflare.com,Data Coordiator,3662,822,4484
36351,Ulick,Tustin,utustinft@ftc.gov,Administrative Assistant III,9574,948,10522
36634,Zaccaria,Macilhench,zmacilhenchfu@upenn.edu,Senior Quality Engineer,2126,1775,3901
36826,Symon,McCahey,smccaheyfw@newyorker.com,Community Outreach Specialist,6400,1458,7858
36529,Tobi,MacDiarmond,tmacdiarmondg4@pen.io,Operator,1437,839,2276
36226,Mary,Korn,mkorng6@uol.com.br,Payment Adjustment Coordinator,3058,1636,4694
36947,Ardith,Shovlin,ashovling7@bbc.co.uk,Professor,2138,1063,3201
36458,Gabriel,McIlheran,gmcilherang9@desdev.cn,Data Coordiator,2376,1061,3437
36751,Brnaby,Matei,bmateigc@irs.gov,Financial Advisor,5642,978,6620
36424,Laureen,Carlson,lcarlsonge@ameblo.jp,Product Engineer,4130,1898,6028
36448,Barrie,Slaymaker,bslaymakergg@paypal.com,Senior Developer,7595,219,7814
36776,Kerrill,Flegg,kflegggk@oakley.com,Payment Adjustment Coordinator,7648,298,7946
36311,Erie,Trounson,etrounsongm@jiathis.com,Human Resources Assistant III,4333,1072,5405
36057,Alyson,Seckington,aseckingtongn@dailymail.co.uk,Quality Engineer,3907,1407,5314
36965,Idell,Blaxter,iblaxtergo@cargocollective.com,Developer IV,8660,861,9521
36318,Tasha,Andrzejczak,tandrzejczakgq@mozilla.com,Legal Assistant,3579,1842,5421
36755,Antoni,Langthorne,alangthornegs@quantcast.com,Account Coordinator,1691,216,1907
36253,Flossie,Veall,fveallgt@indiegogo.com,Assistant Professor,6757,262,7019
36852,Hewitt,Angell,hangellgv@washingtonpost.com,Quality Control Specialist,8769,607,9376
36099,Rayshell,Dinjes,rdinjesgx@prweb.com,Account Executive,5789,1488,7277
36774,Durand,Yuryaev,dyuryaevgy@arstechnica.com,Research Assistant II,4562,342,4904
36276,Mylo,Opdenorth,mopdenorthgz@bing.com,Budget/Accounting Analyst IV,4662,1262,5924
36919,Carena,Chasson,cchassonh4@a8.net,Quality Engineer,2420,617,3037
36335,Roma,Groomebridge,rgroomebridgeh5@time.com,Help Desk Technician,3859,1841,5700
36439,Hazel,Beert,hbeerth6@ftc.gov,Research Associate,7159,608,7767
36467,Randy,Joynson,rjoynsonh7@g.co,Administrative Officer,5574,1499,7073
36042,Hattie,McCarlie,hmccarliehd@theglobeandmail.com,Structural Engineer,3760,1225,4985
36237,Verile,Matitiaho,vmatitiahohe@blog.com,Senior Developer,9545,1718,11263
36332,Hedwig,Lenard,hlenardhj@vk.com,Help Desk Operator,2713,1844,4557
36518,Berkley,Ballentime,bballentimehk@apache.org,Budget/Accounting Analyst I,3435,679,4114
36233,Prent,Ximenez,pximenezhl@tiny.cc,Database Administrator II,3341,829,4170
36674,Marshall,Culleford,mcullefordhn@google.co.jp,Project Manager,2190,1792,3982
36543,Nial,Petteford,npettefordho@tamu.edu,Systems Administrator III,6454,1512,7966
36460,Laurie,Scothron,lscothronhr@wiley.com,Dental Hygienist,4022,1010,5032
36183,Jayme,Frayn,jfraynhs@soundcloud.com,Research Associate,4801,786,5587
36222,Merl,Tellenbrok,mtellenbrokhu@psu.edu,Nuclear Power Engineer,9289,751,10040
36465,Hewett,O'Hingerty,hohingertyhy@va.gov,Project Manager,8760,1983,10743
36672,Claudell,Cracie,ccraciehz@mashable.com,Software Consultant,7800,656,8456
36804,Sibel,Luca,slucai1@adobe.com,Developer IV,6323,1987,8310
36299,Shandie,Carratt,scarratti2@umich.edu,Human Resources Assistant II,5332,1867,7199
36788,Anjela,Duggan,aduggani3@businesswire.com,Social Worker,9872,933,10805
36108,Querida,Ridgewell,qridgewelli5@live.com,Environmental Specialist,3823,779,4602
36784,Sylvia,Heam,sheami6@ucoz.com,VP Sales,1893,1115,3008
36319,George,Rains,grainsi7@army.mil,Information Systems Manager,2513,970,3483
36851,Neale,Rainton,nraintoni8@engadget.com,Senior Editor,1634,1689,3323
36876,Gussie,Rustadge,grustadgei9@skype.com,Quality Engineer,3047,637,3684
36707,Kelbee,Errichelli,kerrichelliib@is.gd,Assistant Media Planner,1909,1555,3464
36911,Leontyne,De la Perrelle,ldelaperrelleic@dion.ne.jp,Sales Associate,2244,629,2873
36702,Sebastien,Bagwell,sbagwellid@over-blog.com,Sales Representative,1869,1316,3185
36388,Rosabelle,Sappell,rsappellih@cyberchimps.com,Programmer Analyst IV,8145,919,9064
36422,Ruperto,Frenzl,rfrenzlii@stumbleupon.com,Senior Cost Accountant,1031,1665,2696
36913,Harmony,Kopec,hkopecik@ft.com,Senior Sales Associate,9818,1010,10828
36907,Wade,Madsen,wmadsenio@goo.gl,Geologist IV,2798,1498,4296
36875,Kippy,Jopling,kjoplingir@gizmodo.com,Senior Developer,6798,697,7495
36513,Humphrey,Westnage,hwestnageis@hp.com,Speech Pathologist,6601,1408,8009
36688,Powell,Hamlen,phamlenit@seattletimes.com,Data Coordiator,8833,1174,10007
36118,Jeanine,Abbotts,jabbottsiv@people.com.cn,Research Assistant I,1472,1895,3367
36881,Willi,Blyden,wblydeniw@samsung.com,Software Engineer III,5123,1323,6446
36639,Aprilette,Murfett,amurfettix@harvard.edu,Health Coach IV,3422,1837,5259
36176,Schuyler,Organ,sorganiz@amazon.de,Geologist III,5759,1912,7671
36143,Chas,Cecere,ccecerej0@google.com.au,Registered Nurse,4718,1997,6715
36938,Della,Tenpenny,dtenpennyj8@addthis.com,Accountant I,4776,1801,6577
36745,Gustavo,Arrow,garrowja@smh.com.au,Recruiter,1987,445,2432
36030,Dolores,Golley,dgolleyjd@issuu.com,Web Designer III,9605,597,10202
36925,Gonzales,McCague,gmccagueje@xinhuanet.com,Chief Design Engineer,7713,1225,8938
36016,Fanechka,Scud,fscudjf@merriam-webster.com,Human Resources Manager,7689,1967,9656
36536,Arluene,Sandom,asandomjg@yellowpages.com,Physical Therapy Assistant,8582,722,9304
36837,Valerye,Keller,vkellerji@ted.com,Account Representative II,9283,714,9997
36059,Ange,Sheehan,asheehanjk@netlog.com,Help Desk Operator,5566,1950,7516
36428,Fran,Feaveer,ffeaveerjn@google.co.uk,Software Engineer II,6542,1614,8156
36752,Dean,Hamsley,dhamsleyjq@goo.ne.jp,Senior Cost Accountant,7231,918,8149
36150,Pierson,Oswal,poswaljr@printfriendly.com,Media Manager IV,2294,868,3162
36072,Ulric,Patesel,upateseljs@sphinn.com,Senior Editor,5754,1669,7423
36451,Dalia,Tupper,dtupperjt@bbb.org,Business Systems Development Analyst,7472,631,8103
36560,Wendell,Coultass,wcoultassju@networkadvertising.org,Associate Professor,6635,1705,8340
36452,Lewie,Sudy,lsudyjy@census.gov,Accountant I,7410,1751,9161
36615,Nestor,Skettles,nskettlesk1@abc.net.au,Health Coach IV,9127,657,9784
36999,Lloyd,Smorthit,lsmorthitk3@bizjournals.com,Engineer I,1110,967,2077
36954,Pansie,Dunton,pduntonk5@delicious.com,Automation Specialist IV,1608,1273,2881
36561,Victoria,Rikkard,vrikkardkc@guardian.co.uk,Environmental Tech,1957,491,2448
36654,Von,Aldred,valdredke@paginegialle.it,Operator,2310,1225,3535
36662,Karlyn,Redford,kredfordkg@google.com.br,Accounting Assistant I,9859,607,10466
36668,Darren,Zelake,dzelakekj@lulu.com,Geological Engineer,3980,1922,5902
36006,Dominique,Pitkeathley,dpitkeathleykl@noaa.gov,Information Systems Manager,6134,1730,7864
36112,Hernando,Norrey,hnorreykm@mozilla.com,Senior Editor,3638,207,3845
36835,Ody,Syddon,osyddonkn@arizona.edu,Senior Financial Analyst,5969,1387,7356
36542,Dell,Ryton,drytonko@hatena.ne.jp,Tax Accountant,5430,791,6221
36877,Britte,Byram,bbyramkt@bravesites.com,Design Engineer,4253,442,4695
36104,Isaak,Lovewell,ilovewellku@huffingtonpost.com,VP Accounting,9163,1750,10913
36344,Thomasine,Lattie,tlattieky@nih.gov,Chemical Engineer,9591,1517,11108
36245,Cristi,O'Dowd,codowdl0@netlog.com,Software Engineer III,5366,1479,6845
36510,Isidora,Derr,iderrl1@webs.com,Design Engineer,2320,1954,4274
36474,Concordia,Inglesant,cinglesantl2@aol.com,Staff Accountant II,6945,1092,8037
36163,Brunhilde,Kervin,bkervinl4@wufoo.com,VP Accounting,6944,1062,8006
36425,Carree,Pywell,cpywelll5@slashdot.org,Programmer I,9034,1282,10316
36724,Dreddy,Calderonello,dcalderonellol7@miibeian.gov.cn,Nurse,1345,1604,2949
36869,Barty,Crocumbe,bcrocumbel8@people.com.cn,Social Worker,5093,1156,6249
36040,Margareta,Downing,mdowninglb@nyu.edu,Analog Circuit Design manager,4809,1256,6065
36847,Con,Goalley,cgoalleyle@seesaa.net,Director of Sales,1211,289,1500
36357,Neils,Deplacido,ndeplacidoli@house.gov,Financial Advisor,8255,1069,9324
36391,Melita,O'Harney,moharneylj@marketwatch.com,Product Engineer,5571,1621,7192
36270,Konstantin,Henrion,khenrionll@usnews.com,Statistician I,2504,1073,3577
36151,Shirleen,Nevinson,snevinsonlm@marketwatch.com,Software Engineer III,1195,331,1526
36438,Christoph,Humphery,chumpherylo@biblegateway.com,Chemical Engineer,6248,1028,7276
36932,Hetti,Minister,hministerlq@typepad.com,Teacher,1210,1328,2538
36836,Angel,Lorraine,alorrainelr@reference.com,Actuary,7928,1310,9238
36473,Annice,Treslove,atreslovels@bbc.co.uk,Safety Technician I,7722,546,8268
36729,Dot,Bohey,dboheylt@spiegel.de,VP Accounting,9073,974,10047
36879,Noach,Brandenburg,nbrandenburglv@webeden.co.uk,Design Engineer,8742,1754,10496
36341,Ethel,Kilrow,ekilrowly@admin.ch,Community Outreach Specialist,7629,1940,9569
36436,Burlie,Inder,binderm0@army.mil,Quality Engineer,3007,1724,4731
36499,Powell,Waterhous,pwaterhousm1@sohu.com,Staff Scientist,6731,819,7550
36087,Violetta,Marti,vmartim2@prweb.com,Payment Adjustment Coordinator,7790,1457,9247
36187,Adella,Beausang,abeausangm5@earthlink.net,Web Developer IV,9796,1185,10981
36953,Rivi,Palfrey,rpalfreym6@zdnet.com,GIS Technical Architect,1773,1261,3034
36699,Anabelle,Fruish,afruishm9@spotify.com,Occupational Therapist,1409,1372,2781
36240,Wayland,Graveney,wgraveneymc@bloglines.com,Programmer Analyst I,2785,1058,3843
36480,Tracy,Whetnell,twhetnellmd@qq.com,Sales Associate,3720,539,4259
36759,Jimmy,Brinson,jbrinsonme@nyu.edu,Web Developer III,6882,759,7641
36265,Cathyleen,Riccetti,criccettimf@xinhuanet.com,Senior Financial Analyst,4426,393,4819
36797,Findley,Pitway,fpitwaymi@deliciousdays.com,Environmental Specialist,6380,980,7360
36334,Magda,Hradsky,mhradskymj@wordpress.org,Senior Quality Engineer,4033,480,4513
36943,Ami,Jenny,ajennymo@seesaa.net,Design Engineer,2552,1517,4069
36476,Devland,Dews,ddewsmq@dailymotion.com,Senior Editor,9978,741,10719
36404,Ewan,Culpan,eculpanmr@europa.eu,Business Systems Development Analyst,2179,332,2511
36105,Shane,Flucks,sflucksmu@sun.com,Financial Advisor,3106,1430,4536
36459,Jennilee,Brideau,jbrideaumv@vimeo.com,Tax Accountant,4329,877,5206
36122,Ricki,Bonicelli,rbonicellin0@mit.edu,Registered Nurse,9684,1487,11171
36846,Stanleigh,Bonar,sbonarn1@bizjournals.com,Speech Pathologist,1692,1107,2799
36673,Thekla,Wickey,twickeyn3@php.net,Junior Executive,7107,1650,8757
36862,Paco,Miskimmon,pmiskimmonn7@wikispaces.com,Account Coordinator,9513,545,10058
36293,Reggi,Tranter,rtranternc@bandcamp.com,Chief Design Engineer,5914,420,6334
36101,Giffie,Hursey,ghurseynd@github.com,Analyst Programmer,5940,1377,7317
36541,Shay,Buckmaster,sbuckmasternf@intel.com,Sales Representative,7214,595,7809
36775,Willa,Delos,wdelosno@posterous.com,Editor,9337,1820,11157
36244,Marlin,Ventam,mventamnp@xrea.com,VP Sales,5173,262,5435
36495,Madelle,Demcak,mdemcaknq@angelfire.com,Quality Engineer,7931,681,8612
36308,Adele,Dulinty,adulintynw@timesonline.co.uk,Help Desk Technician,9968,1676,11644
36871,Timofei,Mancer,tmancernx@geocities.com,Accountant IV,3201,1287,4488
36652,Tressa,Fryers,tfryersnz@ftc.gov,Data Coordiator,9617,343,9960
36362,Gifford,Flute,gfluteo0@multiply.com,Media Manager II,8588,785,9373
36203,Alta,Hollingdale,ahollingdaleo3@nifty.com,Staff Scientist,7826,379,8205
36423,Nigel,Seater,nseatero6@businessinsider.com,Web Designer IV,8877,1661,10538
36916,Florian,Rubinov,frubinovo7@reuters.com,Help Desk Operator,9586,529,10115
36179,Cortney,Dovidian,cdovidiano8@mlb.com,Editor,6294,808,7102
36155,Hildagarde,Drynan,hdrynanoa@biglobe.ne.jp,Biostatistician II,2947,809,3756
36180,Meggy,Quibell,mquibelloe@ycombinator.com,Information Systems Manager,3452,1550,5002
36972,Bamby,Mell,bmellog@cocolog-nifty.com,Operator,8478,662,9140
36077,Cristabel,Beartup,cbeartupoh@mozilla.com,Computer Systems Analyst I,3709,526,4235
36430,Rhonda,Kirrage,rkirrageoj@paginegialle.it,Teacher,3309,1800,5109
36555,Linnet,Garnsworthy,lgarnsworthyol@istockphoto.com,Teacher,1805,1166,2971
36793,Hoyt,Dixson,hdixsonom@cbslocal.com,Senior Financial Analyst,5662,422,6084
36457,Donnie,Greiswood,dgreiswoodoo@shareasale.com,Teacher,5985,205,6190
36692,Jessie,Knudsen,jknudsenot@opensource.org,Chemical Engineer,6444,1822,8266
36390,Renee,Burkin,rburkinox@myspace.com,Marketing Manager,2136,683,2819
36236,Jennica,Brundill,jbrundillp3@archive.org,Civil Engineer,3983,1008,4991
36906,Lelia,Hinder,lhinderp4@smugmug.com,Programmer I,3845,595,4440
36575,Sauveur,Chessil,schessilp6@yelp.com,Account Executive,9280,1338,10618
36811,Violet,Arp,varpp8@wikipedia.org,Senior Developer,6932,307,7239
36020,Pancho,Hantusch,phantuschp9@etsy.com,Quality Engineer,4496,469,4965
36252,Faulkner,Hearn,fhearnpa@unicef.org,VP Marketing,7088,1079,8167
36549,Danni,Chillingsworth,dchillingsworthpc@stumbleupon.com,Nuclear Power Engineer,7573,383,7956
36700,Annabelle,Fernie,aferniepd@jalbum.net,Quality Engineer,8298,1381,9679
36805,Brittani,Behrens,bbehrenspe@fda.gov,Account Coordinator,7836,757,8593
36257,Lu,Knoller,lknollerpf@harvard.edu,Financial Analyst,9756,1734,11490
36186,Alla,Dericot,adericotph@wordpress.com,Registered Nurse,2856,1460,4316
36770,Dot,Conigsby,dconigsbypi@google.co.jp,VP Quality Control,1767,754,2521
36780,Kelly,Yukhnev,kyukhnevpk@feedburner.com,Desktop Support Technician,8852,576,9428
36192,Kinsley,Jacombs,kjacombspl@ft.com,Accountant I,7044,915,7959
36613,Blake,Saiens,bsaienspn@prweb.com,Social Worker,6129,635,6764
36596,Vincenty,Gillbard,vgillbardpq@europa.eu,Research Nurse,4805,1662,6467
36581,Lulita,Seath,lseathpr@cmu.edu,Statistician II,3129,1857,4986
36194,Obediah,Jenno,ojennopt@irs.gov,VP Quality Control,1336,531,1867
36134,Lowell,Perrett,lperrettpx@google.nl,Structural Analysis Engineer,8739,622,9361
36211,Hashim,Holbury,hholburypz@hatena.ne.jp,Engineer I,4175,950,5125
36315,Tessi,Fraschetti,tfraschettiq5@spiegel.de,Dental Hygienist,8686,1730,10416
36394,Jolene,Argente,jargenteq6@prweb.com,Account Coordinator,7542,1137,8679
36268,Clara,Sandeland,csandelandqa@economist.com,Accounting Assistant II,6820,321,7141
36213,Vincent,Bilbrook,vbilbrookqc@over-blog.com,Information Systems Manager,7557,375,7932
36660,Mikaela,Heustace,mheustaceqi@berkeley.edu,Human Resources Manager,5649,370,6019
36469,Josiah,Bertson,jbertsonqj@go.com,Tax Accountant,1608,1974,3582
36162,Jerrilyn,Gallehawk,jgallehawkqm@163.com,Account Coordinator,1757,1292,3049
36071,Ann,Thebeaud,athebeaudqn@comsenz.com,Sales Associate,4558,733,5291
36573,Zackariah,Bennit,zbennitqo@geocities.com,Internal Auditor,6372,1265,7637
36612,Kayla,Ozanne,kozanneqp@parallels.com,VP Sales,3143,1583,4726
36501,Jen,Burmingham,jburminghamqr@paginegialle.it,Chemical Engineer,7826,829,8655
36449,Sheila-kathryn,Pridden,spriddenqs@shop-pro.jp,Marketing Assistant,9670,271,9941
36843,Warden,Byrch,wbyrchqt@buzzfeed.com,Senior Editor,4637,341,4978
36922,Lowell,Lightowler,llightowlerqw@shutterfly.com,Safety Technician IV,7563,833,8396
36377,Karine,Hymus,khymusqx@163.com,Editor,5801,1274,7075
36093,Merry,Prott,mprottqy@oracle.com,Assistant Manager,2687,1384,4071
36048,Hermione,Wallhead,hwallheadr2@sourceforge.net,Health Coach IV,1375,869,2244
36949,Paule,Oneill,poneillr3@who.int,Director of Sales,8370,741,9111
36259,Malanie,Beadon,mbeadonr5@sbwire.com,Pharmacist,2882,1465,4347
36498,Ema,Streater,estreaterr9@moonfruit.com,Mechanical Systems Engineer,8836,315,9151
36593,Launce,Etteridge,letteridgerc@umich.edu,General Manager,8435,1488,9923
36505,Garrek,Sansun,gsansunre@hubpages.com,Structural Engineer,7142,1330,8472
36824,Morgen,Atheis,matheisrf@businessinsider.com,Senior Cost Accountant,3344,1883,5227
36435,Hunt,Dows,hdowsrh@wordpress.com,Product Engineer,8826,1768,10594
36577,Alanson,Shakspeare,ashakspearerl@nature.com,Chief Design Engineer,5325,1903,7228
36939,Ron,Brownrigg,rbrownriggrp@seesaa.net,Biostatistician IV,5646,1372,7018
36531,Tanner,d' Elboux,tdelbouxrr@sohu.com,Chief Design Engineer,8704,1745,10449
37899,Brnaby,Arthy,barthy0@earthlink.net,Engineer III,8956,869,9825
37254,Bevin,Rounds,brounds1@senate.gov,Structural Engineer,6453,1466,7919
37397,Sly,Washington,swashington2@shutterfly.com,Senior Editor,5346,244,5590
37947,Haleigh,Burghall,hburghall3@multiply.com,VP Product Management,3706,791,4497
37982,Gayla,Newey,gnewey4@cnbc.com,Administrative Officer,5880,1255,7135
37841,Elisabeth,Siaskowski,esiaskowski5@wiley.com,Clinical Specialist,4864,218,5082
37848,Vicky,Cicchetto,vcicchetto6@unesco.org,General Manager,9683,710,10393
37917,Enriqueta,Beechcraft,ebeechcraft7@samsung.com,Software Consultant,5616,1821,7437
37492,Fredric,Moscone,fmoscone8@livejournal.com,Structural Engineer,4095,1727,5822
37052,Sanson,Cominello,scominello9@instagram.com,Pharmacist,5266,1978,7244
37127,Berkie,Ruppert,brupperta@bbc.co.uk,Operator,5094,742,5836
37222,Kizzie,Ottee,kotteeb@vinaora.com,Software Consultant,4235,673,4908
37820,Yorgo,Linnit,ylinnitc@flickr.com,Assistant Media Planner,1464,1780,3244
37424,Padriac,Schneidau,pschneidaud@bloomberg.com,Marketing Assistant,5821,1472,7293
37200,Emmy,Ber,ebere@newyorker.com,Environmental Tech,6090,443,6533
37229,Micheline,Whiskerd,mwhiskerdf@tripod.com,Compensation Analyst,3308,1579,4887
37184,Cale,Wasielewski,cwasielewskig@google.co.jp,Graphic Designer,1467,1126,2593
37750,Adler,Pike,apikeh@dailymail.co.uk,Nurse Practicioner,5878,1757,7635
37490,Marissa,Hamon,mhamoni@amazon.co.uk,Web Developer III,3999,1022,5021
37400,Odelle,Shafe,oshafej@so-net.ne.jp,Programmer Analyst II,1999,1328,3327
37603,Keeley,Marriot,kmarriotk@army.mil,Executive Secretary,8435,1296,9731
37392,Genovera,Clemont,gclemontl@a8.net,Dental Hygienist,1418,230,1648
37246,Orsola,Gowrich,ogowrichm@bing.com,Information Systems Manager,8019,307,8326
37079,Cecilia,Scruby,cscrubyn@amazonaws.com,Physical Therapy Assistant,3555,1108,4663
37111,Licha,Olfert,lolferto@usda.gov,Recruiter,7363,1346,8709
37156,Montague,Trye,mtryep@wikipedia.org,Account Coordinator,2540,1223,3763
37789,Bartlet,Stelle,bstelleq@bbc.co.uk,Analog Circuit Design manager,2233,1892,4125
37232,Layla,Blowen,lblowenr@yelp.com,Sales Representative,5917,558,6475
37166,Guillema,Capron,gcaprons@zimbio.com,Software Test Engineer II,2702,315,3017
37458,Jemmy,Willowby,jwillowbyt@pinterest.com,VP Accounting,3902,633,4535
37083,Hiram,Sebrens,hsebrensu@cam.ac.uk,Occupational Therapist,1195,1267,2462
37261,Shela,Roscrigg,sroscriggv@loc.gov,GIS Technical Architect,9924,550,10474
37989,Alexandros,Scrowton,ascrowtonw@ftc.gov,Statistician IV,9721,1769,11490
37105,Tasia,Yerson,tyersonx@zdnet.com,Assistant Professor,4157,544,4701
37047,Jonell,Dobby,jdobbyz@china.com.cn,Geologist I,8857,793,9650
37555,Chelsae,Meysham,cmeysham10@moonfruit.com,Biostatistician III,1726,1934,3660
37443,Anthony,Fransman,afransman11@livejournal.com,Senior Quality Engineer,8311,260,8571
37929,Marillin,Robbe,mrobbe12@photobucket.com,Marketing Assistant,1641,471,2112
37253,Cathyleen,Sawfoot,csawfoot13@deliciousdays.com,Health Coach III,9997,770,10767
37324,Bo,MacDermid,bmacdermid14@state.tx.us,Tax Accountant,3206,1833,5039
37612,Patton,Scadden,pscadden15@flavors.me,Actuary,3455,483,3938
37946,Shandeigh,Stiff,sstiff16@google.pl,Geologist I,6093,340,6433
37717,Eleni,Mulrenan,emulrenan17@omniture.com,Environmental Specialist,4076,1102,5178
37225,Dianna,Marran,dmarran18@w3.org,Paralegal,2885,1777,4662
37152,Atlante,Crowcombe,acrowcombe19@answers.com,Help Desk Operator,9941,541,10482
37037,Ash,Paulisch,apaulisch1a@yale.edu,Environmental Tech,7337,610,7947
37738,Donia,McArdell,dmcardell1b@youku.com,Occupational Therapist,7617,617,8234
37878,Esra,Grumley,egrumley1c@cdc.gov,Electrical Engineer,5813,1951,7764
37732,Anatol,Hazlewood,ahazlewood1d@chronoengine.com,Software Engineer I,3418,1759,5177
37882,Giovanna,Housen,ghousen1e@fc2.com,Graphic Designer,7909,676,8585
37822,Norma,Purdy,npurdy1f@alibaba.com,Software Consultant,5760,1691,7451
37141,Henryetta,Simonini,hsimonini1g@imdb.com,Speech Pathologist,5891,1625,7516
37944,Nettle,Peskin,npeskin1i@issuu.com,Account Coordinator,5634,1912,7546
37461,Francisca,O'Crotty,focrotty1j@i2i.jp,Professor,2895,1490,4385
37173,Lynnett,Macieja,lmacieja1k@cnn.com,Junior Executive,1372,912,2284
37558,Brand,Layburn,blayburn1l@answers.com,Senior Quality Engineer,5222,928,6150
37168,Mathe,Meredyth,mmeredyth1m@sfgate.com,Systems Administrator II,9780,651,10431
37329,Analise,Squeers,asqueers1n@nba.com,Software Test Engineer I,4822,628,5450
37905,Persis,Calken,pcalken1o@tinypic.com,Associate Professor,5935,520,6455
37312,Elwood,Pottiphar,epottiphar1p@google.de,Senior Editor,9095,1491,10586
37115,Ignazio,Giovanitti,igiovanitti1r@webmd.com,Analyst Programmer,8434,233,8667
37136,Aili,Kenningham,akenningham1s@un.org,Food Chemist,3794,1676,5470
37807,Bria,Sparham,bsparham1t@mail.ru,Analog Circuit Design manager,5472,1785,7257
37916,Christine,Kubacki,ckubacki1u@cbc.ca,Financial Analyst,9915,858,10773
37513,Weidar,Fishlock,wfishlock1v@accuweather.com,Account Executive,8640,840,9480
37148,Maye,Braysher,mbraysher1w@phoca.cz,Graphic Designer,9626,1606,11232
37911,Nisse,Soall,nsoall1x@cbc.ca,VP Quality Control,7960,376,8336
37969,Delmore,Dumbrill,ddumbrill1z@hud.gov,Safety Technician IV,2698,1810,4508
37837,Tina,Gambrell,tgambrell20@bizjournals.com,Programmer Analyst III,7185,1749,8934
37747,Michaelina,Nolton,mnolton21@mashable.com,Internal Auditor,4831,1156,5987
37482,Rodolfo,Tyne,rtyne22@hhs.gov,Accountant II,7014,1929,8943
37469,Culley,McDuall,cmcduall23@yahoo.com,Project Manager,6408,845,7253
37719,Drucy,Heinl,dheinl24@narod.ru,Staff Accountant II,5325,1393,6718
37241,Cacilie,Beames,cbeames25@technorati.com,Database Administrator II,8749,606,9355
37693,Crichton,Suggate,csuggate28@artisteer.com,Senior Financial Analyst,7097,1897,8994
37630,Maudie,Blundon,mblundon29@dailymail.co.uk,Marketing Manager,2975,312,3287
37008,Derrik,Owers,dowers2a@addtoany.com,Nuclear Power Engineer,4339,1163,5502
37504,Misty,Cantera,mcantera2b@ifeng.com,Product Engineer,8217,885,9102
37348,Winn,McGrah,wmcgrah2c@phpbb.com,Help Desk Technician,3340,1603,4943
37486,Natka,Iggalden,niggalden2d@mashable.com,Help Desk Operator,7022,1647,8669
37668,Melessa,Blacksland,mblacksland2e@ox.ac.uk,Help Desk Technician,6332,284,6616
37828,Lisetta,Francom,lfrancom2f@bloomberg.com,Director of Sales,2162,1271,3433
37521,Rupert,Slocombe,rslocombe2g@abc.net.au,VP Product Management,1100,319,1419
37421,Cherise,Reddick,creddick2h@dailymotion.com,Electrical Engineer,5836,1182,7018
37592,Tyrone,Iddon,tiddon2i@alexa.com,Business Systems Development Analyst,9626,392,10018
37684,Dicky,Stavers,dstavers2j@e-recht24.de,Geological Engineer,7878,1779,9657
37419,Pearl,Adshead,padshead2k@fastcompany.com,Database Administrator III,6580,1249,7829
37847,Sabina,Marquese,smarquese2m@xinhuanet.com,Clinical Specialist,8641,881,9522
37595,Genni,Schnieder,gschnieder2o@canalblog.com,Administrative Assistant IV,7211,1810,9021
37423,Shay,Crecy,screcy2p@spiegel.de,Media Manager I,7622,1583,9205
37972,Melinda,Fittis,mfittis2q@google.de,Chemical Engineer,2785,1795,4580
37399,Dorian,Neville,dneville2r@arizona.edu,Budget/Accounting Analyst I,2695,1324,4019
37170,Jacob,Crandon,jcrandon2s@zdnet.com,Safety Technician II,4029,294,4323
37774,Wheeler,Doblin,wdoblin2t@behance.net,Web Developer I,8332,954,9286
37871,Tracie,Spare,tspare2u@imgur.com,Statistician III,7811,404,8215
37070,Almira,Bollon,abollon2v@lycos.com,Account Representative IV,2859,298,3157
37021,Donnie,Neising,dneising2w@unc.edu,Structural Engineer,9945,1623,11568
37436,Dane,Garmons,dgarmons2x@berkeley.edu,Actuary,8460,258,8718
37901,Currie,Newiss,cnewiss2y@comcast.net,Administrative Officer,1183,1512,2695
37804,Zaccaria,Grimstead,zgrimstead2z@bluehost.com,Assistant Professor,6009,1117,7126
37765,Hercules,Challes,hchalles30@vistaprint.com,Analog Circuit Design manager,9095,518,9613
37194,Desiri,Klus,dklus31@discuz.net,Payment Adjustment Coordinator,3170,506,3676
37498,Cahra,Deaves,cdeaves32@sakura.ne.jp,Financial Advisor,9944,1479,11423
37054,Freida,Bettleson,fbettleson33@xinhuanet.com,Cost Accountant,7089,674,7763
37167,Desmund,Clyburn,dclyburn34@intel.com,Environmental Tech,6845,435,7280
37559,Gary,Bazylets,gbazylets35@eventbrite.com,Computer Systems Analyst IV,1481,370,1851
37077,Odette,Upstell,oupstell36@yahoo.com,Media Manager III,2161,1925,4086
37065,Ward,Dursley,wdursley37@storify.com,Administrative Assistant IV,8506,651,9157
37697,Tudor,Antyshev,tantyshev38@cocolog-nifty.com,Graphic Designer,8765,1654,10419
37958,Zsa zsa,Buzine,zbuzine39@naver.com,Structural Engineer,8098,1719,9817
37043,Jerome,Filpo,jfilpo3a@printfriendly.com,Research Associate,1204,833,2037
37319,Anderea,Dommersen,adommersen3b@census.gov,Programmer Analyst I,5825,1647,7472
37519,Ronica,Kynson,rkynson3c@digg.com,Compensation Analyst,3531,1661,5192
37084,Bella,Shaves,bshaves3d@ezinearticles.com,Administrative Officer,6495,1742,8237
37212,Niki,Kitchingman,nkitchingman3e@youtube.com,Financial Advisor,7132,320,7452
37854,Jennilee,Hillum,jhillum3f@disqus.com,Budget/Accounting Analyst IV,9390,301,9691
37910,Russ,Braidford,rbraidford3g@cmu.edu,Software Consultant,7492,1808,9300
37827,Ella,Bewshire,ebewshire3h@time.com,Community Outreach Specialist,7716,1018,8734
37294,Chastity,Gillingwater,cgillingwater3i@virginia.edu,Environmental Specialist,5081,1333,6414
37287,Willamina,Elvy,welvy3j@surveymonkey.com,Cost Accountant,7712,1968,9680
37210,Collete,Sigmund,csigmund3k@fotki.com,Automation Specialist II,8606,1404,10010
37683,Aeriela,Fairhurst,afairhurst3l@tmall.com,Financial Analyst,6972,447,7419
37810,Hester,MacGrath,hmacgrath3m@altervista.org,Recruiting Manager,5656,1703,7359
37796,Romeo,Drieu,rdrieu3n@europa.eu,Nurse Practicioner,4039,766,4805
37064,Simonne,Fownes,sfownes3o@scribd.com,Office Assistant III,3657,1524,5181
37450,Christoffer,Shernock,cshernock3p@sfgate.com,Help Desk Operator,1728,1988,3716
37802,Dar,Barus,dbarus3q@dyndns.org,Financial Advisor,2526,1628,4154
37858,Meg,Samter,msamter3r@miibeian.gov.cn,Cost Accountant,8035,206,8241
37143,Ilka,Haisell,ihaisell3s@plala.or.jp,General Manager,8059,856,8915
37960,Janna,Matityahu,jmatityahu3t@storify.com,General Manager,7244,344,7588
37016,Eldin,Anthes,eanthes3u@nyu.edu,Web Developer III,9185,1648,10833
37393,Mirabel,Jeffress,mjeffress3v@istockphoto.com,Editor,9939,1731,11670
37439,Roshelle,Thornbarrow,rthornbarrow3w@harvard.edu,Internal Auditor,6433,1717,8150
37611,Constanta,Gyles,cgyles3x@comsenz.com,Web Developer III,3815,1319,5134
37071,Major,Ledward,mledward3y@blogspot.com,Product Engineer,5314,1815,7129
37700,Ivie,Zorn,izorn3z@archive.org,Human Resources Manager,1646,817,2463
37284,Hana,Heninghem,hheninghem40@google.ca,Environmental Tech,6520,466,6986
37879,Jillian,Flewin,jflewin41@mapy.cz,Quality Engineer,5229,1324,6553
37626,Adorne,Gauvain,agauvain42@alexa.com,Statistician II,8270,1390,9660
37285,Dorolice,Feighney,dfeighney43@trellian.com,Environmental Tech,4573,1486,6059
37009,Ettore,Dyball,edyball44@sphinn.com,Senior Editor,2014,1818,3832
37349,Nikolos,Pehrsson,npehrsson45@360.cn,Administrative Officer,2156,1532,3688
37462,Dick,Kay,dkay46@istockphoto.com,Pharmacist,5696,1164,6860
37297,Heinrik,McClelland,hmcclelland47@cam.ac.uk,Computer Systems Analyst II,2424,1376,3800
37545,Amby,Lomen,alomen49@istockphoto.com,Human Resources Manager,6240,1835,8075
37476,Lyman,Shadwick,lshadwick4a@usatoday.com,VP Sales,1029,1748,2777
37770,Joe,Lathan,jlathan4b@nymag.com,Biostatistician III,9326,1249,10575
37268,Haslett,Denman,hdenman4c@deliciousdays.com,Research Nurse,1184,1589,2773
37356,Tracy,Kulis,tkulis4e@feedburner.com,Health Coach II,3822,1051,4873
37269,Vanya,Pearle,vpearle4f@cmu.edu,Payment Adjustment Coordinator,6205,248,6453
37274,Sigismondo,Champken,schampken4g@imgur.com,Librarian,1552,586,2138
37069,Orsa,Critchley,ocritchley4h@dion.ne.jp,Food Chemist,1102,426,1528
37010,Howey,Augur,haugur4i@mlb.com,Analyst Programmer,9942,892,10834
37692,Benedetta,Spillett,bspillett4l@delicious.com,Account Executive,1017,1422,2439
37301,Dulcinea,Perceval,dperceval4m@ft.com,Registered Nurse,8986,1578,10564
37823,Herve,Alonso,halonso4n@ted.com,Account Representative IV,3917,763,4680
37063,Jennee,Fairley,jfairley4p@usatoday.com,Accountant IV,1946,1979,3925
37657,Silvain,Fetherstonhaugh,sfetherstonhaugh4q@blogger.com,Technical Writer,2021,1901,3922
37957,Hephzibah,Partlett,hpartlett4r@apache.org,Operator,5126,383,5509
37413,Julietta,Grosvenor,jgrosvenor4s@storify.com,Programmer I,1941,1085,3026
37330,Doy,Caile,dcaile4t@seesaa.net,Environmental Tech,8592,373,8965
37132,Jolee,Hincks,jhincks4u@altervista.org,Internal Auditor,3911,1378,5289
37259,Lesley,Fonzo,lfonzo4v@marketwatch.com,Junior Executive,8186,365,8551
37904,Tory,Milmith,tmilmith4w@tripadvisor.com,VP Marketing,5883,1886,7769
37662,Emmalyn,Truce,etruce4x@buzzfeed.com,Director of Sales,5946,835,6781
37331,Sheffie,Geistmann,sgeistmann4z@g.co,Geologist I,6111,1134,7245
37347,Tawnya,Woodrow,twoodrow50@si.edu,Social Worker,1252,774,2026
37714,Sarena,Perigoe,sperigoe51@epa.gov,Database Administrator I,1597,310,1907
37728,Horacio,Allin,hallin52@trellian.com,Associate Professor,1685,1542,3227
37497,Cathie,Codlin,ccodlin53@cyberchimps.com,Product Engineer,6826,1097,7923
37339,Zola,Gritsaev,zgritsaev54@yandex.ru,Senior Financial Analyst,9316,1627,10943
37583,Tiena,Waters,twaters55@skype.com,Electrical Engineer,2382,593,2975
37099,Liesa,McIlory,lmcilory56@unblog.fr,Payment Adjustment Coordinator,9500,883,10383
37501,Katy,Easterbrook,keasterbrook58@cnet.com,Mechanical Systems Engineer,3729,1902,5631
37703,Waverley,Vaggers,wvaggers59@cargocollective.com,Automation Specialist II,5456,1933,7389
37276,Cherianne,Fountian,cfountian5a@yale.edu,Associate Professor,2822,491,3313
37883,Benson,Drayton,bdrayton5b@answers.com,Civil Engineer,2231,883,3114
37979,Mendy,Lax,mlax5c@tuttocitta.it,Help Desk Technician,1018,763,1781
37140,Lynn,Hastie,lhastie5d@google.com.br,VP Product Management,8962,502,9464
37986,Sherlocke,Sibylla,ssibylla5e@boston.com,Computer Systems Analyst IV,2603,863,3466
37987,Blaine,Morrallee,bmorrallee5i@hud.gov,Nuclear Power Engineer,5581,859,6440
37783,Carlota,Yarr,cyarr5j@usgs.gov,Administrative Assistant IV,8919,341,9260
37639,Shina,Mowlam,smowlam5k@timesonline.co.uk,Accounting Assistant II,5652,924,6576
37500,Phillipp,Kobes,pkobes5l@taobao.com,VP Quality Control,9327,1500,10827
37963,Shirleen,Tice,stice5m@t.co,Clinical Specialist,3088,368,3456
37672,Wallace,Lackie,wlackie5n@ucoz.com,Senior Editor,5155,1659,6814
37160,Joshia,Currom,jcurrom5o@themeforest.net,Quality Engineer,6779,1742,8521
37652,Skell,Sneezem,ssneezem5p@histats.com,Assistant Manager,9620,1886,11506
37778,Isa,Bewshea,ibewshea5q@ucsd.edu,VP Product Management,1143,1948,3091
37839,Claus,Roantree,croantree5s@opera.com,Speech Pathologist,2356,1008,3364
37593,Agace,Doe,adoe5u@mozilla.org,GIS Technical Architect,9618,1030,10648
37480,Otes,Minchinton,ominchinton5v@npr.org,Financial Advisor,5689,242,5931
37634,Cecilius,O'Fogarty,cofogarty5w@uol.com.br,Information Systems Manager,6648,1227,7875
37927,Zared,Tassell,ztassell5x@tiny.cc,Tax Accountant,8905,1129,10034
37258,Kessia,Philpots,kphilpots60@nifty.com,Environmental Specialist,2669,629,3298
37894,Jesselyn,Hassard,jhassard62@mysql.com,Nurse Practicioner,6553,791,7344
37226,Jany,O'Callaghan,jocallaghan63@addtoany.com,Operator,6599,1171,7770
37677,Dalenna,Rumbold,drumbold64@indiatimes.com,Nuclear Power Engineer,7747,1633,9380
37264,Cobbie,Gianninotti,cgianninotti65@techcrunch.com,Recruiting Manager,1726,732,2458
37949,Erroll,Glassard,eglassard67@hibu.com,Structural Analysis Engineer,4922,1629,6551
37872,Jerrold,Christoffels,jchristoffels68@sfgate.com,Biostatistician I,3162,629,3791
37328,Ellene,Hamlen,ehamlen69@whitehouse.gov,Systems Administrator III,5559,789,6348
37370,Yoshi,Ghilks,yghilks6a@google.ca,Quality Control Specialist,3139,490,3629
37695,Sigfrid,Perrins,sperrins6b@1und1.de,Paralegal,8446,1601,10047
37433,Alysia,Joincey,ajoincey6c@google.com.br,Food Chemist,9305,1024,10329
37777,Sheeree,Ryan,sryan6d@theatlantic.com,Developer IV,9800,413,10213
37571,Agnesse,Hagston,ahagston6f@people.com.cn,Nurse Practicioner,2033,884,2917
37580,Layton,Oakenfield,loakenfield6g@sun.com,Assistant Professor,6211,877,7088
37296,Harri,Bellini,hbellini6h@imageshack.us,Chemical Engineer,6389,340,6729
37406,Aldous,Slogrove,aslogrove6i@addtoany.com,Safety Technician II,2902,1800,4702
37061,Allie,Haggish,ahaggish6j@cpanel.net,Registered Nurse,8000,208,8208
37852,Yance,Phuprate,yphuprate6l@yellowbook.com,Senior Sales Associate,9394,344,9738
37459,Caroline,Lum,clum6m@csmonitor.com,Geologist III,5245,2000,7245
37028,Sofie,Shillam,sshillam6o@quantcast.com,Pharmacist,2388,224,2612
37936,Brenna,Chiswell,bchiswell6p@360.cn,Information Systems Manager,5184,594,5778
37178,Winna,Greenig,wgreenig6q@fotki.com,Administrative Officer,1519,1210,2729
37722,Dyna,Luther,dluther6r@nydailynews.com,Staff Scientist,5222,978,6200
37868,Ambrosio,Gettone,agettone6t@nifty.com,Database Administrator IV,4862,519,5381
37487,Jarred,Frampton,jframpton6v@hhs.gov,Systems Administrator IV,2318,1873,4191
37018,Naomi,Messingham,nmessingham6w@naver.com,Design Engineer,6076,727,6803
37372,Byrann,Kornyshev,bkornyshev6x@wsj.com,Design Engineer,6756,1530,8286
37032,Juanita,Worvell,jworvell6y@mit.edu,Engineer I,3938,599,4537
37216,Marcos,Sanson,msanson6z@ihg.com,Nurse,7933,1935,9868
37202,Dreddy,Lorentzen,dlorentzen71@sciencedirect.com,Product Engineer,5780,1294,7074
37078,Chicky,Luchetti,cluchetti73@creativecommons.org,Electrical Engineer,8754,1711,10465
37031,Pauly,Airy,pairy74@oracle.com,Statistician III,1286,1114,2400
37670,Dyanna,O'Dunneen,dodunneen76@dmoz.org,Graphic Designer,2238,399,2637
37230,Abbie,Thaim,athaim77@cmu.edu,Staff Accountant IV,3138,1686,4824
37223,Kimble,Paulus,kpaulus78@chronoengine.com,Desktop Support Technician,6600,733,7333
37075,Franny,Luggar,fluggar79@flavors.me,Administrative Officer,9523,619,10142
37980,Debi,Gudd,dgudd7a@google.es,VP Marketing,7743,1969,9712
37711,Eleen,Derisly,ederisly7c@cloudflare.com,Media Manager IV,1600,1038,2638
37454,Janet,Wardlow,jwardlow7d@wsj.com,Environmental Specialist,1242,923,2165
37824,Freeman,Di Angelo,fdiangelo7e@google.com.br,Account Coordinator,2820,1906,4726
37517,Spence,People,speople7g@jimdo.com,Systems Administrator II,3762,1034,4796
37033,Ilise,Giorgioni,igiorgioni7h@prlog.org,Financial Advisor,7412,724,8136
37291,Jessica,Housego,jhousego7j@yolasite.com,Civil Engineer,8843,398,9241
37432,Dana,Naulls,dnaulls7k@flickr.com,Librarian,9854,859,10713
37390,Marlyn,Yegorev,myegorev7l@fc2.com,Registered Nurse,4719,1231,5950
37869,Darn,Chellingworth,dchellingworth7m@tumblr.com,Project Manager,2613,1741,4354
37579,Venus,Whartonby,vwhartonby7n@aol.com,Account Executive,6568,1210,7778
37239,Anetta,McKinie,amckinie7p@surveymonkey.com,VP Product Management,4693,984,5677
37249,Wilfrid,Vasey,wvasey7r@sina.com.cn,Software Consultant,6462,619,7081
37997,Everard,Gatherell,egatherell7s@ning.com,Tax Accountant,6293,945,7238
37931,Thia,Anger,tanger7t@google.de,Dental Hygienist,7225,400,7625
37726,Tammara,Brodhead,tbrodhead7u@baidu.com,Mechanical Systems Engineer,4678,408,5086
37830,Gipsy,McMichell,gmcmichell7w@furl.net,Budget/Accounting Analyst I,9647,416,10063
37260,Auberon,Cripin,acripin7x@jugem.jp,Associate Professor,7192,1708,8900
37380,Abby,Shoemark,ashoemark7y@mayoclinic.com,VP Marketing,5443,470,5913
37015,Avrit,Fletcher,afletcher7z@ftc.gov,Financial Analyst,1851,452,2303
37815,Alanna,Meriton,ameriton81@mashable.com,Speech Pathologist,7786,265,8051
37320,Constancia,Weond,cweond82@prlog.org,Junior Executive,5619,642,6261
37247,Francois,Lacroux,flacroux85@meetup.com,Marketing Assistant,3662,1327,4989
37850,Liesa,MacInnes,lmacinnes86@mysql.com,Senior Developer,7856,1039,8895
37095,Aila,McManus,amcmanus87@xing.com,Assistant Professor,3521,1098,4619
37608,Dotti,Killen,dkillen88@yelp.com,Project Manager,6822,218,7040
37564,Arnold,Hrycek,ahrycek89@java.com,Budget/Accounting Analyst I,6847,981,7828
37151,Edee,McHenry,emchenry8b@fastcompany.com,Systems Administrator IV,1886,727,2613
37267,Elisha,Giacobilio,egiacobilio8c@unesco.org,Civil Engineer,4471,1885,6356
37457,Linnie,Sabban,lsabban8d@ehow.com,Office Assistant III,5595,1184,6779
37798,Cristina,Barwick,cbarwick8e@naver.com,Staff Scientist,8940,496,9436
37479,Hilda,Jenne,hjenne8f@dailymotion.com,Executive Secretary,5754,973,6727
37924,Rudiger,Foyston,rfoyston8g@nps.gov,Human Resources Manager,5625,1928,7553
37921,Paulie,Peery,ppeery8h@chicagotribune.com,Physical Therapy Assistant,9896,1931,11827
37147,Portie,Coon,pcoon8i@163.com,Editor,4184,1281,5465
37906,Nicky,Thoms,nthoms8k@tamu.edu,Recruiting Manager,4272,1076,5348
37150,Kelci,Cusworth,kcusworth8n@amazon.de,Senior Quality Engineer,8288,1658,9946
37840,Gaven,Fairfull,gfairfull8o@behance.net,Programmer Analyst IV,8031,708,8739
37496,Karney,Stollenbeck,kstollenbeck8p@unicef.org,Software Engineer I,8078,1002,9080
37909,Ronalda,Cribbin,rcribbin8q@netvibes.com,Desktop Support Technician,6755,1467,8222
37255,Rhianna,Burghill,rburghill8r@jugem.jp,Cost Accountant,1604,1501,3105
37930,Page,Como,pcomo8s@businessinsider.com,Compensation Analyst,7263,527,7790
37440,Merwyn,Stileman,mstileman8v@discovery.com,Graphic Designer,5884,1173,7057
37209,Brade,Fairhead,bfairhead8w@canalblog.com,Research Associate,9203,1066,10269
37183,Arnuad,Dundredge,adundredge8y@gizmodo.com,Operator,2609,500,3109
37369,Emilio,Milmo,emilmo8z@google.fr,Software Test Engineer III,6054,1185,7239
37368,Colby,Early,cearly94@php.net,General Manager,2456,1254,3710
37518,Shelagh,Sollas,ssollas95@google.com.au,Administrative Officer,9027,1156,10183
37333,Genna,Ramshaw,gramshaw96@joomla.org,Sales Representative,6171,594,6765
37121,Ashlie,Knowlman,aknowlman98@archive.org,Nuclear Power Engineer,5444,1746,7190
37975,Alasteir,Feighry,afeighry99@microsoft.com,Business Systems Development Analyst,4217,515,4732
37772,Ottilie,Yve,oyve9b@yellowpages.com,VP Product Management,4777,1668,6445
37327,Evvie,Durbyn,edurbyn9c@livejournal.com,Data Coordiator,2713,1612,4325
37243,Elston,McCaskell,emccaskell9d@latimes.com,Senior Quality Engineer,3026,541,3567
37744,Waylan,Lenormand,wlenormand9e@unesco.org,Senior Financial Analyst,7451,583,8034
37584,Herold,Bolgar,hbolgar9g@gmpg.org,Executive Secretary,2068,1600,3668
37377,Saraann,Kilner,skilner9h@va.gov,Budget/Accounting Analyst IV,8127,1164,9291
37130,Goran,Smerdon,gsmerdon9i@wix.com,Administrative Officer,1310,1848,3158
37195,Idette,Cicullo,icicullo9k@gov.uk,Research Nurse,8494,958,9452
37779,Jeffrey,Beatty,jbeatty9l@dropbox.com,Nuclear Power Engineer,6043,1282,7325
37122,Halie,Matzaitis,hmatzaitis9n@cocolog-nifty.com,Nurse Practicioner,4629,509,5138
37549,Retha,Landre,rlandre9s@wufoo.com,Senior Sales Associate,6141,1310,7451
37286,Meredith,Robinette,mrobinette9t@prnewswire.com,Research Associate,3366,1727,5093
37785,West,Sanford,wsanford9v@cpanel.net,VP Marketing,1134,644,1778
37803,Lilllie,Lawie,llawie9w@gizmodo.com,Research Nurse,7448,1162,8610
37516,Laureen,Langdridge,llangdridge9y@i2i.jp,Accounting Assistant IV,2012,1805,3817
37928,Jerad,Tanguy,jtanguy9z@sciencedaily.com,Senior Cost Accountant,5326,1588,6914
37508,Neysa,Batrick,nbatricka1@disqus.com,General Manager,4005,1251,5256
37570,Benn,Toma,btomaa3@github.io,Research Associate,5184,433,5617
37427,Betti,Carley,bcarleya4@scientificamerican.com,Director of Sales,6740,1010,7750
37481,James,Wagstaffe,jwagstaffea7@google.com,Administrative Officer,2632,308,2940
37353,Charissa,Brickdale,cbrickdalea9@pagesperso-orange.fr,Human Resources Manager,7628,1058,8686
37566,Jacintha,Ellyatt,jellyattaa@so-net.ne.jp,Electrical Engineer,3632,1843,5475
37707,Salvador,Jaspar,sjasparac@tripadvisor.com,Physical Therapy Assistant,5288,1146,6434
37581,Legra,Drewitt,ldrewittad@theglobeandmail.com,Information Systems Manager,9463,1592,11055
37012,Beverie,Cockitt,bcockittae@biglobe.ne.jp,Associate Professor,2352,319,2671
37998,Jeana,Dreini,jdreiniaf@intel.com,Research Assistant II,4654,1456,6110
37650,Brenn,Doumenc,bdoumencah@a8.net,Director of Sales,5692,558,6250
37191,Lacy,Becaris,lbecarisai@dell.com,Environmental Tech,8350,361,8711
37948,Corty,Miller,cmilleral@jimdo.com,Research Nurse,7358,369,7727
37081,Jeddy,Harcus,jharcusan@reverbnation.com,Sales Associate,3826,297,4123
37984,Martynne,Parlott,mparlottao@chronoengine.com,Chemical Engineer,2110,673,2783
37034,Kelley,MacCombe,kmaccombeaq@seesaa.net,Administrative Officer,4481,965,5446
37741,Corbett,Reavey,creaveyar@aol.com,Paralegal,5227,271,5498
37133,Lauren,Sturch,lsturchas@stanford.edu,Nurse,2023,454,2477
37745,Hube,Corgenvin,hcorgenvinat@seattletimes.com,Professor,8521,993,9514
37058,Ettore,McKenna,emckennaaw@hatena.ne.jp,Internal Auditor,8304,1381,9685
37748,Ajay,Garbutt,agarbuttax@reuters.com,Operator,9308,758,10066
37620,Roseline,Pledger,rpledgeray@macromedia.com,Environmental Tech,9584,703,10287
37861,Verla,Greetland,vgreetlandaz@mashable.com,Community Outreach Specialist,1916,1994,3910
37300,Chandra,Purton,cpurtonb0@ucoz.com,Administrative Officer,4307,676,4983
37755,Ailey,Insoll,ainsollb1@pcworld.com,Operator,4797,926,5723
37708,Iorgos,Radley,iradleyb2@google.de,Administrative Officer,3203,957,4160
37546,Elna,Cullotey,eculloteyb3@weibo.com,Chief Design Engineer,7331,512,7843
37080,Hubert,Magnay,hmagnayb4@go.com,Statistician III,9419,530,9949
37007,Deonne,Armin,darminb5@livejournal.com,Research Associate,2412,666,3078
37664,Silvanus,Gawler,sgawlerb8@businesswire.com,Developer IV,8177,344,8521
37169,Thom,Graine,tgraineb9@photobucket.com,Human Resources Manager,8813,1384,10197
37953,Earvin,Apthorpe,eapthorpeba@netlog.com,Clinical Specialist,3880,923,4803
37507,Martguerita,Beadham,mbeadhambb@mediafire.com,Web Developer I,2341,1685,4026
37361,Darb,Billington,dbillingtonbc@free.fr,Quality Control Specialist,3596,852,4448
37764,Biddie,Williment,bwillimentbe@cnet.com,Actuary,2334,1248,3582
37060,Sidoney,Kivell,skivellbf@salon.com,Senior Financial Analyst,8288,294,8582
37441,Phillipe,MacGiany,pmacgianybi@myspace.com,Internal Auditor,5218,1409,6627
37272,Abigail,Haversum,ahaversumbj@bloomberg.com,Junior Executive,9520,1927,11447
37865,Cale,Richemond,crichemondbl@newyorker.com,Environmental Tech,3586,697,4283
37042,Branden,Keavy,bkeavybn@earthlink.net,Software Test Engineer IV,3374,695,4069
37816,Venita,Cavie,vcaviebp@myspace.com,Tax Accountant,5006,939,5945
37288,Tamqrah,Cearley,tcearleybr@joomla.org,Human Resources Manager,3301,822,4123
37013,Stafani,Plumm,splummbs@example.com,Environmental Tech,9638,626,10264
37659,Torrey,Lampbrecht,tlampbrechtbt@cnet.com,Accountant I,4398,1024,5422
37388,Datha,Raisher,draisherbu@domainmarket.com,Help Desk Operator,3358,1919,5277
37653,Stewart,Lamas,slamasbv@nhs.uk,Research Assistant IV,1340,298,1638
37553,Milo,Toffler,mtofflerbx@360.cn,Nurse Practicioner,2157,1450,3607
37088,Lorilee,Neles,lnelesby@myspace.com,Geological Engineer,2948,497,3445
37915,Ariadne,Cordoba,acordobac1@gmpg.org,Food Chemist,7464,886,8350
37667,Emlyn,Southard,esouthardc2@g.co,Media Manager III,9341,1934,11275
37411,Analise,Boundey,aboundeyc4@epa.gov,Occupational Therapist,4884,910,5794
37091,Ame,Danilyak,adanilyakc5@dropbox.com,Paralegal,2107,757,2864
37819,Rolph,Szapiro,rszapiroc6@earthlink.net,Clinical Specialist,7931,1268,9199
37999,Isabelle,Mocher,imocherc7@ebay.com,Paralegal,6474,596,7070
37616,Nerte,Luisetti,nluisettic9@spotify.com,Marketing Assistant,3419,1298,4717
37219,Tiler,Winks,twinkscb@shinystat.com,Nurse Practicioner,5736,357,6093
37056,Nikki,Asprey,naspreyce@paypal.com,Legal Assistant,6915,1504,8419
37886,Leif,Durnford,ldurnfordcf@java.com,Sales Representative,3916,1143,5059
37187,Jules,Battyll,jbattyllcg@pagesperso-orange.fr,Electrical Engineer,7981,1842,9823
37396,Derrek,Stratiff,dstratiffci@weibo.com,Environmental Specialist,4347,1897,6244
37117,Clarke,Couch,ccouchck@storify.com,Office Assistant IV,7605,1060,8665
37217,Roseann,Petersen,rpetersencn@dyndns.org,VP Sales,2871,1994,4865
37410,Angelique,Ragge,araggecq@squarespace.com,Tax Accountant,4074,1416,5490
37171,Gabie,Klemke,gklemkecr@cnbc.com,VP Sales,9079,1366,10445
37932,Francesca,Robertsson,frobertssoncs@netscape.com,Design Engineer,1591,1038,2629
37207,Helaine,Matus,hmatusct@nifty.com,Help Desk Operator,3234,955,4189
37625,Gallagher,Gennings,ggenningscu@wix.com,Desktop Support Technician,5846,372,6218
37050,Jehu,Corryer,jcorryercv@taobao.com,VP Accounting,6716,763,7479
37629,Hyacinthe,Carpmile,hcarpmilecw@typepad.com,Account Executive,4798,1959,6757
37988,Flint,McKall,fmckallcx@bing.com,Accounting Assistant II,1018,1234,2252
37242,Cecilius,Vreede,cvreedecy@lycos.com,Assistant Professor,3559,606,4165
37426,Livvy,Titcomb,ltitcombcz@java.com,Food Chemist,2430,1193,3623
37359,Myer,Murden,mmurdend1@goo.gl,Nurse Practicioner,5133,392,5525
37221,Frans,Glassman,fglassmand3@netlog.com,Information Systems Manager,6057,1351,7408
37325,Beverley,Maruszewski,bmaruszewskid4@weebly.com,Web Developer IV,8600,1375,9975
37203,Verge,Jiroudek,vjiroudekd6@blogtalkradio.com,Junior Executive,4508,884,5392
37955,Skell,Brewitt,sbrewittd7@tripod.com,Actuary,9644,1482,11126
37890,Mirabella,Musico,mmusicod8@constantcontact.com,Teacher,5539,1194,6733
37177,Jena,Mandell,jmandelld9@icq.com,Computer Systems Analyst II,4123,1933,6056
37233,Huntley,McGuigan,hmcguigandb@desdev.cn,Senior Financial Analyst,7156,779,7935
37066,Crosby,Giff,cgiffdc@nationalgeographic.com,Nuclear Power Engineer,2164,1728,3892
37937,Ailee,Farebrother,afarebrotherdd@usda.gov,Operator,6272,1945,8217
37780,Queenie,Ivashchenko,qivashchenkodf@goo.gl,Sales Representative,9137,981,10118
37731,Westbrook,Howsin,whowsindh@homestead.com,Marketing Manager,7853,653,8506
37283,Gabriello,Kinmond,gkinmonddj@psu.edu,Recruiting Manager,8441,1508,9949
37265,Giles,Bowller,gbowllerdl@furl.net,Analog Circuit Design manager,1342,1044,2386
37198,Corney,Meriet,cmerietdn@alibaba.com,Physical Therapy Assistant,1731,1157,2888
37638,Lanae,Scalia,lscaliado@1und1.de,Quality Control Specialist,7720,944,8664
37784,Whitaker,Sheldon,wsheldondr@prnewswire.com,Administrative Officer,5502,1786,7288
37155,Kiley,Yitshak,kyitshakdt@webmd.com,Geological Engineer,3586,614,4200
37510,Lane,Angeau,langeaudu@fotki.com,Social Worker,1732,1190,2922
37522,Gae,Caldayrou,gcaldayroudx@surveymonkey.com,Account Representative I,7552,473,8025
37245,Wash,Tinston,wtinstondy@163.com,Programmer III,3080,1479,4559
37163,Aidan,Guyer,aguyerdz@nbcnews.com,Junior Executive,8511,1190,9701
37302,Blancha,Watts,bwattse0@narod.ru,Web Designer I,3155,332,3487
37108,Wendel,Hayer,whayere2@mail.ru,Media Manager I,2341,999,3340
37845,Marsiella,Cheng,mchenge3@wp.com,Information Systems Manager,4252,672,4924
37387,Lukas,Burchard,lburcharde4@marketwatch.com,Business Systems Development Analyst,3311,892,4203
37384,Emerson,Beeswing,ebeeswinge5@tumblr.com,Structural Analysis Engineer,2921,676,3597
37897,Barton,Lovering,bloveringe6@berkeley.edu,Human Resources Manager,2323,1268,3591
37035,Diana,Severy,dseverye7@fc2.com,Financial Advisor,2197,1905,4102
37073,Annmaria,Craigmyle,acraigmylee8@trellian.com,Assistant Professor,8364,541,8905
37125,Carmelle,Gemmell,cgemmelle9@mlb.com,Software Test Engineer I,8089,649,8738
37227,Homerus,Lazarus,hlazarusec@ow.ly,Operator,3374,1423,4797
37146,Elden,Stiles,estilesee@skyrock.com,Marketing Assistant,7486,1988,9474
37375,Cherilyn,Mathwin,cmathwinef@storify.com,Nurse Practicioner,2493,1954,4447
37768,Tuckie,Younie,tyounieeg@sohu.com,Environmental Tech,9088,567,9655
37357,Jacquenette,Briddock,jbriddockeh@thetimes.co.uk,Marketing Assistant,2534,1274,3808
37445,Averyl,Celloni,acelloniei@wufoo.com,Account Executive,8063,481,8544
37366,Roseann,Buttwell,rbuttwellej@tuttocitta.it,Registered Nurse,5379,287,5666
37278,Gretal,Lewzey,glewzeyek@opera.com,Director of Sales,3643,1226,4869
37382,Dennison,Porkiss,dporkissel@pbs.org,Administrative Officer,1417,1066,2483
37712,Dario,Pellamont,dpellamontem@dropbox.com,Marketing Assistant,3135,1232,4367
37527,Babs,Trevillion,btrevillionen@gnu.org,General Manager,9810,1511,11321
37981,Lind,Semken,lsemkeneq@altervista.org,Marketing Manager,4790,344,5134
37374,Layne,Ziems,lziemses@1688.com,Developer IV,8265,671,8936
37829,Fayre,Antuk,fantuket@scientificamerican.com,Payment Adjustment Coordinator,9958,718,10676
37172,Jimmie,Riddock,jriddockev@fastcompany.com,Civil Engineer,5907,1377,7284
37455,Drake,Clissell,dclissellez@eepurl.com,Sales Associate,4144,639,4783
37903,Lilias,Scupham,lscuphamf2@apple.com,Civil Engineer,1814,1249,3063
37055,Rozina,Pippin,rpippinf4@php.net,Chemical Engineer,5455,1863,7318
37471,Bernita,Greenig,bgreenigf5@apple.com,Senior Editor,6246,696,6942
37235,Gwenni,Sorrell,gsorrellf6@clickbank.net,Business Systems Development Analyst,5068,1384,6452
37511,Tamar,Ianinotti,tianinottif7@ocn.ne.jp,Computer Systems Analyst III,3128,1028,4156
37967,Falito,Kibbey,fkibbeyf8@multiply.com,Chemical Engineer,3041,1491,4532
37159,Brigitte,Ayto,baytofe@biblegateway.com,Social Worker,2413,1382,3795
37452,Burnaby,Flewan,bflewanff@state.tx.us,Account Representative II,1255,1828,3083
37310,Halli,Skelcher,hskelcherfh@fastcompany.com,Systems Administrator III,3085,1257,4342
37373,Jelene,Dragge,jdraggefj@biblegateway.com,Technical Writer,1032,539,1571
37599,Xymenes,Smithyman,xsmithymanfl@fastcompany.com,Occupational Therapist,4059,416,4475
37746,Chick,Ferraro,cferrarofq@a8.net,Automation Specialist IV,5180,863,6043
37623,Cody,Bonfield,cbonfieldft@vkontakte.ru,Food Chemist,3967,1442,5409
37528,Sam,Upham,suphamg1@marketwatch.com,Librarian,8578,1228,9806
37224,Willi,Barthrop,wbarthropg2@e-recht24.de,Financial Analyst,1865,375,2240
37754,Gregory,Saundercock,gsaundercockg3@apple.com,Cost Accountant,2269,1958,4227
37618,Shandeigh,Crumley,scrumleyg5@nydailynews.com,Analog Circuit Design manager,1627,1445,3072
37483,Jolyn,Graddell,jgraddellg6@examiner.com,Financial Analyst,8552,1307,9859
37800,Marsiella,Alvarado,malvaradoga@cam.ac.uk,Staff Scientist,4259,622,4881
37654,Michel,Jolin,mjolingc@angelfire.com,Financial Advisor,8199,262,8461
37853,Huntley,O'Neill,honeillge@com.com,Assistant Media Planner,2949,1312,4261
37636,Janifer,Robiou,jrobiougf@marketwatch.com,Electrical Engineer,8750,512,9262
37723,Ofilia,Swadlen,oswadlengh@trellian.com,Web Designer II,9843,1401,11244
37068,Shandeigh,McKeighen,smckeighengj@desdev.cn,Senior Financial Analyst,9479,444,9923
37090,Chalmers,Sumption,csumptiongk@webs.com,Financial Advisor,1337,224,1561
37005,Jozef,Filkin,jfilkingn@comcast.net,Teacher,1605,335,1940
37326,Pierrette,Dowzell,pdowzellgq@ow.ly,Help Desk Technician,1390,1542,2932
37591,Prudi,Laird-Craig,plairdcraiggs@ed.gov,Structural Engineer,2610,1899,4509
37044,Kelsi,Dorricott,kdorricottgt@dot.gov,Programmer Analyst IV,4808,292,5100
37535,Ianthe,Meneghi,imeneghigu@howstuffworks.com,Environmental Specialist,7729,695,8424
37756,Brendis,Spriggin,bspriggingv@fc2.com,Technical Writer,8613,964,9577
37685,Guss,Skirvane,gskirvanegx@histats.com,Analyst Programmer,1839,1950,3789
37925,Minerva,Rief,mriefh2@lulu.com,Editor,4663,1471,6134
37775,Norbert,Parr,nparrh5@rediff.com,Internal Auditor,5047,353,5400
37001,Rozalin,Di Domenico,rdidomenicoh8@woothemes.com,Graphic Designer,9565,1424,10989
37231,Alice,Stoney,astoneyha@state.gov,Structural Analysis Engineer,4170,592,4762
37833,Carleton,Kinge,ckingehc@tuttocitta.it,Accountant IV,3108,944,4052
37120,Godfry,Mathan,gmathanhe@aol.com,Structural Engineer,4710,712,5422
37463,Raimund,Riggey,rriggeyhf@imdb.com,Teacher,9766,615,10381
37464,Annamaria,Bickley,abickleyhm@oakley.com,Quality Control Specialist,8389,757,9146
37307,Gerrie,Dyte,gdytehn@constantcontact.com,Compensation Analyst,4922,1216,6138
37057,Pierette,Lightbourne,plightbournehp@yelp.com,Assistant Professor,5509,811,6320
37144,Jo ann,Nerheny,jnerhenyhs@washingtonpost.com,Budget/Accounting Analyst II,9204,215,9419
37586,Corbin,Smogur,csmogurhu@webnode.com,Librarian,9678,339,10017
37598,Kaylee,Lambourn,klambournhw@symantec.com,Staff Accountant III,3356,1471,4827
37407,Had,Pointing,hpointinghx@diigo.com,Marketing Manager,5682,963,6645
37154,Purcell,Flux,pfluxhz@salon.com,Junior Executive,6648,631,7279
37855,Nolana,Arrell,narrelli3@issuu.com,Nurse Practicioner,7580,889,8469
37873,Abbi,Sidebottom,asidebottomi5@irs.gov,Software Consultant,2977,820,3797
37447,Phillipp,Larwood,plarwoodi6@flickr.com,VP Quality Control,4395,340,4735
37530,Heinrik,Bassingden,hbassingdeni7@prnewswire.com,Community Outreach Specialist,8596,1291,9887
37027,Clayton,Longfellow,clongfellowi8@hibu.com,Civil Engineer,2111,339,2450
37289,Allene,MacGillivray,amacgillivrayi9@deliciousdays.com,Developer II,4408,1547,5955
37205,Melisa,Jewkes,mjewkesia@boston.com,Software Engineer III,2514,1067,3581
37355,Annabel,Olivera,aoliveraib@hao123.com,Operator,7794,1098,8892
37145,Sheff,Draisey,sdraiseyie@smh.com.au,Geologist IV,1499,1849,3348
37792,Emmi,Appleford,eapplefordig@newyorker.com,Developer I,5641,446,6087
37381,Byran,Allicock,ballicockii@tuttocitta.it,Structural Engineer,6862,644,7506
37713,Natalina,Ordemann,nordemannij@shop-pro.jp,Cost Accountant,2364,210,2574
37781,Harp,Thomesson,hthomessonil@hud.gov,Engineer I,8755,1409,10164
37208,Alexa,Polin,apolinin@ehow.com,Statistician I,7883,1694,9577
37934,Rosella,Yorath,ryorathip@alibaba.com,Human Resources Assistant II,2590,334,2924
37945,Sheilakathryn,Billyard,sbillyardiq@qq.com,Technical Writer,5839,1747,7586
37832,Lisabeth,Abel,labelir@discovery.com,Software Test Engineer I,1110,1470,2580
37340,Dre,De Goey,ddegoeyis@pinterest.com,Help Desk Operator,3623,1536,5159
37046,Barbaraanne,Bogges,bboggesiv@tripadvisor.com,Administrative Officer,7062,651,7713
37762,Mady,Meere,mmeerej0@amazon.co.jp,Quality Control Specialist,8913,1776,10689
37505,Austin,Shillam,ashillamj2@apple.com,Web Designer III,6416,560,6976
37985,Roarke,Loache,rloachej6@ucoz.com,Community Outreach Specialist,2896,847,3743
37395,Ella,Lincey,elinceyja@google.de,Associate Professor,6428,910,7338
37418,Fernandina,Farguhar,ffarguharjb@geocities.jp,Developer II,2873,574,3447
37543,Robert,Ballinger,rballingerje@un.org,Geological Engineer,4593,291,4884
37104,Cammy,Carlisi,ccarlisijf@abc.net.au,Nurse Practicioner,2815,1196,4011
37472,Wat,Taffrey,wtaffreyjg@boston.com,Computer Systems Analyst I,5342,485,5827
37600,Clementius,Arrowsmith,carrowsmithji@rambler.ru,Nurse Practicioner,2226,879,3105
37687,Ernaline,Killigrew,ekilligrewjk@baidu.com,Dental Hygienist,9228,656,9884
37176,Arney,O' Connell,aoconnelljl@cmu.edu,Dental Hygienist,4149,1110,5259
37275,Yolane,Aery,yaeryjq@tinypic.com,Web Designer IV,3111,1082,4193
37004,Abram,Donaher,adonaherjr@cyberchimps.com,Business Systems Development Analyst,3444,1970,5414
37597,Aridatha,Nealey,anealeyju@typepad.com,Budget/Accounting Analyst III,9281,213,9494
37578,Ricoriki,Craufurd,rcraufurdjw@360.cn,Graphic Designer,3887,902,4789
37098,Hakim,Gisbourn,hgisbournjx@si.edu,Desktop Support Technician,1552,1920,3472
37737,Megan,Ordelt,mordeltjy@163.com,Director of Sales,1008,1949,2957
37038,Danit,Hulme,dhulmejz@disqus.com,Safety Technician IV,1943,729,2672
37663,Andrea,Outibridge,aoutibridgek0@google.nl,Statistician III,2025,588,2613
37753,Wilfred,Dunkerley,wdunkerleyk1@geocities.com,General Manager,5758,711,6469
37640,Eryn,Tytcomb,etytcombk3@cbsnews.com,Nurse Practicioner,7693,786,8479
37491,Reid,Kilalea,rkilaleak4@youtube.com,Financial Advisor,8257,986,9243
37197,Thorpe,Gavagan,tgavagank6@eventbrite.com,Senior Developer,5429,596,6025
37895,Salomi,Plak,splakk8@gov.uk,Human Resources Assistant IV,3794,1972,5766
37153,Maria,Calfe,mcalfekc@stanford.edu,Programmer II,9029,957,9986
37943,Dominique,Blais,dblaiskf@mac.com,Research Associate,5503,1537,7040
37814,Hildegaard,Lamasna,hlamasnakg@ycombinator.com,Internal Auditor,9698,1624,11322
37045,Josi,Blaxton,jblaxtonkj@ox.ac.uk,Chief Design Engineer,6800,1712,8512
37633,Sonnnie,Mc Ilory,smcilorykq@live.com,Biostatistician I,2296,1787,4083
37773,Wilburt,Blesing,wblesingks@bbc.co.uk,Systems Administrator II,4499,458,4957
37562,Prue,Whyman,pwhymankt@ihg.com,Research Assistant III,6497,1888,8385
37062,Briney,Siddons,bsiddonsku@sbwire.com,Quality Engineer,4287,945,5232
37277,Sande,Arnason,sarnasonkv@harvard.edu,Analog Circuit Design manager,5487,373,5860
37428,Henka,Hubner,hhubnerkx@state.tx.us,Research Nurse,4593,1156,5749
37174,Cecily,Whitnell,cwhitnelll0@tiny.cc,Research Assistant IV,9808,1973,11781
37048,Sonnie,Coffin,scoffinl1@ustream.tv,Data Coordiator,1142,1707,2849
37671,Elroy,Cudbird,ecudbirdl3@vkontakte.ru,Research Associate,3602,973,4575
37787,Olvan,Brigham,obrighaml5@wisc.edu,Tax Accountant,9537,579,10116
37282,Vernen,Lacky,vlackyl6@theatlantic.com,Information Systems Manager,6348,562,6910
37631,Giffy,Latch,glatchl8@google.co.uk,Research Associate,5345,358,5703
37729,Myrtie,Whooley,mwhooleyla@microsoft.com,Research Associate,5882,338,6220
37704,Henri,Daniaud,hdaniaudld@cbsnews.com,Speech Pathologist,2060,1034,3094
37244,Bartholemy,Jeanes,bjeanesle@nhs.uk,Senior Cost Accountant,8847,1258,10105
37935,Silvanus,Swancock,sswancocklf@artisteer.com,Food Chemist,8582,224,8806
37876,Elvira,Snelgrove,esnelgrovelh@ed.gov,Account Representative II,2387,834,3221
37215,Jerry,Grishin,jgrishinlj@ustream.tv,Help Desk Operator,5343,875,6218
37234,Karalee,Bletso,kbletsoll@photobucket.com,VP Quality Control,7105,1502,8607
37561,Eolanda,Hasson,ehassonln@digg.com,Analyst Programmer,8546,337,8883
37266,Meara,Moberley,mmoberleylp@mysql.com,Accountant II,5028,1497,6525
37892,Lelia,Ayshford,layshfordlu@cloudflare.com,Electrical Engineer,6996,1069,8065
37602,Niki,Pearmain,npearmainlv@reverbnation.com,Statistician II,8163,1002,9165
37724,Locke,Bjorkan,lbjorkanlx@comsenz.com,Environmental Tech,7453,1148,8601
37844,Inga,Grzeskowski,igrzeskowskilz@mtv.com,Marketing Manager,3123,1079,4202
37206,Valene,Keveren,vkeverenm1@harvard.edu,General Manager,2727,1658,4385
37891,Codi,Lowle,clowlem2@shop-pro.jp,Associate Professor,7949,381,8330
37648,Dewitt,Winslade,dwinsladem5@drupal.org,Programmer Analyst I,7598,1212,8810
37240,Lou,Fearnehough,lfearnehoughma@imageshack.us,Senior Sales Associate,4187,1530,5717
37686,Tim,Jakuszewski,tjakuszewskimc@technorati.com,Nurse Practicioner,9713,1456,11169
37681,Curcio,Condon,ccondonme@reverbnation.com,Professor,7981,944,8925
37788,Diana,Begley,dbegleymf@nationalgeographic.com,Systems Administrator I,8780,1681,10461
37051,Jocelyne,Brown,jbrownmg@jalbum.net,Office Assistant IV,5079,246,5325
37544,Lance,Carmen,lcarmenml@cnbc.com,Computer Systems Analyst III,1721,903,2624
37856,Ginger,Merredy,gmerredymm@oracle.com,Editor,3869,867,4736
37604,Xylia,Van Halen,xvanhalenmp@com.com,Mechanical Systems Engineer,4747,1451,6198
37673,Stephine,Siehard,ssiehardmq@bloglovin.com,Electrical Engineer,1658,754,2412
37551,Penny,Kiloh,pkilohms@ezinearticles.com,Administrative Officer,5454,1640,7094
37181,Ramona,Youngman,ryoungmanmy@prlog.org,Registered Nurse,9692,1898,11590
37149,Hamlin,Bertram,hbertrammz@goo.gl,Compensation Analyst,5606,1063,6669
37537,Robert,Charman,rcharmann0@themeforest.net,Professor,8487,1706,10193
37358,Rozalie,Brereton,rbreretonn1@cbslocal.com,VP Product Management,8176,1476,9652
37952,Gilbertina,Moralee,gmoraleen2@qq.com,Programmer I,4179,1997,6176
37696,Saxe,Scotchbourouge,sscotchbourougen3@state.tx.us,Database Administrator I,1493,916,2409
37096,Roseanne,Stedson,rstedsonn4@linkedin.com,Senior Developer,6577,1180,7757
37568,Bradford,De Robertis,bderobertisn5@kickstarter.com,GIS Technical Architect,6727,723,7450
37644,Shelley,Mildenhall,smildenhalln6@bizjournals.com,Product Engineer,7012,676,7688
37799,Lillian,Lange,llangen9@liveinternet.ru,Computer Systems Analyst III,7015,591,7606
37103,Hillyer,Brower,hbrowernh@unicef.org,Programmer Analyst II,1122,274,1396
37587,Sammy,Hyland,shylandnj@elegantthemes.com,Mechanical Systems Engineer,5519,579,6098
37771,Karmen,Glass,kglassnm@nbcnews.com,Associate Professor,8944,1609,10553
37512,Kaitlyn,Spinella,kspinellanq@statcounter.com,Internal Auditor,3252,1684,4936
37322,Cordelia,Howcroft,chowcroftnr@sourceforge.net,Software Test Engineer II,6462,933,7395
37809,Mac,Pendlington,mpendlingtonns@webeden.co.uk,Nurse Practicioner,5769,295,6064
37766,Mellisa,Woollends,mwoollendsnu@canalblog.com,Junior Executive,5234,1155,6389
37401,Dorthy,Artis,dartisnw@nsw.gov.au,Structural Analysis Engineer,9265,787,10052
37622,Beltran,Jagiela,bjagielanx@odnoklassniki.ru,Media Manager IV,7087,456,7543
37337,Giles,Balassi,gbalassiny@toplist.cz,Occupational Therapist,1174,1447,2621
37624,Tyrone,Beckworth,tbeckwortho0@example.com,Media Manager II,7138,632,7770
37134,Lemmy,Swatridge,lswatridgeo1@chron.com,Mechanical Systems Engineer,7099,1160,8259
37922,Giustino,Erat,gerato3@yandex.ru,Financial Advisor,5614,1073,6687
37627,Arv,Schulter,aschultero4@slideshare.net,Nuclear Power Engineer,9158,1747,10905
37262,Daphne,Rudiger,drudigerob@flickr.com,Assistant Manager,9564,1714,11278
37887,Riki,Botwood,rbotwoodoc@hibu.com,Financial Advisor,8407,1222,9629
37435,Robbie,Philpot,rphilpotoe@live.com,Assistant Media Planner,8647,283,8930
37405,Jayne,Hunter,jhunteroi@amazon.de,Professor,7039,733,7772
37495,Onfre,Blackwood,oblackwoodoj@flavors.me,Desktop Support Technician,1165,1280,2445
37281,Raviv,Silkston,rsilkstonok@mediafire.com,Engineer II,9866,785,10651
37874,Rasia,Sawer,rsaweron@bluehost.com,Electrical Engineer,6147,1676,7823
37678,Philly,Reuter,preuteroq@opera.com,Software Consultant,9933,849,10782
37317,Gilli,Philliskirk,gphilliskirkos@microsoft.com,Editor,7883,382,8265
37656,Janet,Coverly,jcoverlyov@senate.gov,Nurse,1745,1631,3376
37538,Ermentrude,Duerden,eduerdenow@illinois.edu,Analyst Programmer,6435,441,6876
37642,Kayle,Turle,kturleox@chicagotribune.com,Staff Scientist,3779,842,4621
37938,Giulietta,Lottrington,glottringtonoy@vistaprint.com,VP Sales,9758,568,10326
37959,Luci,Banasik,lbanasikp0@chronoengine.com,Research Assistant I,4123,557,4680
37851,Halli,Hessing,hhessingp1@wordpress.com,Civil Engineer,3681,1604,5285
37270,Abbie,Denys,adenysp3@omniture.com,Senior Sales Associate,1433,1147,2580
37589,Zonda,Dunsmuir,zdunsmuirp4@skype.com,Programmer III,8954,1150,10104
37793,Mildrid,Oury,mouryp6@mapquest.com,Automation Specialist II,6099,1153,7252
37596,Wyatan,Langmuir,wlangmuirp7@theatlantic.com,Physical Therapy Assistant,8134,570,8704
37550,Ruben,Armstead,rarmsteadpe@myspace.com,Design Engineer,1238,1671,2909
37292,Bentley,Lanham,blanhampf@cnet.com,Nuclear Power Engineer,1768,1069,2837
37114,Francklyn,Mulbery,fmulberypk@illinois.edu,Tax Accountant,9120,1898,11018
37757,Sheela,Murphey,smurpheypl@psu.edu,Environmental Specialist,3055,375,3430
37025,Alice,Salasar,asalasarps@discovery.com,Programmer I,1210,1046,2256
37350,Nikolas,Whitcombe,nwhitcombepv@bbc.co.uk,Nurse,8995,1639,10634
37617,Mahmud,Huniwall,mhuniwallq0@google.pl,Actuary,6571,1211,7782
37539,Giacinta,Sheaf,gsheafq1@usda.gov,Budget/Accounting Analyst I,9290,1749,11039
37343,Colan,Cathenod,ccathenodq3@marketwatch.com,Editor,2407,1058,3465
37918,Malchy,Stears,mstearsq6@comcast.net,Programmer II,2480,1814,4294
37101,Cathyleen,Chastagnier,cchastagnierq7@businessweek.com,Senior Editor,5675,304,5979
37318,Korella,Desmond,kdesmondq8@google.co.jp,Account Representative IV,8946,1049,9995
37978,Theresita,Fell,tfellq9@themeforest.net,Environmental Tech,8028,1960,9988
37940,Henrie,Oddie,hoddieqa@dagondesign.com,Director of Sales,8500,1344,9844
37446,Mateo,Standen,mstandenqb@yale.edu,Teacher,9988,1511,11499
37298,Franzen,Ridder,fridderqc@cocolog-nifty.com,Assistant Media Planner,6622,1740,8362
37795,Johannes,Hearsum,jhearsumqd@e-recht24.de,VP Marketing,4103,468,4571
37646,Twila,Greeno,tgreenoqh@berkeley.edu,Marketing Assistant,7101,789,7890
37180,Aile,Sammars,asammarsqk@va.gov,Executive Secretary,6729,1318,8047
37548,Floris,Rissom,frissomqm@cisco.com,Programmer I,5546,1826,7372
37569,Bernardo,Regler,breglerqp@msn.com,Automation Specialist III,1564,1033,2597
37190,Lev,Bowe,lboweqr@globo.com,Marketing Manager,3242,1322,4564
37193,Des,Parsonson,dparsonsonqv@rambler.ru,Database Administrator III,6508,820,7328
37164,Eziechiele,Totterdill,etotterdillqw@zimbio.com,Speech Pathologist,7716,696,8412
37165,Christoph,Jessopp,cjessoppr6@deliciousdays.com,Account Executive,9853,517,10370
37448,Saxon,Brownlea,sbrownlearb@cornell.edu,Software Consultant,8956,1875,10831
37557,George,Tye,gtyerf@over-blog.com,Nurse Practicioner,6024,1821,7845
37321,Nicola,Cauley,ncauleyrh@cornell.edu,Senior Financial Analyst,8765,236,9001
37615,Ellis,Boone,eboonerk@jimdo.com,Community Outreach Specialist,6100,733,6833
37295,Ann,Guiduzzi,aguiduzzirn@gnu.org,Senior Quality Engineer,3592,1990,5582
37532,Christoffer,Bail,cbailrp@cisco.com,Systems Administrator III,8298,416,8714
38073,Petronilla,Matsell,pmatsell0@tmall.com,GIS Technical Architect,3128,1324,4452
38830,Marcella,Gittoes,mgittoes1@howstuffworks.com,Senior Financial Analyst,9164,1096,10260
38937,Katheryn,Younghusband,kyounghusband2@sbwire.com,Registered Nurse,2885,1117,4002
38717,Orelee,Burge,oburge3@godaddy.com,Pharmacist,2677,1385,4062
38281,Ario,Lines,alines4@people.com.cn,Accountant II,5724,708,6432
38490,Stevena,Killeley,skilleley5@meetup.com,Associate Professor,3085,1333,4418
38871,Conrado,Witard,cwitard6@macromedia.com,Civil Engineer,3752,946,4698
38265,Channa,Blonden,cblonden7@vkontakte.ru,Research Nurse,6422,1355,7777
38750,Ethelred,Geffen,egeffen8@theglobeandmail.com,Speech Pathologist,5313,737,6050
38920,Leicester,Blanc,lblanc9@spotify.com,Graphic Designer,9253,1233,10486
38864,Marne,Ronca,mroncaa@virginia.edu,Environmental Tech,4000,362,4362
38087,Keith,Gasnoll,kgasnollb@springer.com,VP Quality Control,8924,1968,10892
38138,Dorie,Dumingo,ddumingoc@qq.com,Environmental Tech,9016,869,9885
38648,Penelope,Orringe,porringed@facebook.com,Budget/Accounting Analyst IV,9086,208,9294
38901,Jake,Leadstone,jleadstonee@sbwire.com,Software Test Engineer II,7046,1014,8060
38731,Zacharias,Arents,zarentsf@uol.com.br,Senior Sales Associate,1639,1483,3122
38604,Marlin,Woodrup,mwoodrupg@delicious.com,Help Desk Technician,4371,1280,5651
38350,Aluino,Gernier,agernierh@homestead.com,Senior Financial Analyst,8813,1613,10426
38509,Bob,McBratney,bmcbratneyi@jalbum.net,Human Resources Assistant II,2655,1695,4350
38232,Abbey,Bickerdyke,abickerdykej@reverbnation.com,Editor,4443,1746,6189
38291,Cullen,Skittreal,cskittrealk@ocn.ne.jp,Media Manager I,2795,803,3598
38157,Katharyn,Sibun,ksibunl@howstuffworks.com,Internal Auditor,6161,691,6852
38571,Helen-elizabeth,Byram,hbyramm@dyndns.org,Chief Design Engineer,2832,307,3139
38536,Adorne,Brister,abristern@delicious.com,Professor,8738,626,9364
38381,Kelsy,Duckerin,kduckerino@blogs.com,Editor,2606,488,3094
38631,Corette,Dupoy,cdupoyp@narod.ru,Automation Specialist II,9788,1783,11571
38320,Zachary,Danilyuk,zdanilyukq@accuweather.com,Payment Adjustment Coordinator,6583,393,6976
38154,Grenville,Fido,gfidor@123-reg.co.uk,Help Desk Technician,6711,1404,8115
38129,Laney,Gulvin,lgulvins@sciencedirect.com,Electrical Engineer,5082,850,5932
38861,Coop,Pinnington,cpinningtont@bbb.org,Human Resources Assistant II,3255,1408,4663
38726,Hazel,Robichon,hrobichonv@opera.com,Assistant Media Planner,5174,1375,6549
38767,Marguerite,Cruwys,mcruwysw@un.org,VP Accounting,6703,939,7642
38948,Cheryl,Devennie,cdevenniex@i2i.jp,Mechanical Systems Engineer,1945,715,2660
38663,Timotheus,Louth,tlouthy@cdc.gov,Account Executive,1352,904,2256
38964,Ruth,Whiten,rwhitenz@webeden.co.uk,Assistant Manager,6136,976,7112
38519,Ev,Tubbles,etubbles10@oaic.gov.au,VP Marketing,8160,897,9057
38292,Veda,Eates,veates11@sourceforge.net,Project Manager,7777,1187,8964
38641,Stanwood,Gribbin,sgribbin12@dedecms.com,Nurse Practicioner,8080,1408,9488
38993,Matt,Cowling,mcowling13@de.vu,Teacher,4870,1650,6520
38121,Norene,McGown,nmcgown14@yahoo.co.jp,Professor,5625,298,5923
38593,Timoteo,Le Port,tleport16@csmonitor.com,Analyst Programmer,2235,787,3022
38419,Kalvin,Wootton,kwootton17@salon.com,VP Marketing,7109,821,7930
38932,Willow,Darben,wdarben18@geocities.jp,Pharmacist,3532,1712,5244
38175,Kristo,Greenman,kgreenman19@4shared.com,Sales Representative,3887,995,4882
38606,Wrennie,Kach,wkach1a@google.com,Software Test Engineer III,9493,615,10108
38050,Merlina,Johnes,mjohnes1b@xrea.com,Analyst Programmer,5772,1587,7359
38778,Hartley,Shuker,hshuker1c@bravesites.com,Computer Systems Analyst III,3873,218,4091
38564,Tobias,Rubra,trubra1d@princeton.edu,Electrical Engineer,4860,1238,6098
38706,Heriberto,Thresher,hthresher1e@sbwire.com,Graphic Designer,9277,1649,10926
38383,Hector,Abelevitz,habelevitz1f@walmart.com,GIS Technical Architect,1400,978,2378
38411,Skye,Abramski,sabramski1g@4shared.com,VP Marketing,7347,1183,8530
38230,Gayle,Rein,grein1h@dailymail.co.uk,Director of Sales,8467,1133,9600
38983,Amalie,Grayer,agrayer1i@msn.com,VP Accounting,5273,941,6214
38246,Angelle,Cissen,acissen1k@shutterfly.com,Dental Hygienist,3934,1088,5022
38570,Kass,Bushe,kbushe1l@disqus.com,Structural Engineer,2491,1549,4040
38290,Sharl,Nappin,snappin1m@plala.or.jp,Associate Professor,1436,1949,3385
38892,Darci,Brekonridge,dbrekonridge1n@oakley.com,Systems Administrator II,3514,744,4258
38862,Adham,Garey,agarey1o@themeforest.net,Database Administrator IV,9408,1276,10684
38238,Gonzales,Margach,gmargach1p@washington.edu,Analyst Programmer,1258,1690,2948
38471,Hakim,Dybell,hdybell1q@opera.com,Systems Administrator III,5484,786,6270
38352,Alfi,Knightsbridge,aknightsbridge1r@desdev.cn,VP Quality Control,2050,1867,3917
38176,Ruby,Toplis,rtoplis1s@virginia.edu,Pharmacist,5288,1628,6916
38359,Kile,Thunder,kthunder1t@opensource.org,Geological Engineer,8463,1141,9604
38687,Jone,Windibank,jwindibank1u@admin.ch,Structural Engineer,1087,1674,2761
38497,Demott,Skilling,dskilling1v@flickr.com,Civil Engineer,8147,1926,10073
38170,Shanie,Corbould,scorbould1w@topsy.com,Associate Professor,1734,920,2654
38980,Koral,Speak,kspeak1x@wp.com,Help Desk Technician,5747,253,6000
38639,Gar,Ortler,gortler1y@xrea.com,Web Developer III,8342,1922,10264
38643,Karin,Jager,kjager1z@sbwire.com,Tax Accountant,1011,1453,2464
38933,Timi,Barbe,tbarbe20@printfriendly.com,Pharmacist,2727,1489,4216
38934,Leigh,Abelwhite,labelwhite21@live.com,Chief Design Engineer,7368,1017,8385
38638,Darelle,Whittleton,dwhittleton22@sitemeter.com,Account Representative II,6289,966,7255
38721,Byran,Kyd,bkyd23@elegantthemes.com,Developer I,1313,1214,2527
38591,Arney,Mickleborough,amickleborough24@timesonline.co.uk,VP Marketing,9069,268,9337
38902,Aurel,Langdon,alangdon25@parallels.com,VP Product Management,7593,1455,9048
38045,Adria,Tucknott,atucknott26@oaic.gov.au,Executive Secretary,6877,663,7540
38600,Wenda,Sellack,wsellack27@naver.com,Recruiting Manager,8306,980,9286
38455,Stoddard,Kemston,skemston28@time.com,Civil Engineer,3033,1634,4667
38846,Stan,Luipold,sluipold29@go.com,Business Systems Development Analyst,3731,1634,5365
38786,Corella,Pickerill,cpickerill2a@ted.com,Assistant Media Planner,9986,497,10483
38770,Lamond,Gifkins,lgifkins2b@com.com,Developer IV,6194,930,7124
38608,Fred,O'Ferris,foferris2c@ehow.com,Analog Circuit Design manager,4201,1654,5855
38796,Saundra,Gilardoni,sgilardoni2e@google.es,VP Quality Control,7494,336,7830
38028,Arni,Viccars,aviccars2g@seesaa.net,Nurse Practicioner,1567,599,2166
38473,Dionisio,Haynes,dhaynes2h@hud.gov,Research Associate,8229,1560,9789
38872,Kerri,Eskell,keskell2i@yellowpages.com,GIS Technical Architect,1955,1635,3590
38064,Letisha,Coda,lcoda2j@vistaprint.com,Programmer Analyst II,7470,544,8014
38239,Anitra,Ruckledge,aruckledge2k@friendfeed.com,Senior Financial Analyst,1637,798,2435
38327,Ivette,Arnison,iarnison2l@ucsd.edu,Financial Advisor,7885,697,8582
38522,Elvin,D'Ambrogi,edambrogi2m@cornell.edu,Sales Associate,1086,1657,2743
38431,Anna-maria,Grossman,agrossman2o@artisteer.com,Recruiter,8999,564,9563
38084,Monro,Reddlesden,mreddlesden2p@cnbc.com,Structural Engineer,6540,751,7291
38788,Benedicto,Pashba,bpashba2q@php.net,Geologist I,9200,1869,11069
38744,Cristian,Shernock,cshernock2r@upenn.edu,Graphic Designer,9388,424,9812
38414,Raven,Ridesdale,rridesdale2s@delicious.com,Legal Assistant,5587,312,5899
38033,Eugenius,Keele,ekeele2t@domainmarket.com,Research Assistant I,1118,1468,2586
38278,Kamillah,Ortet,kortet2u@wisc.edu,Engineer II,3117,438,3555
38730,Jacklyn,Govett,jgovett2v@webs.com,Software Consultant,3539,495,4034
38927,Grethel,Sebborn,gsebborn2w@alexa.com,Assistant Professor,4429,1518,5947
38034,Harlene,Norcop,hnorcop2x@apache.org,Associate Professor,7991,1523,9514
38333,Bald,Marple,bmarple2z@webs.com,Product Engineer,5174,1060,6234
38424,Winn,Bignold,wbignold30@mashable.com,Mechanical Systems Engineer,3797,857,4654
38874,Velvet,Beasley,vbeasley31@netlog.com,Software Test Engineer I,3713,1138,4851
38472,Royal,Pepis,rpepis32@ustream.tv,Product Engineer,4772,1977,6749
38093,Jewelle,Aleksashin,jaleksashin33@craigslist.org,Analyst Programmer,3767,1420,5187
38002,Pegeen,Talbot,ptalbot35@spotify.com,Product Engineer,1810,1959,3769
38286,Sigismund,Mogg,smogg36@uiuc.edu,Sales Representative,5009,1283,6292
38213,Sylvan,Moxon,smoxon37@weebly.com,Developer I,3214,705,3919
38065,Elihu,Maude,emaude38@blogger.com,Accounting Assistant IV,5653,937,6590
38825,Rick,Doge,rdoge39@nps.gov,VP Sales,7474,1810,9284
38972,Conny,Jessard,cjessard3a@ifeng.com,Account Executive,5940,394,6334
38566,Inigo,Rowling,irowling3b@businesswire.com,Programmer II,1060,1455,2515
38142,Kynthia,Paton,kpaton3c@last.fm,Electrical Engineer,7123,782,7905
38001,Alina,Brise,abrise3d@odnoklassniki.ru,VP Marketing,6821,1943,8764
38293,Juan,Desson,jdesson3e@jimdo.com,Research Nurse,4102,1175,5277
38689,Brnaba,Keysel,bkeysel3f@businessinsider.com,Legal Assistant,7485,1938,9423
38484,Renelle,Fairrie,rfairrie3g@imageshack.us,Human Resources Manager,5463,1366,6829
38032,Walsh,Flitcroft,wflitcroft3h@simplemachines.org,Help Desk Technician,1099,1000,2099
38446,Horace,Hedingham,hhedingham3i@merriam-webster.com,Quality Control Specialist,4417,248,4665
38111,Tailor,Tarrier,ttarrier3j@ft.com,Operator,5027,506,5533
38757,Armando,Roddy,aroddy3k@imgur.com,Software Consultant,2957,1050,4007
38085,Menard,Rickardes,mrickardes3l@abc.net.au,Information Systems Manager,1675,259,1934
38489,Weber,Wybrew,wwybrew3o@w3.org,Recruiting Manager,2080,278,2358
38004,Ephrayim,O'Giany,eogiany3p@purevolume.com,Senior Cost Accountant,6515,1339,7854
38217,Ramsey,Planque,rplanque3q@sogou.com,VP Sales,6986,1233,8219
38492,Eldredge,Franckton,efranckton3r@a8.net,Administrative Officer,4201,1652,5853
38512,Lauren,Bispham,lbispham3s@earthlink.net,Geologist I,9187,569,9756
38917,Penelope,Frick,pfrick3u@netscape.com,Account Representative IV,5749,1275,7024
38259,Kingsley,Mercey,kmercey3v@dedecms.com,Legal Assistant,6138,523,6661
38652,Saunder,Sokale,ssokale3w@naver.com,Junior Executive,3849,208,4057
38029,Jo,Isacoff,jisacoff3y@newsvine.com,Data Coordiator,4445,577,5022
38451,Thorn,Dibdin,tdibdin3z@chron.com,Financial Advisor,5336,987,6323
38240,Phillipe,Hess,phess40@webnode.com,Executive Secretary,4346,1922,6268
38775,Claudine,Wharby,cwharby41@squidoo.com,Director of Sales,9461,1665,11126
38132,Lucila,Garrity,lgarrity42@angelfire.com,Assistant Professor,1192,656,1848
38748,Sidoney,Given,sgiven43@washingtonpost.com,Web Developer III,6200,881,7081
38296,Wendel,Flintoff,wflintoff44@cnn.com,Office Assistant II,8816,1533,10349
39000,Duane,Jakov,djakov47@ihg.com,Occupational Therapist,7704,838,8542
38930,Marlie,Leyes,mleyes48@booking.com,Food Chemist,4205,715,4920
38772,Shem,de Nore,sdenore49@blogger.com,Research Associate,3474,1869,5343
38996,Melony,Anmore,manmore4a@rakuten.co.jp,Data Coordiator,7575,725,8300
38657,Leighton,Reburn,lreburn4b@time.com,Chief Design Engineer,1844,1299,3143
38773,Cher,Zold,czold4c@multiply.com,Software Engineer I,7743,975,8718
38041,Rachael,Pandey,rpandey4d@miitbeian.gov.cn,Developer II,1055,574,1629
38737,Shayne,Lardner,slardner4e@ibm.com,Software Consultant,6676,1047,7723
38708,Rafaello,Cordobes,rcordobes4f@alexa.com,Geological Engineer,3004,1053,4057
38674,Marthena,Edens,medens4g@com.com,Financial Advisor,3314,1153,4467
38078,Milly,Pascall,mpascall4h@utexas.edu,Account Coordinator,2034,1267,3301
38047,Mattheus,Francescuzzi,mfrancescuzzi4i@wired.com,Associate Professor,1051,2000,3051
38081,Briana,McGaugie,bmcgaugie4j@slashdot.org,Social Worker,8844,296,9140
38011,Allan,Fishbourn,afishbourn4k@liveinternet.ru,Actuary,6941,1003,7944
38454,Roland,Hallawell,rhallawell4l@cnn.com,Research Assistant II,4491,568,5059
38304,Hamilton,Soares,hsoares4m@auda.org.au,Assistant Manager,9467,1680,11147
38826,Kipper,Du Pre,kdupre4o@sphinn.com,Web Developer II,2909,1898,4807
38254,Rozanna,Plumer,rplumer4p@zdnet.com,Editor,8303,1590,9893
38635,Dianna,Colliard,dcolliard4q@sphinn.com,Compensation Analyst,9194,1963,11157
38253,Pascal,Vivyan,pvivyan4r@dmoz.org,Electrical Engineer,8648,1403,10051
38694,Leif,Kleewein,lkleewein4u@furl.net,Accountant IV,7379,1984,9363
38305,Dione,Limpricht,dlimpricht4v@github.io,Nurse,9038,747,9785
38551,Pietra,Toye,ptoye4w@wp.com,Graphic Designer,2228,1639,3867
38732,Towney,Houselee,thouselee4x@icq.com,Health Coach III,3399,1349,4748
38978,Virgilio,Haldane,vhaldane4y@buzzfeed.com,VP Product Management,9966,1126,11092
38840,Elihu,Dripps,edripps4z@usnews.com,Statistician III,8190,621,8811
38661,Christian,Brugger,cbrugger50@biblegateway.com,Compensation Analyst,5323,1501,6824
38500,Suzy,MacParlan,smacparlan51@jalbum.net,Professor,7226,1204,8430
38222,Trista,Moneti,tmoneti53@weebly.com,Programmer Analyst III,7772,666,8438
38751,Lilla,Constance,lconstance54@acquirethisname.com,Graphic Designer,7047,996,8043
38118,Bradly,Wiggall,bwiggall55@plala.or.jp,Budget/Accounting Analyst III,8265,1153,9418
38344,Hilda,Breacher,hbreacher56@soundcloud.com,Developer II,2260,1652,3912
38620,Felix,Sauvage,fsauvage58@mediafire.com,Software Test Engineer II,2842,1995,4837
38956,Idelle,Evemy,ievemy59@google.cn,Quality Engineer,4807,1428,6235
38218,Berne,Elliff,belliff5a@mediafire.com,Automation Specialist I,2773,1177,3950
38534,Austin,Garnson,agarnson5b@opera.com,Civil Engineer,5993,571,6564
38319,Amaleta,Batson,abatson5c@mtv.com,Systems Administrator I,5982,1175,7157
38799,Danny,Bau,dbau5d@blogs.com,Chemical Engineer,6667,356,7023
38517,Brietta,Mothersdale,bmothersdale5e@posterous.com,Actuary,1595,964,2559
38163,Iain,Northern,inorthern5f@yandex.ru,Structural Analysis Engineer,9454,538,9992
38009,Eve,Cuttin,ecuttin5g@wisc.edu,VP Sales,5010,366,5376
38837,Mason,Pfleger,mpfleger5h@privacy.gov.au,Payment Adjustment Coordinator,3369,1261,4630
38202,Orrin,Shewring,oshewring5i@feedburner.com,Editor,7820,771,8591
38116,Berenice,Tween,btween5j@kickstarter.com,Product Engineer,6720,494,7214
38475,Maud,Gambie,mgambie5k@paypal.com,Help Desk Technician,6736,1120,7856
38023,Pollyanna,Ullett,pullett5l@theguardian.com,Environmental Tech,9631,1447,11078
38173,Barron,Staresmeare,bstaresmeare5m@rediff.com,Account Executive,3997,618,4615
38022,Kerrie,Works,kworks5q@icq.com,Nurse,5781,1219,7000
38759,Jacquelin,Rosbrough,jrosbrough5s@odnoklassniki.ru,Safety Technician IV,8115,458,8573
38363,Jordanna,Grimolbie,jgrimolbie5t@miibeian.gov.cn,Developer III,4059,929,4988
38869,Rachael,Deverale,rdeverale5u@dailymail.co.uk,Research Nurse,4122,311,4433
38501,Mae,Denzey,mdenzey5w@yellowbook.com,Assistant Manager,5760,942,6702
38226,Xylina,Bernakiewicz,xbernakiewicz5x@wufoo.com,Help Desk Technician,3255,1539,4794
38449,Ricki,Capewell,rcapewell5y@bandcamp.com,Senior Cost Accountant,8622,592,9214
38394,Jamey,Kmietsch,jkmietsch60@friendfeed.com,Analyst Programmer,2105,1236,3341
38026,Xavier,Rollett,xrollett61@wix.com,Legal Assistant,2737,1411,4148
38612,Tomasine,Sandiford,tsandiford62@imgur.com,VP Quality Control,5227,1412,6639
38031,Nowell,Tattoo,ntattoo63@washingtonpost.com,Food Chemist,8951,1105,10056
38949,Pepi,Cobbold,pcobbold64@buzzfeed.com,Occupational Therapist,7433,800,8233
38370,Jewelle,Elnaugh,jelnaugh65@trellian.com,Software Engineer II,2936,1165,4101
38887,Enid,Hamnett,ehamnett66@so-net.ne.jp,Office Assistant IV,4080,1258,5338
38313,Cherie,Bilbee,cbilbee67@wikispaces.com,Accountant IV,4904,573,5477
38565,Bee,Ruecastle,bruecastle69@upenn.edu,Financial Advisor,8014,1781,9795
38462,Thornie,Chewter,tchewter6b@economist.com,Account Representative III,1298,1575,2873
38438,Melisandra,Egle,megle6d@bbc.co.uk,Database Administrator II,5880,1837,7717
38815,Irena,Croot,icroot6e@discuz.net,Project Manager,6105,1209,7314
38343,Jeremiah,Furniss,jfurniss6f@google.com.br,Accountant II,6371,1357,7728
38195,Stacee,Wankling,swankling6g@youku.com,Research Nurse,5178,1374,6552
38883,Merna,Peace,mpeace6h@uol.com.br,Senior Quality Engineer,3917,260,4177
38200,Sophronia,Gilleon,sgilleon6i@lulu.com,Internal Auditor,7828,631,8459
38003,Anabal,Schoular,aschoular6j@nymag.com,Operator,6252,764,7016
38201,Willard,Copyn,wcopyn6k@topsy.com,Cost Accountant,3396,1010,4406
38898,Gray,Zorzoni,gzorzoni6l@huffingtonpost.com,Help Desk Technician,9071,484,9555
38233,Jeanine,Heckney,jheckney6m@nyu.edu,Speech Pathologist,5998,1799,7797
38853,Timmy,Hadwick,thadwick6n@wordpress.com,Programmer Analyst IV,3443,1864,5307
38401,Rowe,Orrin,rorrin6p@mayoclinic.com,Chemical Engineer,2776,1156,3932
38531,Shannah,Stepto,sstepto6q@zdnet.com,Senior Developer,9057,1163,10220
38798,Ninette,Behrend,nbehrend6r@mayoclinic.com,Biostatistician III,6324,253,6577
38425,Ramsay,Selway,rselway6t@reddit.com,Operator,3688,271,3959
38416,Axe,Mation,amation6v@t-online.de,Structural Engineer,2243,660,2903
38659,Agnella,Hourihane,ahourihane6w@reuters.com,Chemical Engineer,7603,1225,8828
38260,Caron,Cutler,ccutler71@printfriendly.com,Assistant Media Planner,8177,1240,9417
38646,Kenton,Cardew,kcardew72@lulu.com,VP Accounting,5911,855,6766
38769,Kelsey,Rowcliffe,krowcliffe73@google.com.hk,Editor,4129,440,4569
38609,Kaila,Goracci,kgoracci74@usgs.gov,Senior Cost Accountant,1864,235,2099
38054,Marinna,Froschauer,mfroschauer75@examiner.com,Health Coach I,5316,388,5704
38739,Farlee,Sancroft,fsancroft76@altervista.org,GIS Technical Architect,5530,615,6145
38525,Daniella,Hazeldine,dhazeldine77@washington.edu,Accounting Assistant III,3812,542,4354
38627,Rivkah,Yerrington,ryerrington7a@nba.com,Sales Representative,2268,1225,3493
38693,Buddie,Gifford,bgifford7b@wikimedia.org,Recruiter,4604,1606,6210
38463,Ruddie,Naisby,rnaisby7c@geocities.com,Legal Assistant,6007,339,6346
38042,Lorie,Tutsell,ltutsell7d@zimbio.com,Research Associate,7023,498,7521
38059,Skipp,Embling,sembling7e@dailymail.co.uk,Graphic Designer,1259,917,2176
38160,Antonetta,Starkey,astarkey7f@trellian.com,Actuary,1272,919,2191
38136,Hayes,Behnecke,hbehnecke7i@nytimes.com,Chemical Engineer,2695,394,3089
38923,Georgianne,Grelka,ggrelka7k@google.pl,Media Manager I,7371,822,8193
38588,Jacquetta,Ensley,jensley7l@businessweek.com,VP Accounting,4120,1345,5465
38186,Perry,Twelftree,ptwelftree7n@dailymail.co.uk,Financial Analyst,8236,972,9208
38402,Elton,Trevna,etrevna7o@seesaa.net,Human Resources Manager,4217,1399,5616
38158,Klemens,Mars,kmars7p@slate.com,Engineer IV,8146,507,8653
38502,Grady,Barme,gbarme7r@ibm.com,Compensation Analyst,6731,1200,7931
38384,Paulie,Aisthorpe,paisthorpe7s@stanford.edu,Automation Specialist III,5407,444,5851
38516,Kim,Bampton,kbampton7t@gravatar.com,Civil Engineer,9599,1547,11146
38130,Carlie,Lanfere,clanfere7v@nps.gov,Geologist III,4196,532,4728
38814,Elbertina,Maffin,emaffin7w@paypal.com,Automation Specialist I,3607,1523,5130
38615,Sophie,Sate,ssate7x@addthis.com,Safety Technician III,8017,344,8361
38924,Trixi,Woodroff,twoodroff7z@wikispaces.com,Web Developer III,6723,1749,8472
38839,Rolph,Medlicott,rmedlicott81@usda.gov,Speech Pathologist,1732,912,2644
38875,Lyndsay,Dover,ldover82@cargocollective.com,Teacher,9957,271,10228
38999,Isidore,Jane,ijane83@yellowpages.com,VP Sales,6180,1946,8126
38582,Fanechka,Haselden,fhaselden84@msn.com,Geological Engineer,2303,1410,3713
38250,Hans,Moorman,hmoorman85@constantcontact.com,Project Manager,6414,1522,7936
38119,Chiarra,Sprason,csprason86@google.com.hk,Chemical Engineer,5801,580,6381
38558,Henrik,St. Clair,hstclair87@rakuten.co.jp,Quality Control Specialist,5985,845,6830
38068,Marlon,Morton,mmorton88@list-manage.com,Senior Quality Engineer,5695,1474,7169
38647,Ramon,Arnoldi,rarnoldi8a@purevolume.com,Media Manager I,3514,826,4340
38024,Kathlin,Young,kyoung8b@uiuc.edu,Software Consultant,2302,871,3173
38220,Edlin,Pickthorne,epickthorne8c@paypal.com,Administrative Officer,6968,351,7319
38458,Teriann,Copyn,tcopyn8d@dailymail.co.uk,Community Outreach Specialist,2094,1868,3962
38783,Arlina,MacKimm,amackimm8f@photobucket.com,Help Desk Technician,8640,752,9392
38459,Fernando,Hatherell,fhatherell8g@netvibes.com,Associate Professor,4018,1684,5702
38182,Kerry,Sudell,ksudell8h@huffingtonpost.com,Internal Auditor,9675,1293,10968
38180,Trueman,Dysart,tdysart8i@wiley.com,Developer II,9638,1961,11599
38079,Lemmy,Markel,lmarkel8j@cyberchimps.com,GIS Technical Architect,5216,1046,6262
38276,Zenia,Fance,zfance8k@apple.com,Associate Professor,5207,632,5839
38095,Vasili,Gerckens,vgerckens8l@wufoo.com,Office Assistant III,6799,803,7602
38275,Auria,Thornbarrow,athornbarrow8m@springer.com,Senior Cost Accountant,4993,1543,6536
38235,Odette,Edward,oedward8n@yellowpages.com,VP Sales,2358,1179,3537
38418,Adella,Larrie,alarrie8o@answers.com,Health Coach II,7801,1599,9400
38745,Verge,Monkton,vmonkton8p@joomla.org,Pharmacist,1446,1342,2788
38859,Malva,Shewery,mshewery8q@webs.com,Staff Accountant I,3804,1239,5043
38590,Byrann,Glossup,bglossup8u@oaic.gov.au,Analog Circuit Design manager,8616,1745,10361
38580,Angelo,Harper,aharper8v@webeden.co.uk,Administrative Officer,8455,1060,9515
38271,Valle,Charles,vcharles8w@phpbb.com,Structural Engineer,3326,1754,5080
38224,Yasmeen,Coventon,ycoventon8x@opera.com,Web Designer III,1062,218,1280
38216,Lemmie,Pickles,lpickles8z@twitter.com,Community Outreach Specialist,9321,253,9574
38802,Ernesto,Matuszinski,ematuszinski90@mozilla.com,Nurse,6150,333,6483
38895,Hedy,Hasney,hhasney91@free.fr,Occupational Therapist,6982,1043,8025
38780,Nissy,Cantillion,ncantillion92@time.com,Systems Administrator III,7630,1266,8896
38251,Stillman,Wand,swand94@java.com,Senior Sales Associate,6792,741,7533
38145,Emmye,Hightown,ehightown95@typepad.com,Marketing Assistant,8555,1907,10462
38206,Gretta,Clewarth,gclewarth96@businessinsider.com,Clinical Specialist,4312,1028,5340
38234,Suellen,Luddy,sluddy97@xinhuanet.com,Quality Control Specialist,5802,431,6233
38552,Aldus,Simmens,asimmens99@blogspot.com,Human Resources Manager,8798,1826,10624
38684,Jareb,Flieger,jflieger9a@ifeng.com,Senior Quality Engineer,7282,1421,8703
38223,Modesty,Barthorpe,mbarthorpe9b@canalblog.com,Account Coordinator,3833,590,4423
38735,Wenonah,Skep,wskep9c@newyorker.com,Environmental Tech,4229,1487,5716
38491,Del,McCadden,dmccadden9d@tinypic.com,Statistician IV,2522,597,3119
38261,Lena,Iohananof,liohananof9g@e-recht24.de,Desktop Support Technician,1666,1081,2747
38752,Lynde,Binnie,lbinnie9i@paypal.com,Environmental Specialist,5141,1625,6766
38700,Mellicent,Mackinder,mmackinder9j@oaic.gov.au,Mechanical Systems Engineer,7530,352,7882
38905,Ethyl,Heigl,eheigl9l@edublogs.org,Graphic Designer,9671,887,10558
38922,Jerrilee,Croxford,jcroxford9m@zimbio.com,Compensation Analyst,3396,535,3931
38953,Inna,Jeayes,ijeayes9n@people.com.cn,Analyst Programmer,9555,393,9948
38909,Blondelle,Copplestone,bcopplestone9p@redcross.org,Sales Associate,7388,206,7594
38617,Chiarra,Gregori,cgregori9q@goodreads.com,Health Coach IV,2829,1188,4017
38341,Ailee,Tidcomb,atidcomb9r@senate.gov,Cost Accountant,1876,1112,2988
38946,Der,Fayne,dfayne9s@intel.com,Database Administrator III,5443,1057,6500
38346,Susette,Castilljo,scastilljo9t@alibaba.com,Quality Engineer,5029,604,5633
38607,Les,Laborde,llaborde9u@dot.gov,Recruiter,1863,1562,3425
38738,Lorenzo,Elen,lelen9w@nbcnews.com,Nurse Practicioner,6045,817,6862
38724,Maryjo,Wintringham,mwintringham9x@bbb.org,Structural Analysis Engineer,1783,1102,2885
38204,Stanwood,Sciusscietto,ssciussciettoa0@lulu.com,Computer Systems Analyst IV,8985,1603,10588
38973,Barbette,Axelby,baxelbya5@wufoo.com,Environmental Specialist,1910,636,2546
38098,Allin,Griffe,agriffea6@youtu.be,Quality Control Specialist,1546,963,2509
38623,Marcelline,De Vries,mdevriesa9@gravatar.com,Occupational Therapist,3494,1805,5299
38716,Dev,Stelljes,dstelljesaa@reference.com,Help Desk Technician,9645,563,10208
38505,Poppy,Barus,pbarusab@moonfruit.com,Associate Professor,1504,863,2367
38662,Anthia,Rippin,arippinac@fda.gov,Mechanical Systems Engineer,7930,1902,9832
38562,Grissel,Alu,galuad@bravesites.com,Physical Therapy Assistant,2157,1136,3293
38393,Nariko,Wills,nwillsaf@mozilla.org,GIS Technical Architect,4007,1564,5571
38086,Jena,De Courtney,jdecourtneyah@goo.gl,Safety Technician I,7624,1055,8679
38092,Lizabeth,Caines,lcainesai@github.com,Graphic Designer,7931,457,8388
38753,Filippa,Castelain,fcastelainaj@bluehost.com,Quality Control Specialist,3543,512,4055
38332,Odie,Trouncer,otrounceral@51.la,Chief Design Engineer,5174,725,5899
38784,Humbert,MacSporran,hmacsporranam@twitpic.com,Civil Engineer,3218,1834,5052
38577,Yurik,Derle,yderlean@reference.com,Staff Accountant I,6328,956,7284
38791,Rozamond,Feye,rfeyeao@comcast.net,Cost Accountant,7504,1510,9014
38018,Lorie,Waddicor,lwaddicoraq@wikia.com,Chief Design Engineer,9375,697,10072
38010,Brand,Bullick,bbullickas@comcast.net,Help Desk Operator,5649,1883,7532
38774,Stanfield,Broz,sbrozat@marketwatch.com,Internal Auditor,9047,749,9796
38868,Caryl,Harvie,charvieau@mlb.com,Civil Engineer,4000,1184,5184
38356,Rosalind,Crim,rcrimav@blogspot.com,Nurse,3266,1452,4718
38177,Whitney,Knill,wknillaw@craigslist.org,Account Executive,3795,1435,5230
38353,Adora,Gwynn,agwynnax@hugedomains.com,Nurse,7015,1886,8901
38037,Greer,Vowells,gvowellsay@fastcompany.com,Systems Administrator I,9787,1260,11047
38262,Hyacinthia,De Cleyne,hdecleyneaz@nih.gov,Payment Adjustment Coordinator,2748,954,3702
38561,Janeen,Thormwell,jthormwellb1@yandex.ru,Structural Engineer,3379,395,3774
38058,Dorine,Corthes,dcorthesb3@icq.com,Systems Administrator I,9319,297,9616
38979,Ernie,Branthwaite,ebranthwaiteb4@plala.or.jp,Executive Secretary,7087,1366,8453
38400,Leah,Guillotin,lguillotinb5@bloglovin.com,Quality Control Specialist,3659,618,4277
38530,Sigrid,Whiteford,swhitefordb6@springer.com,Sales Representative,9369,936,10305
38779,Clim,Size,csizeb7@mapy.cz,Registered Nurse,9994,760,10754
38527,Locke,Rennles,lrennlesb8@wordpress.com,Desktop Support Technician,1797,1349,3146
38326,Lynnette,Bynold,lbynoldb9@ustream.tv,Analog Circuit Design manager,7080,1076,8156
38514,Brena,Darcey,bdarceybc@google.ca,Chemical Engineer,8526,756,9282
38900,Desirae,Frowen,dfrowenbd@seesaa.net,Accounting Assistant IV,9231,670,9901
38765,Alissa,Sprigings,asprigingsbf@si.edu,Programmer Analyst II,1669,1821,3490
38880,Reinaldos,Mynard,rmynardbi@bloomberg.com,Actuary,7150,905,8055
38947,Nicol,Murrells,nmurrellsbj@fda.gov,Paralegal,5486,1666,7152
38467,Derrek,Pail,dpailbl@unc.edu,Recruiter,1386,1842,3228
38488,Vonni,Brislen,vbrislenbm@cam.ac.uk,Tax Accountant,1958,220,2178
38336,Mary,Toulmin,mtoulminbq@booking.com,Project Manager,1178,1070,2248
38044,Joela,Johnsson,jjohnssonbr@timesonline.co.uk,Cost Accountant,2643,1260,3903
38274,Gayle,Linfoot,glinfootbs@so-net.ne.jp,Account Executive,2220,1082,3302
38367,Adora,Gotts,agottsbt@vistaprint.com,Assistant Professor,3081,996,4077
38375,Langsdon,Winchurst,lwinchurstbv@privacy.gov.au,Internal Auditor,7007,1436,8443
38703,Meagan,Yesenin,myeseninbw@newsvine.com,Analog Circuit Design manager,6055,1179,7234
38888,Jillane,Trotton,jtrottonbx@sciencedaily.com,Account Representative II,5798,224,6022
38584,Corney,Attwell,cattwellby@nsw.gov.au,Software Engineer III,2882,350,3232
38541,Adrian,Blais,ablaisc0@telegraph.co.uk,Nurse,8000,1232,9232
38021,Liuka,Dunham,ldunhamc1@tinyurl.com,Actuary,4369,1370,5739
38144,Bruis,Witt,bwittc2@tmall.com,Product Engineer,3451,1775,5226
38532,Pietrek,Farlow,pfarlowc4@etsy.com,Chief Design Engineer,8957,1804,10761
38014,Kathryn,Lutsch,klutschc5@economist.com,Dental Hygienist,8271,1950,10221
38598,Katalin,Petrakov,kpetrakovc6@dot.gov,Help Desk Technician,1910,666,2576
38818,Allix,Claus,aclausc7@apple.com,Geological Engineer,7908,1405,9313
38526,Dan,Charlon,dcharlonc9@webs.com,Programmer IV,2291,1054,3345
38975,Shaylyn,Binnell,sbinnellca@time.com,Product Engineer,9357,254,9611
38616,Alexi,Slocom,aslocomcb@chicagotribune.com,Help Desk Operator,8253,1378,9631
38713,Amandie,Harmond,aharmondcc@shareasale.com,Help Desk Technician,8811,397,9208
38302,Myca,Valdes,mvaldesce@com.com,Cost Accountant,5145,1350,6495
38236,Sammie,Caselick,scaselickcj@google.co.uk,Safety Technician III,7121,1616,8737
38149,Mary,Heineking,mheinekingcl@kickstarter.com,Tax Accountant,8905,1188,10093
38334,Jojo,Pichmann,jpichmanncm@digg.com,Staff Scientist,2893,482,3375
38797,Berton,Roblou,brobloucn@apache.org,Business Systems Development Analyst,5212,1838,7050
38968,Kalil,Isaacson,kisaacsonco@comcast.net,Operator,5995,1581,7576
38445,Odilia,Leve,olevecq@bloomberg.com,Recruiter,8410,308,8718
38886,Norene,Armiger,narmigercr@soup.io,Graphic Designer,9964,1635,11599
38258,Gerry,Pannaman,gpannamancs@cafepress.com,Help Desk Technician,3615,1108,4723
38105,Leighton,Toal,ltoalcv@rediff.com,Senior Sales Associate,7378,881,8259
38974,Mikaela,Wedderburn,mwedderburncw@miitbeian.gov.cn,Geological Engineer,2434,813,3247
38709,Wenda,Di Pietro,wdipietrocy@nature.com,Marketing Manager,2671,1352,4023
38020,Brinna,Overstall,boverstallcz@redcross.org,Analyst Programmer,9442,1558,11000
38422,Sallie,Henlon,shenlond0@ftc.gov,Compensation Analyst,2606,1994,4600
38194,Camala,Rusling,cruslingd1@meetup.com,Payment Adjustment Coordinator,1543,1389,2932
38006,Doy,Walford,dwalfordd3@squidoo.com,Software Engineer III,8292,468,8760
38351,Oralle,Lavery,olaveryd4@tuttocitta.it,Internal Auditor,4224,430,4654
38152,Hughie,Cajkler,hcajklerd5@wikipedia.org,Research Nurse,8850,1232,10082
38321,Nate,Gregorin,ngregorind7@globo.com,Media Manager III,6909,570,7479
38434,Pavia,Bysshe,pbysshed8@ycombinator.com,Staff Scientist,9692,1951,11643
38395,Sherline,Dufaur,sdufaurd9@hud.gov,Paralegal,5615,521,6136
38903,Katlin,Lett,klettda@xing.com,Pharmacist,1696,1379,3075
38967,Vivi,Willoway,vwillowaydb@yellowpages.com,Business Systems Development Analyst,1242,1856,3098
38599,Bendick,Lampert,blampertdd@over-blog.com,Registered Nurse,6003,663,6666
38308,Galen,Casini,gcasinide@t-online.de,Accounting Assistant I,8649,1993,10642
38677,Elsy,Lillgard,elillgarddf@cam.ac.uk,Software Test Engineer IV,2703,721,3424
38287,Augustine,Spain,aspaindg@tumblr.com,Marketing Assistant,9074,1253,10327
38718,Fran,Penke,fpenkedi@xing.com,Nurse,9723,1543,11266
38653,Vincent,Tack,vtackdj@so-net.ne.jp,VP Sales,7672,656,8328
38680,Any,Fawthrop,afawthropdl@army.mil,Marketing Manager,1086,1972,3058
38714,Nanni,Bemment,nbemmentdm@dion.ne.jp,Junior Executive,2167,1848,4015
38166,Vivianna,Bonsul,vbonsuldn@elegantthemes.com,Structural Engineer,5225,1935,7160
38378,Dela,Trowbridge,dtrowbridgedo@drupal.org,Recruiting Manager,7984,444,8428
38597,Dianne,Kobke,dkobkedp@google.ca,Budget/Accounting Analyst III,2441,349,2790
38168,Skipton,Skirven,sskirvendq@who.int,Product Engineer,4580,962,5542
38102,Sigmund,Palethorpe,spalethorpedr@imageshack.us,Financial Advisor,1023,799,1822
38622,Kirstyn,Ladlow,kladlowdt@quantcast.com,Assistant Manager,9084,1620,10704
38452,Eward,Snelson,esnelsondu@jiathis.com,Senior Editor,5753,1489,7242
38407,Marilee,Losebie,mlosebiedw@sogou.com,Statistician I,5176,233,5409
38314,Rozanna,Scullin,rscullindx@bloomberg.com,Pharmacist,2431,1618,4049
38328,Burke,Downgate,bdowngatedy@php.net,Software Test Engineer II,7315,1301,8616
38392,William,Greenrde,wgreenrdedz@slideshare.net,Research Associate,7874,1583,9457
38228,Silvio,Westbury,swestburye2@ibm.com,Health Coach III,9499,1961,11460
38907,Kailey,Wildber,kwildbere5@rambler.ru,Marketing Manager,6115,262,6377
38153,Kerrin,Vere,kveree6@google.com.hk,Community Outreach Specialist,8331,904,9235
38368,Lucia,Barhams,lbarhamse7@myspace.com,Environmental Specialist,4924,745,5669
38645,Bernhard,Tooher,btoohere8@upenn.edu,Staff Accountant III,6292,944,7236
38624,Roselle,Parell,rparelle9@answers.com,Analyst Programmer,1775,1568,3343
38421,Skip,Rigeby,srigebyea@wix.com,Analyst Programmer,3595,1501,5096
38858,Libbie,Amies,lamiesec@mysql.com,Professor,7512,271,7783
38386,Kurt,Wimms,kwimmsef@census.gov,Payment Adjustment Coordinator,1220,389,1609
38686,Karlens,Whitwell,kwhitwelleg@reverbnation.com,Software Engineer III,5142,1481,6623
38637,Natalya,Hanster,nhanstereh@hao123.com,Technical Writer,1860,1507,3367
38083,Petey,Lodo,plodoei@chronoengine.com,Director of Sales,2732,1256,3988
38249,Liane,Cronchey,lcroncheyek@pbs.org,Senior Financial Analyst,1742,1286,3028
38161,Pet,Fairbairn,pfairbairneo@blogtalkradio.com,Food Chemist,4564,1859,6423
38613,Lammond,Rowlin,lrowlineq@wufoo.com,Recruiting Manager,7867,995,8862
38207,Niall,Mahedy,nmahedyes@princeton.edu,General Manager,4238,1965,6203
38764,Ryley,McCurley,rmccurleyet@cnet.com,Programmer II,1549,595,2144
38811,Aluino,Cutridge,acutridgeew@archive.org,Accounting Assistant III,5399,1753,7152
38397,Chucho,Moat,cmoatey@bandcamp.com,Compensation Analyst,6479,649,7128
38243,Barris,Lidyard,blidyardez@storify.com,Payment Adjustment Coordinator,7947,1509,9456
38682,Gilberta,Harmour,gharmourf1@pcworld.com,Director of Sales,4758,895,5653
38048,Myrwyn,Oakinfold,moakinfoldf3@theguardian.com,VP Product Management,4446,812,5258
38655,Chloe,Mathivon,cmathivonf4@apache.org,Director of Sales,5107,1040,6147
38465,Annabel,Passion,apassionf6@nsw.gov.au,Accounting Assistant II,1904,1059,2963
38819,Lanita,Briztman,lbriztmanf8@aol.com,Computer Systems Analyst I,9094,538,9632
38587,Mikol,Dwane,mdwanefb@nydailynews.com,Internal Auditor,7573,243,7816
38556,Marnia,Ferriman,mferrimanfc@scientificamerican.com,Automation Specialist I,3231,1112,4343
38619,Helene,Ply,hplyfd@netvibes.com,Sales Representative,6828,1823,8651
38835,Casandra,Bartrum,cbartrumfe@naver.com,Speech Pathologist,8507,1319,9826
38499,Cherice,Torry,ctorryfg@edublogs.org,Accounting Assistant II,5017,1696,6713
38481,Tybi,Glauber,tglauberfh@shareasale.com,Payment Adjustment Coordinator,5340,1276,6616
38915,Theodoric,Battyll,tbattyllfj@marriott.com,Help Desk Technician,5316,1712,7028
38503,Cosette,Jeggo,cjeggofm@opensource.org,Senior Cost Accountant,3460,586,4046
38560,Aura,Ruck,aruckfn@discuz.net,Assistant Manager,1622,359,1981
38299,Vidovik,Anstee,vansteefo@furl.net,Food Chemist,6286,1402,7688
38821,Portie,Dullingham,pdullinghamfp@umn.edu,Media Manager II,8146,957,9103
38496,Chaim,Rabl,crablfs@cnbc.com,Developer II,1410,1905,3315
38486,Torrence,Granger,tgrangerft@weather.com,Accounting Assistant I,5793,847,6640
38385,Jayme,Lyster,jlysterfv@go.com,Senior Quality Engineer,2094,214,2308
38963,Tabor,Arrighini,tarrighinify@salon.com,Design Engineer,8933,934,9867
38479,Giana,Wall,gwallfz@state.tx.us,Operator,6093,1843,7936
38636,Lionel,Clemow,lclemowg0@epa.gov,Engineer IV,9645,1682,11327
38630,Eyde,Shelf,eshelfg2@networksolutions.com,Executive Secretary,1637,510,2147
38876,Rowena,Stonary,rstonaryg3@imageshack.us,Community Outreach Specialist,3390,510,3900
38555,Xenia,Smiley,xsmileyg4@stumbleupon.com,Recruiting Manager,3873,1290,5163
38051,Dianemarie,Lonsdale,dlonsdaleg8@fda.gov,Marketing Assistant,9617,281,9898
38447,Rita,Ewen,reweng9@stumbleupon.com,Desktop Support Technician,2193,1038,3231
38267,Oates,Roscamps,oroscampsga@vk.com,Operator,9123,1207,10330
38845,Tadd,von Grollmann,tvongrollmanngb@feedburner.com,Accounting Assistant I,3904,1628,5532
38822,Melvyn,Littledyke,mlittledykegc@pen.io,Payment Adjustment Coordinator,2075,687,2762
38457,Jaimie,Purdy,jpurdyge@cyberchimps.com,VP Product Management,3089,270,3359
38777,Renelle,Stollenhof,rstollenhofgf@g.co,Financial Analyst,4079,902,4981
38453,Sabrina,Maxsted,smaxstedgg@smugmug.com,Software Test Engineer IV,5561,1013,6574
38063,Cordell,Petts,cpettsgj@1und1.de,Chemical Engineer,7319,1580,8899
38406,Quincy,Brockley,qbrockleygl@omniture.com,Nurse,1465,484,1949
38409,Rosetta,Philcock,rphilcockgm@tumblr.com,Help Desk Technician,7883,709,8592
38553,Trudey,Hayworth,thayworthgo@weibo.com,Research Assistant I,4390,1360,5750
38309,Ardine,Raysdale,araysdalegq@multiply.com,Health Coach I,3937,1725,5662
38928,Bert,Buscher,bbuschergs@mozilla.org,GIS Technical Architect,9213,1299,10512
38589,Floyd,Doumerque,fdoumerquegt@sogou.com,Human Resources Manager,1401,1121,2522
38203,Barnaby,Bugg,bbugggw@oracle.com,Account Representative III,5258,1518,6776
38379,Papagena,Bitchener,pbitchenergy@yandex.ru,GIS Technical Architect,3999,613,4612
38904,Penni,Garter,pgarterh0@multiply.com,Legal Assistant,1895,929,2824
38585,Tobit,Pavlovic,tpavlovich1@sbwire.com,Dental Hygienist,7620,1170,8790
38269,Tarrah,Stickney,tstickneyh2@dailymail.co.uk,Operator,8692,1341,10033
38294,Feodor,Moxon,fmoxonh3@timesonline.co.uk,Developer II,5824,1845,7669
38090,Shellie,Coventry,scoventryh5@cloudflare.com,Computer Systems Analyst II,4447,1531,5978
38082,Ransom,Axelby,raxelbyh6@miibeian.gov.cn,Database Administrator IV,4170,1121,5291
38298,Gloriane,Cammiemile,gcammiemileh7@virginia.edu,Help Desk Operator,9305,774,10079
38125,Cullie,Ovesen,covesenha@nsw.gov.au,Nurse,2732,503,3235
38420,Duky,Van der Kruijs,dvanderkruijshb@chronoengine.com,Community Outreach Specialist,4381,1184,5565
38756,Blanca,Eccleston,becclestonhc@domainmarket.com,Health Coach I,2342,1317,3659
38640,Barry,Linham,blinhamhe@dell.com,Senior Quality Engineer,3378,278,3656
38908,Chantalle,Carberry,ccarberryhg@naver.com,Cost Accountant,5530,938,6468
38520,Phebe,Tow,ptowhi@themeforest.net,Computer Systems Analyst IV,5351,1131,6482
38611,Eddy,Becken,ebeckenhj@discovery.com,Database Administrator IV,1582,595,2177
38656,Lilly,Salmons,lsalmonshk@purevolume.com,Clinical Specialist,9611,303,9914
38388,Ulrikaumeko,Joris,ujorishm@taobao.com,Tax Accountant,6572,1256,7828
38695,Brigg,Lechmere,blechmerehn@bluehost.com,Research Nurse,8606,667,9273
38543,Rora,Wattingham,rwattinghamho@twitter.com,Systems Administrator I,7325,241,7566
38545,Trixi,Normanvill,tnormanvillhq@nba.com,Senior Cost Accountant,5748,1555,7303
38382,Charlotte,Hannigan,channiganhr@usatoday.com,Junior Executive,2221,1247,3468
38548,Axe,Vautre,avautreht@whitehouse.gov,Biostatistician IV,7575,593,8168
38390,Donal,Hymor,dhymorhu@last.fm,Marketing Assistant,6956,1961,8917
38982,Kass,Arrell,karrellhv@wordpress.com,Software Test Engineer I,2015,349,2364
38376,Iona,Castree,icastreehw@rakuten.co.jp,Research Assistant I,6707,674,7381
38533,Billi,Bowler,bbowlerhx@wikia.com,Assistant Professor,7562,1366,8928
38722,Patricio,Gahagan,pgahagani1@elpais.com,Safety Technician IV,4539,511,5050
38156,Shae,Digman,sdigmani7@t.co,Statistician II,5811,1323,7134
38477,Seumas,Peplay,speplayi9@gnu.org,Web Designer II,5534,979,6513
38374,Almeria,Bayston,abaystonif@columbia.edu,Payment Adjustment Coordinator,3675,1042,4717
38966,Philomena,McKune,pmckuneih@springer.com,Chemical Engineer,4308,1788,6096
38977,Vernen,Muscroft,vmuscroftii@newyorker.com,Clinical Specialist,5087,949,6036
38847,Lyndsey,Sherewood,lsherewoodij@wufoo.com,Clinical Specialist,8207,763,8970
38877,Broddie,Klimczak,bklimczakil@youku.com,Quality Control Specialist,3080,1631,4711
38989,Emmye,Langabeer,elangabeerim@miitbeian.gov.cn,Professor,6668,1542,8210
38733,Fraser,Gerson,fgersonip@bloglovin.com,Software Test Engineer I,4454,880,5334
38583,Alphard,Diable,adiableiq@yolasite.com,Paralegal,9900,1554,11454
38340,Meggy,Wanden,mwandenir@huffingtonpost.com,Sales Associate,4619,859,5478
38725,Richart,Hugues,rhuguesit@springer.com,Structural Analysis Engineer,4281,1035,5316
38191,Weidar,Hartnup,whartnupiv@odnoklassniki.ru,Clinical Specialist,9876,1633,11509
38618,Sanderson,Chell,schellix@msn.com,Assistant Media Planner,8853,1001,9854
38147,Willard,Staines,wstainesiy@hp.com,Nurse,8042,508,8550
38482,Mindy,Kynan,mkynanj0@purevolume.com,Financial Advisor,9717,1270,10987
38134,Katheryn,MacGiolla Pheadair,kmacgiollapheadairj1@chron.com,Registered Nurse,4175,1309,5484
38906,Ninon,Durnall,ndurnallj3@dot.gov,Geological Engineer,8457,1907,10364
38330,Gae,Cullinan,gcullinanj4@prweb.com,Senior Developer,9961,1650,11611
38146,Annmarie,Botly,abotlyj9@cdbaby.com,Chief Design Engineer,2462,1062,3524
38117,Alyss,Nelthorpe,anelthorpeja@yahoo.com,Automation Specialist IV,7989,1367,9356
38817,Brianna,Edmett,bedmettjc@so-net.ne.jp,Tax Accountant,1512,1073,2585
38911,Livvy,Wheowall,lwheowalljd@newyorker.com,Developer III,1069,1154,2223
38578,Efren,Pignon,epignonjf@rambler.ru,Software Engineer III,7665,1975,9640
38511,Joelie,Dymond,jdymondjg@usgs.gov,Clinical Specialist,4692,1155,5847
38423,Fidelia,O'Logan,fologanjk@hugedomains.com,Environmental Tech,6403,1910,8313
38264,Simona,Blackeby,sblackebyjl@flavors.me,Research Assistant IV,7944,314,8258
38405,Teodoro,MacCostigan,tmaccostiganjp@meetup.com,Executive Secretary,3897,642,4539
38676,Bryan,Tommasetti,btommasettijq@privacy.gov.au,Marketing Assistant,1645,1716,3361
38699,Cary,Dunmore,cdunmorejr@nytimes.com,Financial Analyst,2683,623,3306
38387,Angelika,Soff,asoffjt@mashable.com,Accountant I,1419,1734,3153
38043,Nadya,Synke,nsynkeju@cargocollective.com,GIS Technical Architect,2618,1659,4277
38015,Rivy,Conybear,rconybearjv@github.com,Legal Assistant,2744,1349,4093
38027,Dorey,Debling,ddeblingjw@technorati.com,Teacher,5242,819,6061
38139,Danika,Drable,ddrablejy@latimes.com,Quality Engineer,4673,1011,5684
38596,Elsinore,Hun,ehunjz@miitbeian.gov.cn,Pharmacist,9263,1203,10466
38060,Keary,McGaraghan,kmcgaraghank1@soundcloud.com,Mechanical Systems Engineer,2272,1548,3820
38040,Ches,Van den Velden,cvandenveldenk2@yellowbook.com,Nurse,9424,1341,10765
38329,Webb,Kleehuhler,wkleehuhlerk3@webs.com,Senior Developer,8084,1298,9382
38867,Babara,Espadate,bespadatek4@studiopress.com,Safety Technician IV,2609,591,3200
38810,Ingar,Rown,irownk6@phoca.cz,Research Nurse,4845,221,5066
38848,Orion,Figgs,ofiggska@noaa.gov,Geological Engineer,8642,1565,10207
38131,Reena,Luddy,rluddykb@discovery.com,Financial Analyst,8982,581,9563
38109,Marcelle,Sabben,msabbenkd@comcast.net,Technical Writer,1467,929,2396
38221,Lindsay,Fern,lfernkf@prlog.org,Senior Sales Associate,6775,1508,8283
38427,Ardra,Christal,achristalkk@yellowbook.com,Associate Professor,7863,294,8157
38962,Eugen,Hallt,ehalltkl@nsw.gov.au,Senior Quality Engineer,4856,1072,5928
38435,Dani,Cardew,dcardewko@moonfruit.com,Teacher,3577,676,4253
38140,Brion,Preene,bpreenekz@myspace.com,Research Nurse,5689,1499,7188
38910,Mikol,Moulster,mmoulsterl4@bloglines.com,Paralegal,8406,288,8694
38890,Hubey,Kegg,hkeggl5@imageshack.us,Registered Nurse,8713,1087,9800
38985,Maybelle,Richten,mrichtenl6@ebay.com,Assistant Media Planner,9478,527,10005
38673,Dena,Stainfield,dstainfieldlb@zimbio.com,Software Consultant,5449,451,5900
38957,Ilyse,Workes,iworkeslc@uiuc.edu,Project Manager,7808,298,8106
38227,Ophelie,Lithgow,olithgowle@phpbb.com,Computer Systems Analyst I,2449,517,2966
38942,Angele,Wittier,awittierlg@slashdot.org,Executive Secretary,8875,1824,10699
38337,Robinia,Moreing,rmoreinglh@live.com,Chief Design Engineer,4787,1454,6241
38441,Pippo,Grayne,pgrayneli@google.cn,Senior Quality Engineer,3677,256,3933
38546,Thadeus,Charkham,tcharkhamll@printfriendly.com,Senior Financial Analyst,2672,1936,4608
38325,Loleta,Rebbeck,lrebbeckln@bizjournals.com,Food Chemist,7534,1849,9383
38614,Blisse,Pellant,bpellantlo@comcast.net,Computer Systems Analyst III,9098,574,9672
38632,Pearce,Tewkesbury,ptewkesburylq@army.mil,Marketing Assistant,4588,913,5501
38306,Martelle,Domenichelli,mdomenichellilr@goo.gl,Assistant Media Planner,4073,1639,5712
38070,Dahlia,Boldt,dboldtls@forbes.com,Web Developer I,4909,372,5281
38225,Oralia,Meeus,omeeuslu@hostgator.com,Legal Assistant,3320,1459,4779
38208,Malanie,Gratrex,mgratrexlv@virginia.edu,Quality Engineer,8945,1427,10372
38485,Juieta,Skelly,jskellylw@soup.io,Data Coordiator,8350,1754,10104
38215,Linda,Coleridge,lcoleridgelx@meetup.com,Office Assistant III,3790,1589,5379
38763,Norine,Quinton,nquintonly@drupal.org,Marketing Manager,3881,1262,5143
38315,Payton,O'Tierney,potierneym0@umich.edu,Compensation Analyst,4538,1087,5625
38417,Wynne,McGarrahan,wmcgarrahanm1@mediafire.com,Research Nurse,5665,1987,7652
38528,Arvie,Shawley,ashawleym3@goo.gl,Engineer IV,8242,1738,9980
38310,Brand,Howood,bhowoodm7@sogou.com,Database Administrator II,8268,267,8535
38300,Keelby,Cliff,kcliffm9@cdbaby.com,Executive Secretary,3916,528,4444
38008,Tiffani,Kinloch,tkinlochmb@noaa.gov,VP Product Management,3460,795,4255
38790,Gaultiero,Yaus,gyausmd@fotki.com,Sales Representative,1032,880,1912
38913,Genevra,Gimson,ggimsonme@github.io,Staff Accountant II,4063,545,4608
38761,Dur,Battill,dbattillmg@buzzfeed.com,Budget/Accounting Analyst III,9155,1824,10979
38603,Pierette,Mellon,pmellonmh@phoca.cz,Financial Advisor,5219,464,5683
38800,Ermin,Blench,eblenchmk@gnu.org,Staff Scientist,5990,1677,7667
38282,Anselm,Reinmar,areinmarmm@nytimes.com,Account Representative IV,7966,1515,9481
38650,Kahlil,Instone,kinstonemo@imgur.com,Computer Systems Analyst I,1904,1621,3525
38219,Oralla,Hurst,ohurstms@jimdo.com,Food Chemist,9623,1355,10978
38884,Charlot,O' Cuolahan,cocuolahanmt@live.com,Human Resources Assistant II,3401,784,4185
38100,Reinaldos,Americi,ramericimz@google.com,Food Chemist,2603,1779,4382
38762,Alejandro,Beach,abeachn0@parallels.com,General Manager,5054,1045,6099
38504,Marlie,Welburn,mwelburnn3@chronoengine.com,Help Desk Technician,1399,1906,3305
38931,Patricio,Carvilla,pcarvillan4@cdbaby.com,Internal Auditor,9406,763,10169
38897,Benedick,Clyant,bclyantn5@canalblog.com,Electrical Engineer,5005,550,5555
38430,Sam,O'Monahan,somonahann7@stumbleupon.com,Legal Assistant,4871,390,5261
38099,Josephine,Kluss,jklussn8@umich.edu,Sales Representative,1273,997,2270
38464,Rustin,Overbury,roverburyna@theglobeandmail.com,Environmental Tech,4817,334,5151
38998,Federico,Voisey,fvoiseync@jigsy.com,Marketing Assistant,8380,785,9165
38094,Goldy,Feedham,gfeedhamnf@wired.com,Human Resources Manager,5885,1078,6963
38035,Tore,Mayberry,tmayberrynk@about.com,Environmental Specialist,1025,832,1857
38734,Debby,Kohen,dkohennl@cbsnews.com,VP Marketing,9812,542,10354
38736,Crystal,Prettyjohn,cprettyjohnno@si.edu,Sales Representative,2308,1466,3774
38357,Kassey,Ivory,kivorynq@exblog.jp,Biostatistician IV,2638,390,3028
38719,Laurel,Nolleth,lnollethns@mysql.com,VP Product Management,2687,371,3058
38828,Jody,Casetti,jcasettint@posterous.com,Community Outreach Specialist,5424,1508,6932
38542,Dulcia,Blakeley,dblakeleynx@paypal.com,Paralegal,5761,1899,7660
38071,Davide,Stud,dstudo1@illinois.edu,Librarian,5053,1956,7009
38856,Darrelle,Glaze,dglazeo9@youtu.be,Compensation Analyst,9701,939,10640
38795,Tito,Novacek,tnovacekoa@youtube.com,Administrative Assistant I,7513,679,8192
38573,Eilis,Gaitung,egaitungob@pagesperso-orange.fr,GIS Technical Architect,5630,1410,7040
38576,Melany,Crush,mcrushog@ca.gov,Registered Nurse,1282,1176,2458
38727,Jessalyn,Clousley,jclousleyoi@vimeo.com,Assistant Media Planner,8509,577,9086
38091,Benyamin,Butrimovich,bbutrimovichon@storify.com,Marketing Manager,4201,883,5084
38408,Hasty,Kuhne,hkuhneoo@uol.com.br,Physical Therapy Assistant,1081,1562,2643
38746,Skye,Nockells,snockellsop@ft.com,Programmer III,5531,236,5767
38263,Ophelia,Easum,oeasumor@sourceforge.net,Design Engineer,6256,874,7130
38950,Erwin,Trowsdall,etrowsdallot@shop-pro.jp,Recruiting Manager,8682,1218,9900
38997,Celie,Martinetto,cmartinettoov@slashdot.org,Human Resources Manager,3955,1612,5567
38660,Dania,Ginglell,dginglelloy@wired.com,Project Manager,1696,1210,2906
38257,Latisha,Arrington,larringtonoz@homestead.com,Social Worker,9545,1812,11357
38816,Timmy,Livett,tlivettp2@phpbb.com,Senior Sales Associate,1084,1148,2232
38805,Yolande,Lardner,ylardnerp8@cafepress.com,Developer IV,4161,1634,5795
38671,Thelma,Brocket,tbrocketp9@dagondesign.com,Community Outreach Specialist,1240,1983,3223
38899,Zea,Dowle,zdowlepa@vistaprint.com,Product Engineer,3420,378,3798
38248,Kiah,Noulton,knoultonpc@nyu.edu,Executive Secretary,4147,1458,5605
38444,Miller,Ludgate,mludgatepd@umich.edu,Automation Specialist IV,2048,1743,3791
38841,Godiva,Hawtin,ghawtinph@mozilla.com,Senior Sales Associate,2520,1129,3649
38981,Chancey,Kunz,ckunzpi@timesonline.co.uk,Electrical Engineer,4921,1824,6745
38061,Natasha,Petkovic,npetkovicpj@ehow.com,Environmental Specialist,3759,209,3968
38789,Natassia,Matthewes,nmatthewespm@nifty.com,Internal Auditor,5169,1553,6722
38270,Perrine,Kolin,pkolinpr@istockphoto.com,Operator,2539,1252,3791
38852,Pattie,Norvell,pnorvellpt@bigcartel.com,Environmental Tech,6625,949,7574
38038,Roseline,Parsons,rparsonspv@washingtonpost.com,Administrative Officer,4541,1292,5833
38256,Marv,Schuler,mschulerpw@parallels.com,Speech Pathologist,3894,1665,5559
38114,Wilma,Rockhall,wrockhallpz@mapy.cz,Assistant Media Planner,5164,1374,6538
38626,Mildred,Revens,mrevensq0@typepad.com,Graphic Designer,7148,1176,8324
38487,Winona,Arendt,warendtq4@cbc.ca,Help Desk Operator,5884,929,6813
38658,Noreen,Hendonson,nhendonsonqg@privacy.gov.au,Clinical Specialist,1612,543,2155
38960,Patric,Caplis,pcaplisqk@theatlantic.com,Statistician I,7320,460,7780
38707,Elden,Haith,ehaithqq@unc.edu,VP Marketing,5999,327,6326
38358,Conny,Reilinger,creilingerqr@ning.com,Librarian,6092,1848,7940
38364,August,Messiter,amessiterqs@sun.com,Actuary,1326,973,2299
38537,Dunc,Bigby,dbigbyqv@shutterfly.com,Account Executive,3719,1561,5280
38747,Britt,Winder,bwinderqy@marketwatch.com,Chief Design Engineer,8251,306,8557
38569,Robinett,Mickelwright,rmickelwrightr0@cafepress.com,Recruiter,2826,1795,4621
38715,Mahmud,Keatley,mkeatleyr2@studiopress.com,Civil Engineer,9988,795,10783
38538,Brandy,Bavester,bbavesterr6@rediff.com,Associate Professor,4095,1460,5555
38832,Humfried,Hassin,hhassinr7@tmall.com,Administrative Assistant II,6890,1323,8213
38976,Stanwood,Trude,struder8@theatlantic.com,Nurse Practicioner,2141,1321,3462
38712,Ceil,Castellanos,ccastellanosrh@google.pl,Graphic Designer,2024,1532,3556
38801,Noll,Huston,nhustonrj@intel.com,Operator,9943,494,10437
38579,Minna,Baudou,mbaudourk@qq.com,Community Outreach Specialist,1905,617,2522
38941,Graehme,Lewry,glewryrm@msu.edu,Help Desk Technician,2665,1849,4514
38212,Arvy,Dickey,adickeyrq@sciencedaily.com,Marketing Manager,3047,322,3369
38728,Kala,Swinley,kswinleyrr@themeforest.net,Human Resources Manager,1808,1239,3047
39132,Myrle,Riep,mriep0@usa.gov,Administrative Assistant I,8634,1841,10475
39173,Garland,Dummigan,gdummigan1@simplemachines.org,Financial Analyst,7222,1874,9096
39799,Jimmie,Mirrlees,jmirrlees2@netlog.com,Research Nurse,8634,1131,9765
39596,Charline,Terrazzo,cterrazzo3@wikimedia.org,Marketing Assistant,6776,1882,8658
39988,Martina,Nolda,mnolda4@plala.or.jp,Data Coordiator,1423,1023,2446
39850,Charin,Hub,chub5@chron.com,Senior Editor,7790,1412,9202
39498,Trudey,Georgeou,tgeorgeou6@tamu.edu,Information Systems Manager,4034,761,4795
39103,Blondy,Cogin,bcogin7@shinystat.com,Administrative Assistant I,1450,1277,2727
39520,Laurence,Dowey,ldowey8@gmpg.org,Electrical Engineer,5106,597,5703
39818,Konrad,Baldi,kbaldi9@dell.com,Teacher,3912,476,4388
39011,Shayne,Kelson,skelsona@tinyurl.com,Financial Analyst,4967,278,5245
39954,Rhea,Sillitoe,rsillitoeb@studiopress.com,Marketing Assistant,8963,1941,10904
39357,Torey,Fetters,tfettersc@ftc.gov,Cost Accountant,6692,893,7585
39130,Abdel,McNeilly,amcneillyd@seattletimes.com,Financial Advisor,8563,1914,10477
39908,Ebba,Dench,edenche@europa.eu,Safety Technician I,2339,281,2620
39821,Eddy,Linnell,elinnellf@infoseek.co.jp,Clinical Specialist,1019,1814,2833
39968,Christean,Yeliashev,cyeliashevg@guardian.co.uk,Electrical Engineer,9844,977,10821
39115,Cleon,Easter,ceasterh@upenn.edu,Occupational Therapist,3679,1289,4968
39019,Norean,Coomber,ncoomberi@printfriendly.com,Help Desk Operator,2060,1218,3278
39660,Vera,Matashkin,vmatashkinj@dedecms.com,Statistician II,6534,827,7361
39459,Itch,Franckton,ifrancktonk@howstuffworks.com,Environmental Tech,7347,623,7970
39526,Zedekiah,Castagne,zcastagnel@homestead.com,Dental Hygienist,3952,1324,5276
39093,Ruprecht,Cappleman,rcapplemanm@51.la,Environmental Tech,5326,796,6122
39583,Nathanil,Street,nstreetn@foxnews.com,Health Coach II,2245,1753,3998
39319,Alane,Buche,abuchep@51.la,Software Test Engineer II,1047,958,2005
39290,Ross,Dessent,rdessentq@google.it,Human Resources Manager,6229,564,6793
39613,Townsend,Paulig,tpauligr@wikipedia.org,VP Product Management,5542,1723,7265
39244,Michale,McGibbon,mmcgibbons@addthis.com,Executive Secretary,2581,1184,3765
39002,Oswell,Pentland,opentlandt@europa.eu,Assistant Professor,2929,606,3535
39617,Teodoor,Agge,taggeu@soup.io,Financial Analyst,9929,1421,11350
39568,Fran,Goch,fgochv@answers.com,Dental Hygienist,6276,1439,7715
39243,Inness,Poynser,ipoynserw@hatena.ne.jp,Structural Engineer,2617,1241,3858
39487,Eve,Balsillie,ebalsilliex@kickstarter.com,VP Marketing,6151,1100,7251
39554,Deni,Barwise,dbarwisey@amazon.co.jp,Quality Control Specialist,1138,457,1595
39781,Stacie,Josh,sjoshz@wiley.com,Speech Pathologist,3222,1065,4287
39003,Brynne,Ladds,bladds11@acquirethisname.com,Operator,1323,1387,2710
39667,Gallard,Mompesson,gmompesson12@sina.com.cn,Paralegal,5374,836,6210
39194,Annalee,Godar,agodar13@4shared.com,Occupational Therapist,6788,1274,8062
39198,Lisha,Lambersen,llambersen14@nyu.edu,Editor,3550,1235,4785
39386,Westley,Abade,wabade15@japanpost.jp,Data Coordiator,8010,1047,9057
39951,Marjy,Pleming,mpleming16@hao123.com,Web Designer II,7066,559,7625
39039,Berkly,Shephard,bshephard17@taobao.com,Cost Accountant,7086,1927,9013
39215,Redd,Langstrath,rlangstrath18@wp.com,Developer III,4800,1361,6161
39551,Devan,Spieck,dspieck19@soup.io,VP Product Management,4158,1320,5478
39448,Archibald,Battyll,abattyll1a@imgur.com,Compensation Analyst,1553,1323,2876
39547,Catlaina,Brasted,cbrasted1b@usnews.com,Senior Cost Accountant,7002,688,7690
39310,Ives,Humburton,ihumburton1c@tmall.com,Assistant Manager,9364,792,10156
39602,Joeann,Hanscom,jhanscom1d@edublogs.org,VP Sales,4025,772,4797
39845,Katherina,Kidwell,kkidwell1e@shutterfly.com,Desktop Support Technician,5055,810,5865
39941,Sybilla,de Guise,sdeguise1f@clickbank.net,Account Representative II,7125,710,7835
39829,Lolly,Keller,lkeller1g@fc2.com,Payment Adjustment Coordinator,2405,1272,3677
39816,Napoleon,Cartmel,ncartmel1h@indiegogo.com,Systems Administrator I,2050,1415,3465
39450,Lancelot,Hukins,lhukins1i@nytimes.com,Associate Professor,2034,1442,3476
39943,Ardella,Peebles,apeebles1j@dailymotion.com,Legal Assistant,2874,974,3848
39934,Adrian,Sedgebeer,asedgebeer1k@dell.com,Director of Sales,5921,1514,7435
39733,Shannan,Sweedland,ssweedland1m@hibu.com,Software Consultant,7426,1861,9287
39866,Bradford,Francombe,bfrancombe1n@dedecms.com,Environmental Specialist,6725,1972,8697
39996,Cherise,Stoggell,cstoggell1o@usgs.gov,General Manager,6887,1220,8107
39884,Kerby,Barca,kbarca1q@mysql.com,Teacher,8255,1569,9824
39874,Morse,De Pietri,mdepietri1r@canalblog.com,Developer III,4201,1943,6144
39980,Ban,Menendez,bmenendez1s@blogspot.com,Senior Financial Analyst,1674,935,2609
39535,Cahra,Shorto,cshorto1t@wunderground.com,Project Manager,9752,261,10013
39129,Stu,Collie,scollie1u@pinterest.com,Web Developer II,5620,1194,6814
39077,Terry,Cock,tcock1v@etsy.com,Database Administrator III,4329,1305,5634
39976,Jordan,Pohl,jpohl1w@aol.com,Web Developer IV,5416,1108,6524
39608,Dexter,Moulton,dmoulton1x@utexas.edu,Technical Writer,8352,1842,10194
39841,Skippy,Shepcutt,sshepcutt1y@oaic.gov.au,Analyst Programmer,6487,369,6856
39364,Mikael,Issakov,missakov1z@liveinternet.ru,Staff Scientist,1774,1078,2852
39187,Caro,Hollingdale,chollingdale20@free.fr,Nurse Practicioner,8926,646,9572
39147,Pauly,Vivians,pvivians21@umn.edu,Nurse Practicioner,5568,1021,6589
39586,Kinny,Mac Geaney,kmacgeaney22@imageshack.us,Professor,4463,677,5140
39047,Pegeen,Loffhead,ploffhead23@un.org,Senior Editor,4427,1151,5578
39191,Johnath,Regler,jregler24@virginia.edu,Operator,6135,240,6375
39793,Lind,Fery,lfery25@ameblo.jp,Dental Hygienist,8780,1877,10657
39548,Marissa,Moorcraft,mmoorcraft26@google.fr,Electrical Engineer,2688,218,2906
39852,Moe,Metzel,mmetzel27@altervista.org,Quality Control Specialist,2353,1665,4018
39576,Merissa,Hollingsbee,mhollingsbee28@apple.com,Paralegal,4923,1526,6449
39977,Leslie,Quodling,lquodling29@google.pl,Structural Engineer,6195,1124,7319
39485,Noelle,Totton,ntotton2a@github.io,Database Administrator II,9446,690,10136
39837,Lambert,Leuren,lleuren2b@odnoklassniki.ru,Professor,8877,737,9614
39159,Carr,Maypother,cmaypother2c@4shared.com,General Manager,3253,1207,4460
39176,Bette-ann,Fullstone,bfullstone2d@npr.org,Physical Therapy Assistant,6864,1538,8402
39970,Marlene,Mansfield,mmansfield2e@istockphoto.com,Sales Associate,1811,380,2191
39062,Silvanus,Ors,sors2f@cpanel.net,Occupational Therapist,9707,349,10056
39796,Portie,Quartermain,pquartermain2g@admin.ch,Media Manager IV,8617,1713,10330
39097,Mildred,Angood,mangood2h@free.fr,Pharmacist,7638,625,8263
39549,Millard,Yoselevitch,myoselevitch2i@reddit.com,Project Manager,7369,1147,8516
39849,Christiana,Downton,cdownton2j@yelp.com,Web Developer II,3061,1242,4303
39589,Nisse,Derricoat,nderricoat2k@elpais.com,Computer Systems Analyst II,5212,1704,6916
39493,Nertie,Youthead,nyouthead2l@umich.edu,Engineer IV,7234,414,7648
39772,Hansiain,Roth,hroth2m@latimes.com,Desktop Support Technician,2098,1576,3674
39925,Hershel,Yesichev,hyesichev2n@ucoz.ru,Budget/Accounting Analyst I,6253,1439,7692
39286,Ian,Keat,ikeat2o@springer.com,Accountant II,2526,1511,4037
39222,Rolf,Ovenell,rovenell2p@oracle.com,Budget/Accounting Analyst III,5532,917,6449
39754,Benjamin,Blaylock,bblaylock2q@shutterfly.com,Automation Specialist II,2731,868,3599
39414,Dale,Ashleigh,dashleigh2s@google.cn,Operator,3025,527,3552
39795,Leeland,Byford,lbyford2t@uol.com.br,Help Desk Operator,6325,1364,7689
39591,Abbi,Druhan,adruhan2u@moonfruit.com,Account Executive,9773,1299,11072
39741,Suki,Anders,sanders2v@meetup.com,Research Assistant III,8079,1486,9565
39291,Gasper,Isaksen,gisaksen2w@xinhuanet.com,Technical Writer,5608,1268,6876
39252,Malynda,McCarty,mmccarty2x@bloglines.com,VP Accounting,2729,1002,3731
39462,Abigale,Hallyburton,ahallyburton2y@addthis.com,Health Coach III,4171,1494,5665
39027,Eldridge,Faint,efaint30@ucsd.edu,Analog Circuit Design manager,2456,725,3181
39043,Silvia,Babb,sbabb31@pinterest.com,Assistant Professor,3474,1163,4637
39067,Kally,Ben,kben32@sfgate.com,Financial Advisor,2025,844,2869
39230,Dion,Cubbon,dcubbon34@dell.com,Systems Administrator I,9129,1569,10698
39834,Brittney,Sommerled,bsommerled35@google.co.uk,Business Systems Development Analyst,4828,595,5423
39053,Shelton,Byatt,sbyatt37@networkadvertising.org,Media Manager IV,9385,496,9881
39634,Cary,Tite,ctite38@economist.com,Operator,4464,1969,6433
39947,Reyna,Matushevitz,rmatushevitz39@deviantart.com,Senior Quality Engineer,3971,1228,5199
39753,Shani,MacGiany,smacgiany3a@angelfire.com,Accounting Assistant III,5569,1873,7442
39719,Montague,Rawet,mrawet3b@newsvine.com,Programmer II,5173,1813,6986
39150,Penelopa,Grewcock,pgrewcock3c@squarespace.com,Senior Cost Accountant,6994,758,7752
39745,Shel,Plevin,splevin3d@google.it,Chief Design Engineer,7485,1304,8789
39106,Northrop,Back,nback3e@blogspot.com,Nurse Practicioner,8680,994,9674
39249,Gilbert,Haskins,ghaskins3f@nifty.com,Help Desk Technician,2706,849,3555
39016,Fidelity,Moyle,fmoyle3g@sitemeter.com,Information Systems Manager,6282,494,6776
39125,Chuck,Beglin,cbeglin3h@skype.com,Graphic Designer,5848,489,6337
39592,Giff,Ewdale,gewdale3i@phpbb.com,Structural Analysis Engineer,9749,258,10007
39055,Rowney,Messent,rmessent3j@usnews.com,Desktop Support Technician,4483,641,5124
39599,Ardisj,Figura,afigura3k@uol.com.br,Occupational Therapist,8000,856,8856
39636,Lila,Fruchter,lfruchter3l@ucoz.com,Analyst Programmer,6613,1345,7958
39657,Sonnnie,Le Frank,slefrank3m@nytimes.com,Senior Quality Engineer,1046,1862,2908
39625,Hedvig,Thomasson,hthomasson3n@istockphoto.com,Recruiter,1456,1914,3370
39195,Cob,McRobb,cmcrobb3o@ihg.com,Social Worker,2907,1174,4081
39172,Sula,Iffe,siffe3p@networkadvertising.org,Biostatistician I,1062,718,1780
39873,Jacklyn,Rennebach,jrennebach3q@cnn.com,Desktop Support Technician,2895,1193,4088
39318,Eileen,Kerman,ekerman3r@bbb.org,Analyst Programmer,4966,631,5597
39210,Robyn,Ransbury,rransbury3s@simplemachines.org,Safety Technician I,5678,1916,7594
39412,Kathryn,Boddie,kboddie3t@instagram.com,Automation Specialist I,1933,725,2658
39404,Reginald,McKellen,rmckellen3u@ca.gov,Computer Systems Analyst I,4631,611,5242
39421,Paolina,Rodgers,prodgers3v@trellian.com,Payment Adjustment Coordinator,9866,446,10312
39131,Nanny,Faircloth,nfaircloth3w@umn.edu,Human Resources Manager,9656,1757,11413
39303,Blisse,Johananoff,bjohananoff3x@wordpress.com,Teacher,7033,526,7559
39099,Derwin,Danbrook,ddanbrook3y@vistaprint.com,Clinical Specialist,9438,1105,10543
39142,Misty,Eggleston,meggleston40@ihg.com,Compensation Analyst,1010,1439,2449
39276,Trix,Grinyer,tgrinyer41@princeton.edu,Engineer II,8109,1355,9464
39542,Roseann,Giblin,rgiblin42@ebay.co.uk,Programmer Analyst I,8025,1697,9722
39472,Marlee,Barrar,mbarrar43@trellian.com,Accounting Assistant II,8845,1701,10546
39250,Mab,Castelletti,mcastelletti44@sohu.com,Occupational Therapist,9058,732,9790
39242,Clotilda,Hammersley,chammersley45@mediafire.com,Developer IV,5478,1395,6873
39752,Tonye,Allcoat,tallcoat46@mac.com,Systems Administrator III,5824,986,6810
39861,Louis,Sommerlin,lsommerlin47@hud.gov,Operator,5711,1799,7510
39765,Mikel,Frarey,mfrarey48@acquirethisname.com,Cost Accountant,9277,1141,10418
39118,Kerk,Sodeau,ksodeau49@mysql.com,Pharmacist,2616,502,3118
39686,Gloria,Busch,gbusch4a@aol.com,Quality Control Specialist,5890,1833,7723
39904,Owen,Durrett,odurrett4b@indiatimes.com,Registered Nurse,6500,874,7374
39906,Sunny,Katte,skatte4d@last.fm,Graphic Designer,7593,842,8435
39213,Theodor,Phizakarley,tphizakarley4e@yelp.com,Nurse,8321,1563,9884
39997,Luisa,Glentz,lglentz4g@fda.gov,Safety Technician IV,4182,266,4448
39543,Federico,Bloy,fbloy4h@devhub.com,Nuclear Power Engineer,4006,1802,5808
39697,Catlee,Sier,csier4i@behance.net,Technical Writer,7920,1087,9007
39022,Quint,Yoselevitch,qyoselevitch4j@joomla.org,Social Worker,6655,457,7112
39326,Isadore,Mott,imott4k@cisco.com,Clinical Specialist,5051,1870,6921
39896,Abraham,Tieman,atieman4n@mozilla.org,Quality Engineer,6190,1806,7996
39926,Layney,Redfield,lredfield4o@facebook.com,Junior Executive,1603,1556,3159
39091,Sheffie,Dowling,sdowling4p@dailymail.co.uk,Actuary,3275,1360,4635
39961,Myer,Mowling,mmowling4q@linkedin.com,Developer I,8752,1261,10013
39610,Kalli,Fosse,kfosse4r@de.vu,Developer III,6811,1390,8201
39725,Ritchie,Densumbe,rdensumbe4s@ted.com,Desktop Support Technician,4933,948,5881
39786,Whittaker,Faich,wfaich4t@sphinn.com,Tax Accountant,9758,989,10747
39439,Mamie,Selcraig,mselcraig4u@jigsy.com,Senior Financial Analyst,7624,1359,8983
39264,Clem,Vedeneev,cvedeneev4w@shinystat.com,Analyst Programmer,3384,1390,4774
39567,Ewen,Balchen,ebalchen4x@biblegateway.com,GIS Technical Architect,6643,1832,8475
39774,Abbe,Schapiro,aschapiro4y@mozilla.com,Administrative Officer,9338,1208,10546
39392,Alejandro,Lorenzetti,alorenzetti51@chron.com,Mechanical Systems Engineer,2887,1648,4535
39013,Matthew,Ciccottini,mciccottini53@canalblog.com,Accounting Assistant III,4147,794,4941
39635,Reinhold,Gallamore,rgallamore54@phoca.cz,Computer Systems Analyst III,2382,1895,4277
39021,Brnaba,Brunke,bbrunke55@businesswire.com,Sales Representative,7991,672,8663
39759,Brana,Pacquet,bpacquet56@google.it,Physical Therapy Assistant,2296,1548,3844
39018,Lamar,Cianni,lcianni57@independent.co.uk,Automation Specialist III,8759,575,9334
39096,Jimmie,Chezier,jchezier58@clickbank.net,Accountant IV,2643,1014,3657
39225,Nola,Munks,nmunks59@odnoklassniki.ru,Information Systems Manager,5302,1424,6726
39912,Shamus,Cardo,scardo5b@seesaa.net,Automation Specialist III,4053,1138,5191
39289,Jessica,Court,jcourt5c@booking.com,Nurse,7717,868,8585
39647,Tiena,Poulglais,tpoulglais5d@guardian.co.uk,Developer III,7961,707,8668
39791,Oswald,Hayton,ohayton5e@unblog.fr,Information Systems Manager,6899,1857,8756
39717,Ibby,Poutress,ipoutress5f@blogspot.com,Recruiter,9738,1579,11317
39846,Gaynor,Crocetto,gcrocetto5g@ameblo.jp,Business Systems Development Analyst,1104,1391,2495
39274,Merline,Lamplough,mlamplough5h@samsung.com,Electrical Engineer,6180,411,6591
39468,Lancelot,Elsby,lelsby5i@blogspot.com,VP Sales,2798,232,3030
39888,Jacqueline,Blum,jblum5j@amazon.co.jp,Legal Assistant,8038,1486,9524
39560,Jessey,Atteridge,jatteridge5k@webs.com,Accounting Assistant II,4231,1910,6141
39158,Mersey,Enterlein,menterlein5l@nps.gov,Senior Editor,7753,1863,9616
39758,Eugenia,Mastrantone,emastrantone5m@nbcnews.com,Administrative Assistant IV,3053,495,3548
39544,Franzen,Ragdale,fragdale5p@amazonaws.com,VP Sales,8727,667,9394
39059,Ferdie,O'Doghesty,fodoghesty5q@sourceforge.net,Operator,3598,1480,5078
39886,Philipa,Bolderstone,pbolderstone5r@google.it,Office Assistant I,5637,1865,7502
39321,Madelle,Spillard,mspillard5s@fotki.com,Internal Auditor,9125,1403,10528
39704,Vite,McMeekin,vmcmeekin5t@youku.com,Analyst Programmer,5239,549,5788
39949,Fons,Capinetti,fcapinetti5u@gnu.org,Environmental Tech,3618,680,4298
39166,Sharai,Brewer,sbrewer5v@nymag.com,Analog Circuit Design manager,9464,1509,10973
39445,Mateo,Phalip,mphalip5w@godaddy.com,Administrative Assistant IV,4456,1041,5497
39435,Hillery,Pavlata,hpavlata5x@naver.com,Librarian,6181,1269,7450
39279,Leticia,Wakely,lwakely5y@usda.gov,Payment Adjustment Coordinator,5303,248,5551
39507,Tomasine,Labbez,tlabbez5z@scribd.com,Software Engineer III,6501,1030,7531
39262,Cordelia,Linnitt,clinnitt60@dedecms.com,Budget/Accounting Analyst III,1747,1217,2964
39897,Wallis,Verheijden,wverheijden61@rediff.com,Systems Administrator II,1500,1123,2623
39756,Tomaso,Stegell,tstegell62@privacy.gov.au,Assistant Professor,8757,363,9120
39503,Abram,Normanvell,anormanvell63@huffingtonpost.com,Research Nurse,4603,1953,6556
39900,Sunny,Sparshett,ssparshett64@usatoday.com,Food Chemist,1990,1817,3807
39301,Thor,Cremins,tcremins65@globo.com,Electrical Engineer,5915,1065,6980
39496,Kirsti,Josefsohn,kjosefsohn67@wunderground.com,Quality Control Specialist,4323,681,5004
39956,Bel,Patifield,bpatifield68@xing.com,Software Engineer II,8826,1482,10308
39251,Eolanda,Alejandre,ealejandre69@yale.edu,VP Quality Control,3590,468,4058
39724,Andrew,Fairnington,afairnington6a@t-online.de,Office Assistant IV,9905,1074,10979
39946,Micah,Robardley,mrobardley6b@reuters.com,Account Executive,9120,1674,10794
39638,Gertie,Sans,gsans6f@e-recht24.de,Chief Design Engineer,1682,497,2179
39441,Tillie,Melmar,tmelmar6g@theglobeandmail.com,Developer II,2309,232,2541
39913,Nicky,Fishburn,nfishburn6h@mail.ru,Nuclear Power Engineer,2599,911,3510
39614,Oswald,Limprecht,olimprecht6i@cnet.com,Community Outreach Specialist,9609,659,10268
39844,Tim,Theaker,ttheaker6l@china.com.cn,Assistant Manager,4987,1154,6141
39026,Wilow,Capaldo,wcapaldo6m@paginegialle.it,Database Administrator IV,4502,994,5496
39094,Ibbie,Foskew,ifoskew6n@ustream.tv,VP Marketing,5743,1357,7100
39312,Caresa,Liston,cliston6o@dropbox.com,Database Administrator I,1845,1094,2939
39226,Jessi,Pont,jpont6p@google.de,Compensation Analyst,5862,639,6501
39615,Isidore,Sivior,isivior6q@miitbeian.gov.cn,Senior Developer,2857,624,3481
39234,Morten,Mohammed,mmohammed6r@twitter.com,Safety Technician IV,1719,1872,3591
39899,Ezmeralda,Halpine,ehalpine6s@unesco.org,Editor,7699,1308,9007
39986,Conny,Readman,creadman6t@geocities.jp,Financial Analyst,6507,1300,7807
39273,Valencia,Gutridge,vgutridge6u@nymag.com,Junior Executive,8120,1156,9276
39260,Ruthi,Cromb,rcromb6v@ning.com,Compensation Analyst,3922,702,4624
39692,Klarika,Farrah,kfarrah6w@histats.com,Cost Accountant,5504,569,6073
39521,Dani,Schneider,dschneider6x@delicious.com,Teacher,5532,956,6488
39744,Eddie,Traylen,etraylen70@senate.gov,Health Coach III,4928,600,5528
39122,Ewell,Greenan,egreenan71@elpais.com,Accountant I,8263,1303,9566
39590,Puff,Decent,pdecent72@photobucket.com,Programmer II,7731,499,8230
39024,Prisca,Matthius,pmatthius73@prnewswire.com,Operator,4987,1124,6111
39637,Devon,Rubinsaft,drubinsaft74@amazon.co.uk,Financial Advisor,8786,1325,10111
39031,Howard,Schaffler,hschaffler75@msu.edu,Environmental Tech,6460,1228,7688
39775,Sargent,Martine,smartine76@youku.com,Research Assistant II,3609,1522,5131
39740,Larine,Hurler,lhurler77@fotki.com,Assistant Media Planner,3231,554,3785
39990,Daren,McNelly,dmcnelly78@admin.ch,Design Engineer,7499,1053,8552
39722,Audie,Bartholomieu,abartholomieu79@netscape.com,Analog Circuit Design manager,1447,1707,3154
39718,Iggy,Roots,iroots7b@scribd.com,Actuary,3017,735,3752
39197,Ulrich,Bearman,ubearman7c@sina.com.cn,Software Consultant,2463,1373,3836
39025,Trenna,Fulton,tfulton7d@facebook.com,Analyst Programmer,5596,1562,7158
39296,Enriqueta,Markussen,emarkussen7e@mediafire.com,Web Designer I,6479,1807,8286
39620,Colin,Attride,cattride7f@paypal.com,Senior Cost Accountant,5294,723,6017
39905,Annie,Brangan,abrangan7h@g.co,Statistician I,5186,1991,7177
39239,Shannah,McGlue,smcglue7i@wikimedia.org,Accounting Assistant II,8227,1628,9855
39090,Marcelia,Honsch,mhonsch7j@bloomberg.com,Internal Auditor,5829,607,6436
39028,Trever,Fairn,tfairn7l@desdev.cn,Staff Scientist,9253,605,9858
39710,Jacquelyn,Vallentine,jvallentine7m@uol.com.br,Chemical Engineer,2126,1011,3137
39446,Bobby,Scriver,bscriver7o@reverbnation.com,Design Engineer,7278,1368,8646
39269,Dan,Meere,dmeere7p@amazonaws.com,Office Assistant III,9324,453,9777
39865,Caterina,Zannotelli,czannotelli7q@google.fr,Mechanical Systems Engineer,7865,1831,9696
39978,Papageno,Bixley,pbixley7s@oakley.com,Office Assistant I,9465,1666,11131
39679,Gus,Heaven,gheaven7u@hao123.com,Help Desk Technician,9800,926,10726
39035,Lexie,William,lwilliam7x@mapquest.com,Project Manager,2570,666,3236
39782,Gilbertina,Seabrook,gseabrook7y@digg.com,Executive Secretary,9886,1194,11080
39960,Craig,Lathwell,clathwell7z@yandex.ru,Quality Control Specialist,7076,474,7550
39174,Wayne,Sammes,wsammes80@moonfruit.com,VP Accounting,8731,348,9079
39208,Alane,Reolfo,areolfo81@newsvine.com,Research Assistant IV,8743,1462,10205
39167,Fabe,Colquhoun,fcolquhoun84@unc.edu,Internal Auditor,3293,1127,4420
39413,Erwin,Keggins,ekeggins85@trellian.com,Quality Engineer,8899,1897,10796
39175,Jilli,Matous,jmatous87@barnesandnoble.com,Safety Technician IV,2986,802,3788
39859,Lindy,McGrane,lmcgrane88@yahoo.co.jp,Food Chemist,4218,1604,5822
39394,Jacklyn,Dyte,jdyte89@a8.net,Nuclear Power Engineer,2649,1298,3947
39963,Dame,Klasen,dklasen8a@amazon.com,Systems Administrator II,8534,1508,10042
39116,Gino,Marjoribanks,gmarjoribanks8b@jimdo.com,Safety Technician IV,3455,647,4102
39069,Gaston,Pannett,gpannett8c@loc.gov,Junior Executive,8385,569,8954
39232,Zach,Beche,zbeche8e@webmd.com,Community Outreach Specialist,1892,1996,3888
39694,Reg,Baribal,rbaribal8f@fastcompany.com,Staff Scientist,8437,881,9318
39168,Stern,Milesap,smilesap8g@mysql.com,Account Coordinator,2810,1373,4183
39399,Ephrem,Denisard,edenisard8h@usa.gov,Engineer IV,5300,1602,6902
39297,Jarvis,Quinnet,jquinnet8i@amazon.com,Social Worker,5482,1308,6790
39618,Husain,Podd,hpodd8j@about.com,Human Resources Assistant IV,2456,981,3437
39004,Halsy,Todarini,htodarini8k@marketwatch.com,Accountant IV,1034,1363,2397
39651,Gabi,Taffie,gtaffie8l@moonfruit.com,Staff Accountant II,9833,738,10571
39851,Marnie,Lucks,mlucks8m@si.edu,Staff Accountant III,3469,683,4152
39145,Coralyn,Mapson,cmapson8p@home.pl,Electrical Engineer,2710,470,3180
39597,Frazier,Le Clercq,fleclercq8s@smugmug.com,Design Engineer,4843,1700,6543
39317,Nikolaos,Sword,nsword8t@microsoft.com,Programmer III,4122,1671,5793
39927,Kirbee,Braidon,kbraidon8u@diigo.com,Help Desk Operator,1522,1632,3154
39436,Simonne,Olley,solley8v@sfgate.com,Physical Therapy Assistant,6652,314,6966
39408,Merlina,Delos,mdelos8w@umn.edu,Civil Engineer,2321,351,2672
39872,Marthe,Andreasen,mandreasen8x@yandex.ru,Administrative Assistant IV,9191,578,9769
39438,Lyn,Domini,ldomini90@amazon.com,VP Quality Control,9682,1024,10706
39139,Gwennie,Greir,ggreir91@ehow.com,Information Systems Manager,8960,1621,10581
39892,Glendon,Dallender,gdallender92@marriott.com,Structural Engineer,3845,980,4825
39377,Kim,Neary,kneary94@etsy.com,VP Marketing,4871,709,5580
39057,Leanor,Swaffield,lswaffield98@wordpress.org,Senior Financial Analyst,9584,263,9847
39595,Bone,Whitworth,bwhitworth99@storify.com,Systems Administrator IV,8131,983,9114
39107,Reggis,Jereatt,rjereatt9a@wikia.com,Senior Developer,5808,1653,7461
39111,Pierette,Gasker,pgasker9b@addthis.com,Actuary,3361,508,3869
39266,Barbabas,Fawckner,bfawckner9c@cbsnews.com,Chemical Engineer,5419,1173,6592
39033,Lindy,Conlaund,lconlaund9d@constantcontact.com,VP Quality Control,1336,1625,2961
39491,Estel,Mogra,emogra9e@tripadvisor.com,Health Coach I,2470,1488,3958
39220,Raquela,Tills,rtills9f@stumbleupon.com,Librarian,9063,1314,10377
39933,Chaddie,Cuseck,ccuseck9g@google.com.hk,VP Sales,3830,1317,5147
39940,Ceciley,Armin,carmin9h@gnu.org,Account Coordinator,8321,1689,10010
39081,Willyt,McLean,wmclean9i@angelfire.com,Tax Accountant,5854,1215,7069
39619,Krystle,Bitcheno,kbitcheno9j@qq.com,Marketing Manager,5707,904,6611
39192,Lay,Moller,lmoller9k@webnode.com,Systems Administrator IV,1537,569,2106
39265,Russell,Vasquez,rvasquez9l@marriott.com,Legal Assistant,7752,1784,9536
39074,Barrie,Rockliffe,brockliffe9m@simplemachines.org,Quality Engineer,9159,1747,10906
39351,Wakefield,Comusso,wcomusso9n@gizmodo.com,Administrative Officer,6226,957,7183
39945,Cobby,Walesa,cwalesa9o@histats.com,VP Marketing,8182,1612,9794
39645,Melloney,Kewley,mkewley9q@businesswire.com,Office Assistant III,2771,1357,4128
39880,Kendall,Chateau,kchateau9r@cbc.ca,Account Representative II,1195,1932,3127
39546,Walker,Blundel,wblundel9t@ebay.co.uk,Quality Engineer,4934,1915,6849
39506,Angelico,Soggee,asoggee9u@pinterest.com,Product Engineer,1416,282,1698
39661,Bibbye,Tippell,btippell9v@mysql.com,Database Administrator IV,3760,316,4076
39309,Velvet,Camps,vcamps9w@newyorker.com,Cost Accountant,6071,575,6646
39598,Herculie,Robun,hrobun9y@jalbum.net,VP Sales,4605,1613,6218
39711,Kenton,Aldhous,kaldhous9z@bigcartel.com,Health Coach IV,8766,1073,9839
39254,Genevra,Jacquemy,gjacquemya1@sina.com.cn,Paralegal,1235,418,1653
39894,Maybelle,Baudry,mbaudrya2@shop-pro.jp,Senior Sales Associate,8227,994,9221
39738,Page,Pickance,ppickancea5@nhs.uk,Senior Sales Associate,9325,309,9634
39214,Aylmar,Halling,ahallinga6@theatlantic.com,Junior Executive,4259,228,4487
39721,Gerald,Swinfen,gswinfena8@xing.com,Civil Engineer,3380,1063,4443
39178,Gib,McEwen,gmcewena9@wsj.com,Speech Pathologist,2617,969,3586
39973,Dede,Devinn,ddevinnaa@unesco.org,Recruiter,6635,1341,7976
39811,Jaymee,Upstone,jupstoneab@nbcnews.com,Professor,2353,1767,4120
39794,Clay,McCrainor,cmccrainorac@zimbio.com,Budget/Accounting Analyst IV,5520,1312,6832
39165,Redd,Scocroft,rscocroftad@wired.com,Administrative Officer,4757,754,5511
39527,Jaine,Ceillier,jceillierae@google.ru,VP Marketing,8157,1264,9421
39703,Mitchel,Pratton,mprattonaf@e-recht24.de,Chemical Engineer,2400,429,2829
39729,Oran,Stuart,ostuartag@bbb.org,Geologist IV,2526,409,2935
39337,Iona,Eberts,iebertsai@cnn.com,Programmer Analyst IV,7014,1549,8563
39100,Veronique,Parrish,vparrisham@google.es,Research Assistant IV,1037,1002,2039
39164,Aubrey,Linklater,alinklateran@tiny.cc,Systems Administrator II,3625,993,4618
39825,Henryetta,Douthwaite,hdouthwaiteao@columbia.edu,Analog Circuit Design manager,2256,475,2731
39223,Bobbee,Fisbey,bfisbeyap@jimdo.com,Media Manager II,9582,1201,10783
39809,Bertine,Joselovitch,bjoselovitchat@alexa.com,Account Executive,5273,1352,6625
39460,Haydon,Tynan,htynanau@exblog.jp,Food Chemist,4459,935,5394
39480,Ibbie,Brittan,ibrittanav@fda.gov,Clinical Specialist,1743,894,2637
39953,Aldous,Setchell,asetchellaw@wikipedia.org,Assistant Professor,5266,1910,7176
39148,Lynnell,Syalvester,lsyalvesteray@freewebs.com,Teacher,3498,528,4026
39280,Linus,Hegarty,lhegartyaz@wordpress.org,Developer II,4344,1353,5697
39417,Leisha,Eastwood,leastwoodb0@elpais.com,Nurse Practicioner,5508,1358,6866
39831,Sibelle,Coldbath,scoldbathb1@canalblog.com,Speech Pathologist,2256,1187,3443
39769,Nicolis,Sadd,nsaddb2@addthis.com,Automation Specialist I,1772,955,2727
39529,Halimeda,Latek,hlatekb4@privacy.gov.au,Tax Accountant,9802,1157,10959
39483,Nat,Redmond,nredmondb6@youku.com,Budget/Accounting Analyst II,7941,847,8788
39928,Austin,Malden,amaldenb7@hc360.com,Mechanical Systems Engineer,2975,323,3298
39550,Torry,Hazzard,thazzardb9@scribd.com,Internal Auditor,4614,1334,5948
39643,Connie,Blenkhorn,cblenkhornbb@amazon.com,Information Systems Manager,5020,513,5533
39515,Rivalee,Crapper,rcrapperbd@chron.com,Information Systems Manager,9791,955,10746
39890,Nerissa,Pidduck,npidduckbf@webmd.com,Account Coordinator,8109,1973,10082
39124,Charita,Gianelli,cgianellibh@mysql.com,Help Desk Operator,1038,267,1305
39979,Alley,Bleakley,ableakleybi@rakuten.co.jp,Computer Systems Analyst IV,1347,387,1734
39391,Arlette,Tomkies,atomkiesbj@independent.co.uk,Information Systems Manager,6245,760,7005
39484,Lawton,Macklam,lmacklambk@alibaba.com,Office Assistant IV,2484,1452,3936
39403,Dare,Berryman,dberrymanbl@smugmug.com,Environmental Specialist,2514,880,3394
39671,Claudell,MacPaden,cmacpadenbm@reference.com,Administrative Assistant II,7085,655,7740
39258,Lane,Malimoe,lmalimoebn@addthis.com,Research Nurse,5446,595,6041
39807,Jessica,Dawdry,jdawdrybo@typepad.com,Pharmacist,6430,1625,8055
39923,Evaleen,Souley,esouleybp@goodreads.com,Financial Analyst,5560,1359,6919
39302,Carlyle,Takle,ctaklebq@myspace.com,Budget/Accounting Analyst III,6084,1140,7224
39449,Zara,Ritmeyer,zritmeyerbs@geocities.jp,Financial Analyst,8945,1869,10814
39108,Emmey,Tatersale,etatersalebu@google.fr,Media Manager III,4823,442,5265
39862,Tabbie,Jeduch,tjeduchby@deviantart.com,Actuary,6787,1388,8175
39419,Robinson,O'Hagan,rohaganbz@china.com.cn,Chief Design Engineer,3654,1091,4745
39582,Arnuad,Sunman,asunmanc1@indiatimes.com,Executive Secretary,7947,1096,9043
39324,Robinson,Ghioni,rghionic2@bravesites.com,Recruiting Manager,9172,1271,10443
39763,Hamlin,Barsam,hbarsamc6@webeden.co.uk,Graphic Designer,1326,1721,3047
39255,Bellina,Alflatt,balflattc7@wordpress.com,Editor,7280,274,7554
39683,Celine,Fortman,cfortmanc8@slideshare.net,Recruiting Manager,9255,1709,10964
39727,Rhett,MacGarrity,rmacgarritycb@cmu.edu,Chemical Engineer,3308,1418,4726
39184,Dominick,Bravery,dbraverycd@t.co,Biostatistician III,3767,503,4270
39776,Kendall,Cubbin,kcubbince@tumblr.com,VP Quality Control,6110,1041,7151
39428,Red,Dale,rdalecf@issuu.com,Graphic Designer,6873,1382,8255
39935,Monro,Boult,mboultcj@example.com,Human Resources Manager,9698,436,10134
39494,Rozamond,Degnen,rdegnencl@networksolutions.com,Research Nurse,4894,1281,6175
39149,Darlene,Heald,dhealdcn@google.com.au,Civil Engineer,6549,691,7240
39457,Eda,McCorkindale,emccorkindaleco@163.com,Health Coach II,5183,598,5781
39855,Florri,Stegers,fstegerscp@kickstarter.com,Design Engineer,5100,1895,6995
39322,Violante,Gatchell,vgatchellcr@jalbum.net,Product Engineer,1528,403,1931
39328,Amabel,Weavers,aweaverscs@mashable.com,Statistician II,9336,542,9878
39304,Alexandra,Kubiczek,akubiczekcv@mtv.com,Senior Quality Engineer,1666,671,2337
39510,Stanfield,Jiggle,sjigglecx@newyorker.com,Environmental Tech,3993,1166,5159
39578,Ilka,Dovinson,idovinsond2@msn.com,Financial Advisor,6017,759,6776
39356,Melessa,Rubenchik,mrubenchikd3@mashable.com,Recruiting Manager,7318,1882,9200
39891,Tybi,Humpherston,thumpherstond4@ifeng.com,VP Quality Control,9425,1284,10709
39179,Adah,Bestar,abestard5@statcounter.com,Software Engineer III,4014,1710,5724
39379,Celka,Kleiner,ckleinerd6@nydailynews.com,Senior Financial Analyst,8777,818,9595
39957,Lyon,Briiginshaw,lbriiginshawd7@addthis.com,Geological Engineer,2151,1294,3445
39659,Verene,Abbati,vabbatid8@amazon.com,Technical Writer,8850,1777,10627
39253,Iggie,Bitterton,ibittertond9@smugmug.com,Chief Design Engineer,4318,1878,6196
39261,Ree,Edgcombe,redgcombeda@people.com.cn,Financial Analyst,3466,326,3792
39196,Tyson,Paterno,tpaternodb@nyu.edu,Community Outreach Specialist,6470,1409,7879
39481,Candis,Outlaw,coutlawdc@walmart.com,Automation Specialist III,3328,1115,4443
39732,Lucia,Leggett,lleggettde@google.co.jp,Accountant II,5746,1452,7198
39469,Trudie,Praundlin,tpraundlindg@ftc.gov,VP Sales,7791,699,8490
39343,Melissa,Coverlyn,mcoverlyndh@reference.com,Staff Scientist,3880,674,4554
39750,Patsy,Phaup,pphaupdi@twitter.com,Programmer Analyst IV,2257,1736,3993
39294,Steward,Newnham,snewnhamdj@reddit.com,Graphic Designer,8118,877,8995
39907,Jervis,Siderfin,jsiderfindk@samsung.com,Assistant Manager,6424,541,6965
39277,Vivienne,Olenin,volenindl@google.nl,Research Nurse,1753,352,2105
39966,Leicester,Jannings,ljanningsdm@cbslocal.com,Help Desk Operator,9792,1018,10810
39224,Lynelle,Van Geffen,lvangeffendn@bigcartel.com,VP Marketing,5396,1873,7269
39572,Fanni,Larcher,flarcherdp@mail.ru,Librarian,3289,1456,4745
39275,Sallyanne,Dudmesh,sdudmeshdr@ebay.co.uk,Speech Pathologist,1089,883,1972
39944,Janaye,Romaynes,jromaynesds@google.pl,VP Product Management,7674,538,8212
39023,Kimberlyn,Grimsey,kgrimseydu@harvard.edu,Financial Advisor,4849,806,5655
39245,Margery,Kincaid,mkincaiddw@wufoo.com,Staff Scientist,6947,1978,8925
39628,Ker,Hawkes,khawkesdx@furl.net,Senior Editor,4397,738,5135
39875,Grove,Gasperi,ggasperidz@newyorker.com,Nurse Practicioner,8017,1448,9465
39987,Chariot,Cleobury,ccleoburye0@51.la,Food Chemist,8829,1143,9972
39110,Honey,Kier,hkiere2@hexun.com,Junior Executive,5433,1848,7281
39702,Giacinta,Calverley,gcalverleye4@amazonaws.com,Account Representative II,7861,1507,9368
39497,Katerine,Brambill,kbrambille6@cyberchimps.com,VP Product Management,5976,1612,7588
39154,Christophe,Fall,cfalle7@theglobeandmail.com,Graphic Designer,7707,1133,8840
39068,Ruddy,Langdale,rlangdalee8@nps.gov,Quality Engineer,4876,1782,6658
39082,Paddy,Korfmann,pkorfmannec@forbes.com,Web Designer I,2489,1625,4114
39730,Wainwright,Copnar,wcopnared@photobucket.com,Account Coordinator,6297,804,7101
39952,Florina,Sefton,fseftonef@addtoany.com,Geologist I,2014,1177,3191
39075,Meier,Piletic,mpileticej@toplist.cz,VP Marketing,7977,1138,9115
39812,Sunny,Stopps,sstoppseo@jimdo.com,Registered Nurse,2557,1050,3607
39827,Rogers,Brouard,rbrouardep@ycombinator.com,Structural Engineer,1160,1912,3072
39283,Adlai,Hammerstone,ahammerstoneer@arstechnica.com,Dental Hygienist,3035,613,3648
39937,Brianne,Broadwell,bbroadwelles@netscape.com,Automation Specialist IV,5003,1023,6026
39305,Neala,Glencrosche,nglencroscheet@scientificamerican.com,Quality Control Specialist,8078,962,9040
39779,Jesselyn,Khosa,jkhosaeu@digg.com,Technical Writer,8382,215,8597
39929,Thorin,Curtin,tcurtinew@whitehouse.gov,Associate Professor,8484,1239,9723
39001,Linet,Harrington,lharringtonex@netscape.com,Nuclear Power Engineer,9616,843,10459
39802,Hilton,Mar,hmarez@typepad.com,Analyst Programmer,7311,711,8022
39541,Enrique,Stambridge,estambridgef4@gravatar.com,Civil Engineer,7544,369,7913
39235,Vick,Le Guin,vleguinf7@sbwire.com,Research Associate,7199,660,7859
39881,Elvina,Bestiman,ebestimanf9@nasa.gov,VP Product Management,3182,728,3910
39646,Tove,Pigeram,tpigeramfb@weibo.com,Web Designer III,8867,487,9354
39169,Emmett,Spatari,espatarifd@hostgator.com,VP Product Management,5217,1096,6313
39363,Alain,Ambrosini,aambrosiniff@ask.com,Executive Secretary,7454,235,7689
39361,Brianna,Coraini,bcorainifh@mapy.cz,Chief Design Engineer,5401,1905,7306
39056,Zebedee,Fotherby,zfotherbyfj@gmpg.org,Assistant Professor,1791,477,2268
39842,Aurelia,Hukin,ahukinfm@cornell.edu,Marketing Assistant,3787,1273,5060
39524,Malachi,Le Sarr,mlesarrfn@mac.com,Research Assistant II,3802,1346,5148
39930,Starla,Cotherill,scotherillfo@cafepress.com,Business Systems Development Analyst,7608,722,8330
39101,Karol,Prettyjohns,kprettyjohnsfp@reddit.com,Desktop Support Technician,4564,617,5181
39473,Vito,Cahn,vcahnfq@istockphoto.com,Speech Pathologist,8485,285,8770
39983,Maxy,Mowatt,mmowattfs@plala.or.jp,Systems Administrator I,5076,246,5322
39065,Jacinthe,Manketell,jmanketellft@thetimes.co.uk,Automation Specialist III,3389,1191,4580
39716,Vania,MacFayden,vmacfaydenfu@umich.edu,Account Coordinator,8019,522,8541
39342,Ede,Aleksich,ealeksichfw@mapquest.com,GIS Technical Architect,6789,653,7442
39501,Jamil,Etheredge,jetheredgefx@nbcnews.com,Help Desk Technician,4755,776,5531
39701,Jehu,Gorse,jgorsefy@com.com,Help Desk Operator,4314,1981,6295
39134,Courtnay,Bauser,cbauserg0@parallels.com,Recruiting Manager,9842,1777,11619
39499,Dre,Cristofolini,dcristofolinig1@loc.gov,Payment Adjustment Coordinator,5912,301,6213
39867,Dorrie,Swanger,dswangerg2@t-online.de,Sales Associate,5403,532,5935
39735,Sonya,Grevile,sgrevileg3@howstuffworks.com,Structural Analysis Engineer,9855,1564,11419
39241,Kahlil,Camelli,kcamellig4@amazon.de,Project Manager,1461,442,1903
39603,Shaylah,Yurocjhin,syurocjhing6@cocolog-nifty.com,Civil Engineer,2081,878,2959
39405,Shellie,Gethouse,sgethouseg7@yahoo.co.jp,Accountant I,4873,1029,5902
39374,Cece,Endean,cendeang8@addtoany.com,Librarian,4712,492,5204
39270,Liza,Touson,ltousongb@goodreads.com,Assistant Manager,2915,1360,4275
39063,Danni,Giblin,dgiblingd@dailymail.co.uk,Operator,1518,808,2326
39437,Lani,Piesing,lpiesinggi@chron.com,Systems Administrator III,3697,1580,5277
39964,Dalt,Edmeads,dedmeadsgj@auda.org.au,Senior Developer,2693,647,3340
39632,Eleonore,Gosker,egoskergl@webmd.com,Mechanical Systems Engineer,7138,1950,9088
39156,Arny,Smythin,asmythingm@nature.com,Environmental Tech,5974,1144,7118
39998,Ferdinand,Rydeard,frydeardgn@tinyurl.com,Pharmacist,5235,1359,6594
39826,Gladys,Strowan,gstrowangq@dyndns.org,Staff Accountant I,1041,231,1272
39534,Tessa,Jumeau,tjumeaugr@nsw.gov.au,Recruiter,5287,966,6253
39372,Erick,Siggins,esigginsgs@msn.com,Food Chemist,9167,1421,10588
39348,Nevile,Duckworth,nduckworthgu@wp.com,Database Administrator I,7471,229,7700
39375,Carolus,Derges,cdergesgx@ovh.net,Database Administrator IV,6569,332,6901
39229,Lorain,Biddulph,lbiddulphgy@baidu.com,Structural Analysis Engineer,2788,856,3644
39734,Bonita,Raubenheim,braubenheimgz@pbs.org,Statistician II,8527,1631,10158
39427,Kanya,Pettisall,kpettisallh1@imgur.com,Social Worker,5995,1747,7742
39623,Iain,Ainslie,iainslieh2@geocities.com,Nuclear Power Engineer,4297,1261,5558
39365,Gwenore,Moir,gmoirh3@webmd.com,Quality Control Specialist,7292,1071,8363
39344,Tamar,Lascelles,tlascellesh4@imageshack.us,Senior Editor,4961,1840,6801
39789,Ingamar,Loudian,iloudianh6@baidu.com,Chemical Engineer,8340,1321,9661
39443,Denyse,Belverstone,dbelverstoneh7@buzzfeed.com,Community Outreach Specialist,5898,1666,7564
39674,Annabelle,Tuffield,atuffieldh8@youtu.be,VP Quality Control,5817,466,6283
39761,Derk,MacWilliam,dmacwilliamhd@latimes.com,Software Consultant,6708,1906,8614
39773,Linn,Surmeyer,lsurmeyerhf@scientificamerican.com,Structural Analysis Engineer,2533,381,2914
39228,Hermine,Seary,hsearyhg@gov.uk,Analog Circuit Design manager,5439,865,6304
39066,Ronnie,Curwood,rcurwoodhh@list-manage.com,Account Representative III,6555,1976,8531
39402,Layne,Manoelli,lmanoellihi@xinhuanet.com,Chief Design Engineer,8020,427,8447
39760,Mallissa,Chalcroft,mchalcrofthk@jugem.jp,Recruiter,7487,601,8088
39948,Shaylyn,Cozzi,scozzihl@webmd.com,Physical Therapy Assistant,5871,494,6365
39601,Olivero,Freeberne,ofreebernehp@wp.com,VP Sales,1551,209,1760
39712,Esme,Ramsay,eramsayhr@si.edu,Dental Hygienist,6505,1826,8331
39642,Mose,Grelik,mgrelikhx@hibu.com,Database Administrator II,6699,991,7690
39032,Jody,Genny,jgennyhy@constantcontact.com,Recruiter,8021,910,8931
39840,Bealle,Jeafferson,bjeaffersonhz@hostgator.com,Senior Editor,5274,1171,6445
39792,Andres,Snashall,asnashalli0@cocolog-nifty.com,Senior Quality Engineer,7763,1276,9039
39746,Marilee,Rickertsen,mrickertseni1@utexas.edu,Recruiting Manager,6948,1149,8097
39121,Selby,Jeanesson,sjeanessoni3@phpbb.com,Cost Accountant,1023,958,1981
39049,Ashly,Godfroy,agodfroyi5@ycombinator.com,Legal Assistant,7809,1200,9009
39177,Alessandra,Capsey,acapseyi6@wiley.com,Senior Sales Associate,9798,1820,11618
39893,Pearl,Wonfar,pwonfari7@about.com,GIS Technical Architect,4050,677,4727
39633,Kip,Baptiste,kbaptistei8@nba.com,Accountant II,1878,847,2725
39186,Conant,Laminman,claminmani9@delicious.com,Internal Auditor,2757,561,3318
39353,Brittaney,Shay,bshayig@forbes.com,Executive Secretary,3077,1835,4912
39687,Hanson,Rennie,hrennieih@tinyurl.com,Design Engineer,6351,1351,7702
39531,Silvio,Paddon,spaddonin@globo.com,Senior Quality Engineer,7924,1794,9718
39895,Gertruda,Thornthwaite,gthornthwaiteio@blogs.com,Analyst Programmer,5378,1947,7325
39737,Celie,Canete,ccaneteit@harvard.edu,Operator,7328,1184,8512
39271,Carney,Sennett,csennettiu@ibm.com,Programmer Analyst I,6381,1592,7973
39008,Costa,Chittim,cchittimiw@ed.gov,Business Systems Development Analyst,6530,860,7390
39143,Piggy,Prestie,pprestieiz@ycombinator.com,Nurse,6177,1179,7356
39385,Clerc,Predohl,cpredohlj0@mozilla.org,Pharmacist,7647,1754,9401
39566,Antoni,Brehat,abrehatj4@github.io,Nurse Practicioner,9865,436,10301
39489,Jaquelin,Copyn,jcopynj5@tripod.com,Software Test Engineer I,4964,1936,6900
39696,Juli,Hancill,jhancillj7@reference.com,Help Desk Operator,4968,1998,6966
39183,Phillie,Mitrovic,pmitrovicj8@twitter.com,Director of Sales,9176,850,10026
39406,Siana,Patty,spattyj9@1und1.de,Analog Circuit Design manager,8157,1918,10075
39808,Gayler,Bozworth,gbozworthjc@flavors.me,Speech Pathologist,2818,1787,4605
39366,Beverly,Biernacki,bbiernackijd@sina.com.cn,Research Associate,8915,1781,10696
39955,Noam,Huckell,nhuckelljf@prlog.org,Business Systems Development Analyst,2335,683,3018
39800,El,Wontner,ewontnerji@diigo.com,Food Chemist,5232,1867,7099
39338,Batsheva,Timcke,btimckejl@cisco.com,Business Systems Development Analyst,6690,1007,7697
39993,Dona,Gemmill,dgemmilljo@arizona.edu,Cost Accountant,8102,1691,9793
39256,Carmen,Troughton,ctroughtonjp@tripod.com,Marketing Manager,6526,1423,7949
39061,Brooke,Fattore,bfattorejq@icq.com,Legal Assistant,2272,1415,3687
39580,Imojean,Trewartha,itrewarthajr@yellowbook.com,Social Worker,5531,1565,7096
39367,Tatiana,Inkle,tinklejs@vistaprint.com,Editor,7869,1867,9736
39584,Nathan,Jaquet,njaquetjx@huffingtonpost.com,Research Associate,5395,1151,6546
39797,Zaria,Whanstall,zwhanstallk0@pinterest.com,Database Administrator I,9452,1615,11067
39939,Tiffie,Loudian,tloudiank1@shinystat.com,Financial Advisor,3734,270,4004
39431,Jacquie,Beeston,jbeestonk3@umn.edu,Librarian,7528,1219,8747
39433,Cher,Gosden,cgosdenk4@oakley.com,VP Product Management,3624,865,4489
39909,Tootsie,Bruhnicke,tbruhnickek7@telegraph.co.uk,Electrical Engineer,8108,802,8910
39355,Odelinda,Higbin,ohigbink8@jimdo.com,Junior Executive,9571,1472,11043
39389,Rutledge,Cicco,rciccoka@nytimes.com,Health Coach II,3154,841,3995
39959,Hayes,Gartside,hgartsidekb@constantcontact.com,Project Manager,1821,1611,3432
39311,Michaella,Cescotti,mcescottikf@jimdo.com,Paralegal,2777,1241,4018
39751,Aguistin,Volonte,avolontekg@hao123.com,Environmental Tech,2969,1303,4272
39777,Land,Wontner,lwontnerkh@senate.gov,Cost Accountant,8535,507,9042
39188,Fergus,Cagan,fcaganki@eepurl.com,Pharmacist,7756,1159,8915
39454,Artemas,Rodson,arodsonkj@tmall.com,Marketing Manager,7921,1271,9192
39193,Doug,McKnish,dmcknishkn@feedburner.com,Staff Scientist,9543,218,9761
39334,Kelsey,Kermeen,kkermeenkq@jugem.jp,Associate Professor,8860,1392,10252
39523,Claiborne,Forth,cforthks@hc360.com,Paralegal,3637,323,3960
39570,Meade,Dechelle,mdechelleku@devhub.com,Software Consultant,3197,1848,5045
39492,Gerhardine,Petford,gpetfordl0@ifeng.com,VP Sales,9540,1491,11031
39706,Lennard,Giurio,lgiuriol1@vinaora.com,Executive Secretary,8447,846,9293
39924,Editha,Melross,emelrossl3@vk.com,Nurse,1517,1018,2535
39649,Cynthia,Clyant,cclyantl7@gravatar.com,Chief Design Engineer,1408,792,2200
39495,Carie,Francesconi,cfrancesconilb@jigsy.com,Senior Developer,3786,1630,5416
39135,Gran,Causey,gcauseyld@elpais.com,Help Desk Operator,1126,915,2041
39453,Sauveur,Vassman,svassmanle@uiuc.edu,Community Outreach Specialist,3419,1421,4840
39240,Jacintha,Madelin,jmadelinlf@intel.com,Human Resources Assistant I,8766,962,9728
39373,Ruggiero,Slocumb,rslocumblh@typepad.com,Software Test Engineer I,8464,527,8991
39335,Ddene,Dawidowitz,ddawidowitzli@ovh.net,Registered Nurse,3397,1525,4922
39237,Paddy,Thay,pthaylk@smh.com.au,Legal Assistant,4021,1046,5067
39371,Clywd,Laible,claibleln@digg.com,Human Resources Manager,2810,1457,4267
39629,Ronica,Ballentime,rballentimelo@nhs.uk,Payment Adjustment Coordinator,2947,534,3481
39113,Claus,Garaway,cgarawaylq@godaddy.com,Accountant IV,5754,1715,7469
39889,Ameline,Champniss,achampnissls@samsung.com,Payment Adjustment Coordinator,6741,967,7708
39658,Gwen,Bockmann,gbockmannlt@netvibes.com,Information Systems Manager,9300,248,9548
39352,Margarette,Mewrcik,mmewrciklv@theatlantic.com,Electrical Engineer,2258,819,3077
39087,Moll,O'Lyhane,molyhanely@canalblog.com,Graphic Designer,1361,1672,3033
39559,Eddie,Andrzej,eandrzejlz@newsvine.com,Clinical Specialist,9545,904,10449
39768,Sissie,Kelleway,skellewaym0@amazon.co.uk,Administrative Officer,5450,1762,7212
39790,Rufe,Spadari,rspadarim1@hibu.com,Clinical Specialist,2145,1854,3999
39345,Karola,Woolliams,kwoolliamsm2@mashable.com,Product Engineer,5409,1310,6719
39488,Suzanne,Tompkin,stompkinm3@hubpages.com,Payment Adjustment Coordinator,7856,218,8074
39843,Sheridan,D'Cruze,sdcruzem7@prweb.com,Account Representative I,3443,804,4247
39411,Anita,Braun,abraunme@yandex.ru,Accounting Assistant III,8127,274,8401
39046,Chadwick,Konmann,ckonmannmh@histats.com,Product Engineer,7177,566,7743
39557,Hillel,Lorrain,hlorrainmi@fotki.com,Web Designer II,5958,447,6405
39688,Clayborn,Ugoletti,cugolettiml@eepurl.com,Human Resources Assistant IV,1318,397,1715
39824,Regina,Qusklay,rqusklaymm@businessinsider.com,Dental Hygienist,9354,400,9754
39525,Cathleen,Shakshaft,cshakshaftmn@jalbum.net,Desktop Support Technician,3895,1175,5070
39914,Stavros,Stockle,sstocklemo@wp.com,Human Resources Assistant I,2159,1580,3739
39762,Shanon,Brimilcombe,sbrimilcombemp@sfgate.com,Desktop Support Technician,6405,552,6957
39080,Yalonda,Lambourne,ylambournemu@whitehouse.gov,Systems Administrator III,8085,408,8493
39587,Munroe,Stygall,mstygallmv@pen.io,Senior Cost Accountant,8133,714,8847
39381,Phyllis,Handford,phandfordmw@thetimes.co.uk,Recruiter,4020,404,4424
39071,Bruce,Wrathmell,bwrathmellmx@tuttocitta.it,Structural Engineer,7424,1623,9047
39424,Ameline,Verring,averringmy@nytimes.com,Software Test Engineer III,6638,1727,8365
39350,Tommie,Crosskell,tcrosskelln0@nyu.edu,Structural Analysis Engineer,1130,1650,2780
39268,Ody,Richardson,orichardsonn1@ihg.com,Analyst Programmer,6902,776,7678
39086,Norris,Lattka,nlattkan6@pbs.org,Human Resources Assistant II,9037,1259,10296
39478,Ali,Albrighton,aalbrightonn7@aboutads.info,Civil Engineer,4694,822,5516
39588,Zorana,Eggins,zegginsnb@ebay.com,Technical Writer,2675,1606,4281
39098,Bill,Marsden,bmarsdennd@hao123.com,Dental Hygienist,3281,1455,4736
39502,Gianina,Willets,gwilletsnf@wikia.com,Senior Financial Analyst,2630,1771,4401
39715,Orville,Seabrocke,oseabrockenl@oakley.com,Senior Sales Associate,7232,1211,8443
39767,Trudey,Whitley,twhitleynn@umn.edu,Help Desk Technician,1593,1508,3101
39764,Kayla,Shalders,kshaldersnt@reverbnation.com,Assistant Professor,2213,1626,3839
39992,Ive,Stubbs,istubbsnv@ycombinator.com,Business Systems Development Analyst,1281,926,2207
39095,Dudley,Tregea,dtregeao0@smh.com.au,GIS Technical Architect,8532,967,9499
39189,Edouard,Durram,edurramo9@elegantthemes.com,Automation Specialist I,5630,959,6589
39452,Tawnya,Mersh,tmershoa@sciencedaily.com,Paralegal,4901,1848,6749
39698,Vinita,Merriton,vmerritonoe@yandex.ru,Human Resources Manager,6223,418,6641
39573,Carl,Saltern,csalternog@imageshack.us,Payment Adjustment Coordinator,6139,1337,7476
39109,Agnella,Grabban,agrabbanoi@alexa.com,Marketing Assistant,5203,576,5779
39141,Durand,Dooly,ddoolyop@house.gov,Cost Accountant,9918,241,10159
39519,Joycelin,Rabbage,jrabbageoq@prweb.com,Software Consultant,6369,1754,8123
39396,Candice,Haddleton,chaddletonor@guardian.co.uk,GIS Technical Architect,2042,1650,3692
39218,Kingston,Fenck,kfenckos@zimbio.com,Environmental Tech,8619,1104,9723
39146,Arabela,Skeldon,askeldonow@dailymotion.com,Chief Design Engineer,3953,906,4859
39878,Palmer,Grutchfield,pgrutchfieldoz@eventbrite.com,Office Assistant III,3139,1116,4255
39757,Cordula,Elie,celiep0@sfgate.com,Senior Financial Analyst,1695,1118,2813
39017,Marcie,Balleine,mballeinep5@squarespace.com,Web Designer IV,6042,1635,7677
39707,Fallon,Burtwell,fburtwellp8@gmpg.org,Senior Quality Engineer,7150,894,8044
39425,Penny,Strangward,pstrangwardp9@1688.com,Budget/Accounting Analyst III,7400,1164,8564
39157,Jolee,Acklands,jacklandspa@gnu.org,Senior Sales Associate,6881,493,7374
39919,Shana,Halburton,shalburtonpb@go.com,Environmental Tech,5356,1710,7066
39014,Rocky,Binding,rbindingpd@google.es,Research Associate,1730,1784,3514
39064,Mareah,Hessel,mhesselpe@themeforest.net,Research Assistant I,7336,1304,8640
39341,Ferdinande,Brayshaw,fbrayshawpf@mozilla.com,Physical Therapy Assistant,4425,778,5203
39962,Amabel,Lewis,alewisph@loc.gov,Clinical Specialist,3303,1538,4841
39536,Claudie,Joyson,cjoysonpj@usatoday.com,Account Coordinator,8360,220,8580
39332,Clemence,Livermore,clivermorepl@pcworld.com,Geological Engineer,4530,1074,5604
39153,Enrique,Packington,epackingtonpm@sina.com.cn,Health Coach IV,8744,862,9606
39329,Rori,Crim,rcrimpo@epa.gov,Health Coach I,5060,1828,6888
39410,Link,Covington,lcovingtonpq@woothemes.com,Compensation Analyst,6926,777,7703
39858,Cathryn,Oliveras,coliveraspr@vinaora.com,Editor,8767,953,9720
39565,Samuel,Hamlen,shamlenps@nydailynews.com,Food Chemist,7448,1817,9265
39942,Shea,Rollin,srollinpv@narod.ru,Web Designer III,8865,1072,9937
39857,Dulce,Vearnals,dvearnalspy@cbsnews.com,Sales Associate,6480,450,6930
39801,Ulrike,Pastor,upastorpz@wikispaces.com,Operator,1290,1355,2645
39163,Elbert,Normand,enormandq0@craigslist.org,Teacher,1107,1930,3037
39739,Elbert,Matias,ematiasq1@hao123.com,Environmental Specialist,3542,1831,5373
39434,Sullivan,Prothero,sprotheroq3@state.tx.us,Geological Engineer,7044,1275,8319
39298,Ingamar,Pinson,ipinsonq6@nhs.uk,Software Engineer II,4475,1601,6076
39969,Adriano,Corkett,acorkettqa@timesonline.co.uk,Project Manager,9561,717,10278
39522,Hilde,Croall,hcroallqc@arstechnica.com,GIS Technical Architect,6662,809,7471
39005,Fay,Ranfield,franfieldqf@taobao.com,Graphic Designer,7391,1831,9222
39029,Korey,Yakovlev,kyakovlevqh@washingtonpost.com,Financial Analyst,9851,430,10281
39368,Netti,Celiz,ncelizqj@fotki.com,Senior Financial Analyst,1706,1908,3614
39358,Mason,Aucourte,maucourteql@shop-pro.jp,Geological Engineer,5174,1132,6306
39810,Conn,Mallett,cmallettqq@icio.us,Web Designer III,5129,857,5986
39479,Kassie,Bridewell,kbridewellqu@cnbc.com,Physical Therapy Assistant,8457,403,8860
39423,Normie,Batters,nbattersqw@macromedia.com,Director of Sales,8116,1992,10108
39958,Davie,Gabbidon,dgabbidonqy@eepurl.com,Computer Systems Analyst III,9245,573,9818
39838,Olly,Maasze,omaaszer3@google.co.uk,Recruiter,4101,666,4767
39612,Mart,O'Nowlan,monowlanr5@deliciousdays.com,Payment Adjustment Coordinator,3041,205,3246
39144,Michelina,Heustace,mheustacer6@shop-pro.jp,Senior Editor,8477,1842,10319
39259,Thane,Scalera,tscalerar7@dmoz.org,Research Assistant IV,6900,932,7832
39476,Herc,Lamminam,hlamminamra@cnbc.com,Assistant Manager,7542,757,8299
39227,Mariele,Hanby,mhanbyrb@samsung.com,Structural Analysis Engineer,3312,733,4045
39105,Lyndsey,Ondrich,londrichrd@mapquest.com,Recruiting Manager,8253,1694,9947
39530,Kare,Mellish,kmellishrf@digg.com,Recruiter,5327,323,5650
39655,Joela,Franey,jfraneyrh@rakuten.co.jp,Automation Specialist III,5989,772,6761
39989,Lizabeth,Riha,lriharl@typepad.com,Software Test Engineer III,1229,764,1993
39052,Inessa,Guye,iguyero@huffingtonpost.com,Compensation Analyst,2982,663,3645
40463,Carrol,Merkel,cmerkel0@a8.net,Senior Financial Analyst,8602,1537,10139
40938,Antonio,Gebb,agebb1@accuweather.com,Geologist III,6997,696,7693
40124,Meir,Sandys,msandys2@fastcompany.com,Analog Circuit Design manager,9851,1991,11842
40470,Shae,Hews,shews3@ustream.tv,Marketing Assistant,2374,296,2670
40867,Danette,Rottger,drottger4@umn.edu,Senior Quality Engineer,2842,841,3683
40603,Laverna,Nind,lnind5@cyberchimps.com,Structural Engineer,2110,1020,3130
40935,Quincey,Wintringham,qwintringham6@pen.io,Senior Quality Engineer,1333,947,2280
40918,Brook,Ashbe,bashbe7@blogger.com,Administrative Officer,2876,1920,4796
40632,Barbette,Helks,bhelks8@skype.com,Desktop Support Technician,1150,1583,2733
40954,Layney,Cottesford,lcottesford9@cisco.com,Environmental Specialist,5666,1120,6786
40995,Ranna,Meriot,rmeriota@altervista.org,Recruiting Manager,7869,1296,9165
40916,Perry,Demicoli,pdemicolib@behance.net,Professor,2565,301,2866
40171,Candy,Goodsal,cgoodsalc@tumblr.com,Health Coach III,7253,1331,8584
40651,Yelena,Postance,ypostanced@i2i.jp,Speech Pathologist,7868,862,8730
40369,Marianna,Neasam,mneasame@blogs.com,VP Sales,3001,1916,4917
40630,Sherwin,Toe,stoef@toplist.cz,Paralegal,8029,218,8247
40728,Veronike,Strowlger,vstrowlgerg@shareasale.com,Electrical Engineer,7006,1454,8460
40283,Kimberlee,Surgeon,ksurgeonh@live.com,Actuary,7503,1627,9130
40194,Janeta,Hendrichs,jhendrichsi@discovery.com,Software Consultant,5566,1546,7112
40243,Zitella,Dincke,zdinckej@alibaba.com,Senior Editor,6478,658,7136
40794,Chiquita,Eagland,ceaglandk@tmall.com,Web Designer I,5490,1302,6792
40735,Thekla,Chadd,tchaddl@soundcloud.com,Registered Nurse,2661,1130,3791
40551,Laird,Elger,lelgerm@themeforest.net,Programmer I,2152,1284,3436
40596,Heath,Henriquet,hhenriquetn@about.me,Web Developer I,9957,1771,11728
40900,Vaughan,Rolley,vrolleyo@skyrock.com,Accountant II,6593,1968,8561
40099,Eliza,Scattergood,escattergoodp@discuz.net,Environmental Tech,7925,238,8163
40796,Madelin,Proudley,mproudleyq@goodreads.com,Clinical Specialist,9230,996,10226
40063,Andree,Dawton,adawtonr@vistaprint.com,Accountant I,4800,1007,5807
40347,Mohammed,Kos,mkoss@bbb.org,Accounting Assistant II,5357,1883,7240
40907,Myrle,Delap,mdelapt@dagondesign.com,Structural Analysis Engineer,2286,1682,3968
40863,Fonsie,Yurkevich,fyurkevichu@1688.com,Chemical Engineer,7467,214,7681
40122,Skip,Heaysman,sheaysmanv@msu.edu,Desktop Support Technician,3353,1325,4678
40799,Aeriela,Delahunty,adelahuntyw@seattletimes.com,Research Assistant IV,5797,1468,7265
40284,Angelita,Gutman,agutmanx@mediafire.com,Desktop Support Technician,9209,295,9504
40205,Raff,Blackston,rblackstony@nifty.com,Information Systems Manager,4969,339,5308
40515,Ab,Kefford,akeffordz@java.com,Help Desk Operator,9953,1960,11913
40881,Waldemar,Francklin,wfrancklin10@nba.com,Associate Professor,5436,1581,7017
40831,Seka,Quin,squin12@seesaa.net,Tax Accountant,6425,1806,8231
40213,Pate,Sapsed,psapsed13@51.la,Design Engineer,6180,1258,7438
40365,Thia,Exroll,texroll14@netlog.com,Systems Administrator II,5881,1873,7754
40974,Karon,Guitel,kguitel15@nps.gov,Internal Auditor,1821,1724,3545
40392,Kiley,Shyres,kshyres16@statcounter.com,Technical Writer,5562,1624,7186
40594,Darby,Rymmer,drymmer17@mapy.cz,Quality Control Specialist,8116,1989,10105
40676,Klarrisa,Portail,kportail18@sitemeter.com,Web Developer I,7770,1799,9569
40862,Raoul,Baroc,rbaroc19@earthlink.net,Data Coordiator,7767,1373,9140
40159,Perice,Crosio,pcrosio1a@earthlink.net,Physical Therapy Assistant,7268,746,8014
40540,Constantina,Bicknell,cbicknell1b@virginia.edu,Dental Hygienist,2082,414,2496
40153,Flss,Gopsell,fgopsell1c@liveinternet.ru,Graphic Designer,7891,711,8602
40742,Colas,Hamson,chamson1d@yale.edu,Sales Associate,7823,1623,9446
40282,Ulla,Nunan,ununan1e@godaddy.com,Accounting Assistant III,9829,1869,11698
40672,Cyndia,Frango,cfrango1f@com.com,Geologist IV,3414,366,3780
40417,Natalya,Layhe,nlayhe1g@soundcloud.com,Professor,7240,1752,8992
40313,Ulysses,Ulyatt,uulyatt1h@tinypic.com,Developer I,5606,384,5990
40087,Feliza,Brigginshaw,fbrigginshaw1i@nhs.uk,Database Administrator I,3236,1627,4863
40031,Leonerd,Andriveaux,landriveaux1j@nymag.com,Pharmacist,6448,1041,7489
40721,Florence,Hamson,fhamson1k@unblog.fr,Research Assistant IV,8965,1591,10556
40714,Che,Yarnell,cyarnell1l@wordpress.org,Financial Advisor,8187,1160,9347
40861,Dar,Bartles,dbartles1m@photobucket.com,Recruiting Manager,1619,1923,3542
40726,Calvin,Wanklin,cwanklin1n@stanford.edu,Research Assistant II,3538,1474,5012
40525,Terese,Kleingrub,tkleingrub1o@house.gov,Automation Specialist I,2507,1595,4102
40984,Alida,McLice,amclice1p@springer.com,Software Consultant,9226,425,9651
40646,Curry,Perrett,cperrett1q@nifty.com,General Manager,3514,1882,5396
40613,Hy,Deverock,hdeverock1r@sphinn.com,Editor,4144,880,5024
40708,Eldin,Paulon,epaulon1s@istockphoto.com,Data Coordiator,9049,980,10029
40629,Harry,Hedden,hhedden1u@delicious.com,Clinical Specialist,3631,994,4625
40560,Milt,Chadbourne,mchadbourne1v@photobucket.com,Marketing Manager,6223,405,6628
40339,Brenda,MacNockater,bmacnockater1w@salon.com,Software Consultant,8839,1321,10160
40756,Thor,Churchward,tchurchward1x@a8.net,Help Desk Operator,7613,255,7868
40005,Creigh,Judgkins,cjudgkins1y@biblegateway.com,Office Assistant IV,3348,870,4218
40752,Renaud,Janney,rjanney1z@friendfeed.com,Recruiting Manager,6091,1763,7854
40773,Sabrina,Whitrod,swhitrod20@youtu.be,Web Designer II,2253,1951,4204
40758,Derek,St. Hill,dsthill21@angelfire.com,Statistician III,4840,1183,6023
40653,Rochell,Rymmer,rrymmer22@bigcartel.com,Technical Writer,3654,589,4243
40423,Eberhard,Woolis,ewoolis23@smh.com.au,Assistant Media Planner,5552,1753,7305
40970,Rabbi,Finley,rfinley24@cbslocal.com,Desktop Support Technician,2262,1496,3758
40192,Dexter,Addionizio,daddionizio26@hexun.com,Biostatistician I,9566,1607,11173
40411,Terrance,Whistlecraft,twhistlecraft27@cnbc.com,Senior Cost Accountant,9445,866,10311
40795,Eli,Billsberry,ebillsberry28@people.com.cn,Assistant Manager,7990,1062,9052
40536,Eddy,Crisp,ecrisp29@wix.com,VP Marketing,3300,443,3743
40704,Fina,Wollard,fwollard2b@economist.com,Desktop Support Technician,7340,1431,8771
40948,Rockey,Mallen,rmallen2c@bandcamp.com,Compensation Analyst,5447,1161,6608
40079,Pietra,Wortman,pwortman2d@parallels.com,Account Executive,4579,841,5420
40109,Sigrid,Scorah,sscorah2e@unc.edu,Programmer I,5107,1212,6319
40123,Nesta,Bowlesworth,nbowlesworth2f@youku.com,Administrative Officer,8452,587,9039
40818,Maudie,Gervaise,mgervaise2g@virginia.edu,Mechanical Systems Engineer,6422,297,6719
40628,Ruthe,Meers,rmeers2h@multiply.com,Programmer III,1779,1774,3553
40610,Rahal,Layzell,rlayzell2i@sphinn.com,Programmer Analyst III,9471,368,9839
40871,Libby,Coldman,lcoldman2j@pcworld.com,Nurse Practicioner,6937,1901,8838
40493,Violette,Heading,vheading2k@dmoz.org,Junior Executive,9774,1512,11286
40082,Adelbert,Hepher,ahepher2l@smh.com.au,Research Nurse,8751,975,9726
40533,Camellia,Loges,cloges2m@ehow.com,Information Systems Manager,9957,1081,11038
40510,Antoine,Speares,aspeares2n@stanford.edu,Financial Analyst,4190,1602,5792
40299,Josie,Hitcham,jhitcham2o@google.de,Professor,1026,1982,3008
40154,Muffin,McNeigh,mmcneigh2q@g.co,Account Coordinator,7065,872,7937
40562,Cacilia,Daughton,cdaughton2r@dagondesign.com,Financial Advisor,1375,1209,2584
40211,Micheline,Gooderson,mgooderson2s@cmu.edu,Quality Engineer,6678,1737,8415
40903,Riannon,Lafferty,rlafferty2t@qq.com,Business Systems Development Analyst,1232,1460,2692
40528,Augy,Gheeorghie,agheeorghie2u@blogtalkradio.com,Web Designer III,6943,525,7468
40665,Sigfried,Whal,swhal2v@csmonitor.com,Programmer II,2246,1343,3589
40605,Cornie,Ship,cship2w@foxnews.com,Product Engineer,7880,1213,9093
40296,Daron,Lief,dlief2x@weebly.com,Safety Technician II,1837,1810,3647
40802,Worthy,Berni,wberni2z@tripod.com,Operator,9794,565,10359
40976,Cecile,Dedden,cdedden30@cbslocal.com,Software Engineer I,6990,966,7956
40176,Janeen,McLewd,jmclewd31@wisc.edu,Civil Engineer,2849,481,3330
40134,Rita,Bowdon,rbowdon32@addthis.com,Nuclear Power Engineer,5634,655,6289
40207,Rodd,Stebbings,rstebbings33@illinois.edu,Teacher,4815,537,5352
40932,Timofei,Nimmo,tnimmo34@unblog.fr,Software Test Engineer IV,8458,1190,9648
40461,Osmund,Spyvye,ospyvye35@nsw.gov.au,VP Sales,7628,1740,9368
40962,Callida,Allbrook,callbrook36@t-online.de,Clinical Specialist,2389,898,3287
40908,Saunderson,Luciano,sluciano37@ucla.edu,Environmental Specialist,5620,1510,7130
40472,Boonie,Burnell,bburnell38@msu.edu,Structural Engineer,5398,1453,6851
40242,Sheelagh,Stoll,sstoll39@taobao.com,Mechanical Systems Engineer,5047,785,5832
40715,Cornie,Dun,cdun3b@naver.com,Statistician IV,5616,1016,6632
40634,Tymon,Stockwell,tstockwell3c@paginegialle.it,Technical Writer,8274,1550,9824
40983,Connor,Aylett,caylett3d@xrea.com,Internal Auditor,8353,545,8898
40502,Tyne,Bertin,tbertin3e@hostgator.com,Help Desk Operator,9240,1638,10878
40160,Donaugh,Thaxter,dthaxter3f@dagondesign.com,Legal Assistant,8295,902,9197
40718,Martino,Wadeling,mwadeling3g@google.it,Technical Writer,5465,246,5711
40161,Olivette,Keuning,okeuning3h@github.com,Marketing Assistant,9422,1855,11277
40260,Madalyn,Culbert,mculbert3i@psu.edu,Assistant Manager,6172,1163,7335
40767,Sunshine,Bew,sbew3j@whitehouse.gov,Civil Engineer,9298,1087,10385
40951,Bartholomew,Pilbury,bpilbury3l@shinystat.com,Statistician IV,2619,461,3080
40028,Kennie,Bompass,kbompass3m@alexa.com,Pharmacist,8952,993,9945
40229,Karl,Pideon,kpideon3n@aboutads.info,Office Assistant I,4261,462,4723
40303,Sidoney,Cuel,scuel3p@msn.com,Accounting Assistant I,9747,314,10061
40163,Henka,Chaise,hchaise3q@netvibes.com,Web Designer I,5286,510,5796
40021,Jeri,Iglesia,jiglesia3r@topsy.com,Clinical Specialist,2191,967,3158
40784,Benito,Mewis,bmewis3s@ox.ac.uk,Compensation Analyst,1044,460,1504
40400,Laverna,Reedie,lreedie3u@uiuc.edu,Account Coordinator,5765,1595,7360
40398,Benedicta,Edmonson,bedmonson3v@samsung.com,Developer IV,6565,423,6988
40183,Sonia,Lorrie,slorrie3w@storify.com,Human Resources Manager,5090,1858,6948
40049,Gauthier,McCarver,gmccarver3x@google.co.uk,Junior Executive,5094,538,5632
40221,Babb,Reven,breven3y@ucoz.com,Accounting Assistant IV,7344,1894,9238
40654,Dorolisa,Woolford,dwoolford40@bloglovin.com,VP Sales,4857,1434,6291
40067,Davida,Fulker,dfulker41@google.co.jp,Actuary,7583,1053,8636
40066,Laure,Hebblewhite,lhebblewhite43@cmu.edu,Software Test Engineer III,8085,380,8465
40029,Iago,Thornhill,ithornhill44@harvard.edu,Product Engineer,9290,1086,10376
40145,Marja,Gibling,mgibling45@intel.com,Engineer II,4526,1214,5740
40723,Rudyard,Denne,rdenne46@sina.com.cn,Information Systems Manager,7423,1419,8842
40223,Fee,Olivari,folivari47@de.vu,Tax Accountant,1135,1510,2645
40847,Christi,Jarritt,cjarritt4a@devhub.com,Systems Administrator II,2161,1871,4032
40581,Adolf,Cerro,acerro4b@yahoo.com,Financial Analyst,9237,1400,10637
40576,Trista,Morrissey,tmorrissey4c@google.it,General Manager,7837,641,8478
40971,Frederich,Luke,fluke4d@over-blog.com,Programmer III,1254,692,1946
40507,Rusty,Cardenosa,rcardenosa4e@yellowpages.com,Biostatistician II,8669,312,8981
40724,Aurlie,Abys,aabys4h@google.nl,Associate Professor,2857,981,3838
40092,Lancelot,Forsyth,lforsyth4i@cnbc.com,Media Manager II,9765,819,10584
40236,Lee,Agirre,lagirre4j@google.ca,Administrative Assistant IV,6455,1392,7847
40574,Joey,McPhelimey,jmcphelimey4k@sourceforge.net,Senior Sales Associate,7444,1930,9374
40719,Johna,Birney,jbirney4l@flickr.com,Budget/Accounting Analyst II,3265,241,3506
40290,Elinore,Jude,ejude4m@patch.com,Electrical Engineer,8667,1897,10564
40008,Vere,Maggill'Andreis,vmaggillandreis4n@bizjournals.com,Senior Editor,3938,1856,5794
40930,Matilde,Sango,msango4o@surveymonkey.com,Sales Associate,2682,1443,4125
40002,Osbert,Folks,ofolks4p@mozilla.org,Graphic Designer,1573,1718,3291
40520,Audie,Jeannard,ajeannard4q@bluehost.com,Operator,1428,1077,2505
40140,Zaneta,Kinver,zkinver4r@gizmodo.com,Clinical Specialist,5723,217,5940
40808,Stanfield,Thody,sthody4s@google.cn,Engineer III,8384,321,8705
40009,Helenelizabeth,Tredget,htredget4u@netlog.com,Product Engineer,1691,684,2375
40256,Stephi,Veque,sveque4v@psu.edu,Staff Scientist,6724,471,7195
40343,Salvatore,Rzehor,srzehor4w@angelfire.com,Help Desk Operator,8222,1631,9853
40856,Christopher,Mallen,cmallen4x@yellowpages.com,Sales Associate,6928,1173,8101
40255,Sarena,Chelam,schelam4y@moonfruit.com,Account Coordinator,5896,255,6151
40219,Fair,Shimmings,fshimmings4z@answers.com,Senior Quality Engineer,4567,1884,6451
40635,Neysa,Heatly,nheatly51@amazon.co.uk,Food Chemist,5293,736,6029
40765,Blanch,Whayman,bwhayman52@admin.ch,Tax Accountant,7861,528,8389
40659,Justina,Paradine,jparadine53@booking.com,Junior Executive,6705,293,6998
40496,Emmaline,Rydeard,erydeard54@pinterest.com,Nurse Practicioner,3668,825,4493
40412,Deedee,Ianizzi,dianizzi55@mapy.cz,Occupational Therapist,8541,1631,10172
40244,Tedie,Scarce,tscarce56@go.com,VP Quality Control,3819,1184,5003
40402,Verna,Coupland,vcoupland58@themeforest.net,Computer Systems Analyst III,6969,1615,8584
40656,Ethelred,Sale,esale59@hao123.com,VP Accounting,9498,401,9899
40384,Terencio,Dobrovolski,tdobrovolski5a@go.com,Data Coordiator,5511,1296,6807
40973,Hube,Outhwaite,houthwaite5b@soundcloud.com,Community Outreach Specialist,5220,744,5964
40673,Skippie,Lonsdale,slonsdale5c@slashdot.org,Desktop Support Technician,5035,1186,6221
40648,Matthus,Bauchop,mbauchop5d@wunderground.com,Payment Adjustment Coordinator,4297,413,4710
40505,Shelly,Hamner,shamner5f@exblog.jp,Internal Auditor,8693,1061,9754
40386,Kristel,Cawthry,kcawthry5g@springer.com,Civil Engineer,7885,1118,9003
40850,Pascale,Mitchenson,pmitchenson5h@unicef.org,VP Sales,3447,915,4362
40757,Lenee,Gallego,lgallego5i@alibaba.com,Environmental Tech,5328,1383,6711
40924,Lenore,Tampion,ltampion5j@arizona.edu,Assistant Media Planner,7463,1240,8703
40287,Hakeem,Primo,hprimo5k@jugem.jp,Programmer IV,6493,441,6934
40174,Kandace,Slaymaker,kslaymaker5m@slate.com,General Manager,3568,725,4293
40747,Kimberli,McEllen,kmcellen5n@europa.eu,Quality Control Specialist,7695,1590,9285
40817,Cletus,Leney,cleney5o@sphinn.com,Product Engineer,3937,1940,5877
40834,Freedman,Nuton,fnuton5p@uol.com.br,Social Worker,4936,1624,6560
40625,Harland,McGibbon,hmcgibbon5q@rakuten.co.jp,Web Developer I,5598,916,6514
40247,Nettie,Bedo,nbedo5r@about.me,Operator,6463,1292,7755
40378,Seth,Huggett,shuggett5s@usatoday.com,Web Designer II,9666,1898,11564
40685,Greta,Siviour,gsiviour5t@ucla.edu,Accountant I,9505,646,10151
40381,Darcie,Rendall,drendall5u@unesco.org,Pharmacist,6525,1511,8036
40910,Addie,Dykes,adykes5v@arizona.edu,Product Engineer,7097,1076,8173
40492,Cindra,Cota,ccota5w@ftc.gov,Statistician III,7980,810,8790
40488,Debora,Tewkesbury.,dtewkesbury5x@smh.com.au,Office Assistant II,9308,1372,10680
40991,Bobbee,Riglesford,briglesford5y@fema.gov,VP Sales,5498,221,5719
40906,Luis,Westwick,lwestwick60@example.com,Professor,1601,1378,2979
40846,Tab,Tummons,ttummons61@github.io,Electrical Engineer,9637,970,10607
40379,Ellwood,Braithwait,ebraithwait63@mtv.com,Nuclear Power Engineer,4566,714,5280
40391,Juliette,Butner,jbutner64@typepad.com,Editor,6544,680,7224
40107,Terrill,Eves,teves65@theguardian.com,Food Chemist,1596,556,2152
40238,Wynny,Grigorian,wgrigorian68@weather.com,Office Assistant IV,7213,1480,8693
40439,Klarrisa,Sigart,ksigart69@mozilla.com,Technical Writer,5805,1473,7278
40706,Rik,Bricksey,rbricksey6a@reverbnation.com,Statistician II,2383,427,2810
40233,Lida,Sturm,lsturm6b@businessinsider.com,Compensation Analyst,8401,1618,10019
40318,Forbes,Thome,fthome6c@a8.net,Administrative Officer,3353,916,4269
40155,Denny,Dargue,ddargue6d@amazon.co.jp,Account Executive,1325,348,1673
40040,Reuven,Riolfo,rriolfo6e@godaddy.com,Quality Control Specialist,7822,1773,9595
40936,Aila,Pillifant,apillifant6f@dropbox.com,Automation Specialist II,6021,1063,7084
40189,Wylma,Chasen,wchasen6g@cisco.com,Civil Engineer,6007,1475,7482
40992,Joaquin,Masden,jmasden6i@omniture.com,Programmer III,8580,1479,10059
40477,Dev,Archambault,darchambault6j@fotki.com,Assistant Professor,5632,1949,7581
40414,Nikoletta,Dinnage,ndinnage6k@forbes.com,VP Accounting,3175,939,4114
40127,Ilario,Reolfo,ireolfo6l@phpbb.com,Database Administrator IV,3004,490,3494
40669,Issie,Kaplan,ikaplan6m@webeden.co.uk,Teacher,5121,302,5423
40133,Gene,Barnett,gbarnett6n@naver.com,Recruiter,1491,250,1741
40790,Mathe,Sowden,msowden6o@chicagotribune.com,Social Worker,2848,1923,4771
40069,Ignatius,Staves,istaves6p@boston.com,Assistant Professor,2110,587,2697
40409,Vinni,Kleinholz,vkleinholz6r@addtoany.com,Administrative Officer,1834,1606,3440
40781,Kenna,Kings,kkings6s@huffingtonpost.com,Legal Assistant,4297,1030,5327
40511,Newton,Coke,ncoke6t@about.com,Speech Pathologist,8315,849,9164
40950,Catlee,Ruddy,cruddy6v@hibu.com,Assistant Professor,4129,917,5046
40838,Maddy,Wilcocke,mwilcocke6x@moonfruit.com,Research Assistant IV,2039,758,2797
40052,Janine,Conerding,jconerding6y@foxnews.com,Project Manager,3565,1269,4834
40374,Aubrette,Dicke,adicke6z@wp.com,Developer III,1085,1987,3072
40622,Jory,Longhi,jlonghi70@cloudflare.com,Assistant Media Planner,5041,1951,6992
40227,Lisette,Fuge,lfuge72@intel.com,Community Outreach Specialist,4899,1359,6258
40322,Kiele,Plaskett,kplaskett73@opera.com,Human Resources Manager,5547,258,5805
40612,Bevan,Yoodall,byoodall74@clickbank.net,Biostatistician I,6483,1260,7743
40220,Burty,Shorton,bshorton77@bizjournals.com,Help Desk Technician,9603,1146,10749
40301,Lindsey,Caw,lcaw78@census.gov,Social Worker,8016,1342,9358
40258,Yance,Gorthy,ygorthy79@hostgator.com,Research Assistant II,4084,1285,5369
40566,Hulda,Gauntley,hgauntley7a@ucla.edu,Office Assistant I,3037,1146,4183
40037,Reeta,Eldridge,reldridge7b@digg.com,Food Chemist,4212,1193,5405
40827,Gun,Batts,gbatts7c@yahoo.co.jp,Analyst Programmer,4618,1836,6454
40291,Iosep,Ugoletti,iugoletti7d@cloudflare.com,Account Representative IV,7445,1656,9101
40148,Fawn,Blasiak,fblasiak7e@zdnet.com,Software Consultant,2975,866,3841
40874,Kendre,Lummasana,klummasana7f@hostgator.com,Social Worker,7301,1704,9005
40348,Alex,Noyes,anoyes7g@ft.com,Environmental Specialist,2800,1967,4767
40558,Saundra,Lilleycrop,slilleycrop7h@jimdo.com,General Manager,9493,751,10244
40671,Adella,Hucklesby,ahucklesby7i@altervista.org,Senior Developer,5190,1123,6313
40953,Karrah,Tukesby,ktukesby7j@wiley.com,Desktop Support Technician,9169,1672,10841
40753,Ofelia,Gillison,ogillison7l@loc.gov,GIS Technical Architect,5097,1215,6312
40471,Tallulah,Wardle,twardle7m@va.gov,Legal Assistant,5582,527,6109
40385,Moises,Grinikhinov,mgrinikhinov7n@stanford.edu,Social Worker,3776,1173,4949
40073,Alia,Cogin,acogin7o@theglobeandmail.com,Budget/Accounting Analyst I,4505,1402,5907
40330,Norton,Cudde,ncudde7p@wired.com,Computer Systems Analyst IV,4817,425,5242
40351,Ragnar,Evitt,revitt7r@purevolume.com,Operator,1626,1433,3059
40700,Cherilynn,Adanet,cadanet7s@is.gd,Staff Scientist,2720,1005,3725
40637,Zita,Anetts,zanetts7u@t-online.de,Analyst Programmer,9154,1326,10480
40156,Halsey,Vatcher,hvatcher7x@yale.edu,Nuclear Power Engineer,8190,1711,9901
40876,Mattias,Murcutt,mmurcutt7z@who.int,Associate Professor,5623,794,6417
40286,Mirella,Stockhill,mstockhill81@telegraph.co.uk,Nurse Practicioner,9214,522,9736
40624,Sigvard,Berzons,sberzons83@etsy.com,Human Resources Manager,2181,1456,3637
40865,Norine,Azemar,nazemar84@usgs.gov,Environmental Specialist,7478,405,7883
40710,Marijo,Lishmund,mlishmund85@networkadvertising.org,Legal Assistant,6349,884,7233
40329,Trixie,Swinley,tswinley86@trellian.com,Help Desk Technician,5214,1979,7193
40693,Halette,Izen,hizen87@studiopress.com,Community Outreach Specialist,7820,1330,9150
40701,Raye,Gasking,rgasking88@privacy.gov.au,Internal Auditor,8819,543,9362
40222,Krisha,Anster,kanster89@parallels.com,Internal Auditor,8080,1870,9950
40249,Micheline,Lancastle,mlancastle8a@home.pl,Cost Accountant,9076,448,9524
40868,Cleopatra,Darton,cdarton8b@angelfire.com,Information Systems Manager,7057,228,7285
40583,Georgine,Scarse,gscarse8c@nih.gov,Help Desk Operator,8728,1133,9861
40235,Reba,Janecek,rjanecek8d@sciencedaily.com,Media Manager I,9627,1122,10749
40631,Juline,McCaughran,jmccaughran8f@examiner.com,Staff Accountant II,7867,980,8847
40985,Libbey,Mooreed,lmooreed8g@multiply.com,VP Product Management,9209,912,10121
40909,Artemus,Fenich,afenich8h@mlb.com,Senior Sales Associate,5347,734,6081
40452,Bobbi,Brittain,bbrittain8j@mysql.com,Financial Analyst,7291,696,7987
40448,Bria,Haye,bhaye8l@google.de,Chief Design Engineer,5486,1973,7459
40787,Kincaid,Python,kpython8m@fc2.com,Information Systems Manager,1015,1801,2816
40234,Helene,Hattigan,hhattigan8n@hatena.ne.jp,Computer Systems Analyst II,4988,374,5362
40457,Kaila,Olivari,kolivari8o@theatlantic.com,Programmer II,8481,1258,9739
40304,Matthieu,Sabbins,msabbins8p@creativecommons.org,Quality Control Specialist,4158,1660,5818
40550,Cherry,Gajownik,cgajownik8s@cmu.edu,Speech Pathologist,9034,1240,10274
40098,Germana,Noteyoung,gnoteyoung8u@who.int,Internal Auditor,6060,804,6864
40853,Hanni,Garner,hgarner8v@sphinn.com,Nuclear Power Engineer,7877,1086,8963
40636,Bastien,Zoellner,bzoellner8w@wikia.com,Assistant Media Planner,4078,901,4979
40789,Chryste,Cottel,ccottel8y@php.net,Community Outreach Specialist,2747,245,2992
40152,Gwenny,Lapslie,glapslie90@de.vu,Legal Assistant,4183,678,4861
40826,Bernadene,Linnell,blinnell93@paypal.com,Quality Control Specialist,8909,459,9368
40349,Carolee,McLese,cmclese95@storify.com,Project Manager,7202,1858,9060
40376,Lawrence,Doerling,ldoerling97@biblegateway.com,Recruiter,3102,1976,5078
40879,Wilbert,Woosnam,wwoosnam98@blogtalkradio.com,Actuary,8425,1494,9919
40382,Tull,Hayford,thayford99@dot.gov,Staff Accountant II,8420,811,9231
40128,Jereme,Woodberry,jwoodberry9a@va.gov,Programmer IV,8551,292,8843
40187,Laney,Grisley,lgrisley9b@imgur.com,Safety Technician I,2111,1240,3351
40880,Walden,Giovannilli,wgiovannilli9c@amazonaws.com,Clinical Specialist,4667,1818,6485
40941,Taite,Slark,tslark9d@loc.gov,Director of Sales,5207,922,6129
40570,Huntley,Greenrde,hgreenrde9e@google.fr,Teacher,1922,1018,2940
40027,Dion,Klimochkin,dklimochkin9f@mediafire.com,Assistant Media Planner,1853,570,2423
40356,Naoma,Lubeck,nlubeck9h@qq.com,Chief Design Engineer,2617,1874,4491
40937,Kliment,Rutley,krutley9j@gmpg.org,Operator,9326,1341,10667
40836,Luci,Hazeltine,lhazeltine9k@addthis.com,Computer Systems Analyst IV,9656,1715,11371
40530,Marjory,Annets,mannets9n@hhs.gov,Research Associate,5531,1369,6900
40342,Antonia,Smetoun,asmetoun9p@yale.edu,Internal Auditor,4899,1294,6193
40383,Leah,Reschke,lreschke9q@instagram.com,Research Associate,3340,765,4105
40748,Paulie,Razoux,prazoux9r@yandex.ru,Data Coordiator,6729,335,7064
40940,Normy,Eatttok,neatttok9s@seesaa.net,Structural Engineer,1409,526,1935
40271,Joceline,Petticrow,jpetticrow9u@blinklist.com,Paralegal,4676,1584,6260
40684,Cybil,Pepperd,cpepperd9v@zdnet.com,Information Systems Manager,3653,416,4069
40121,Norrie,Coryndon,ncoryndon9w@google.fr,Recruiter,3074,1533,4607
40393,Didi,Terzza,dterzza9x@geocities.jp,Geological Engineer,6160,792,6952
40456,Anetta,Buckell,abuckell9y@hibu.com,Assistant Manager,3778,869,4647
40791,Elga,Dulwitch,edulwitcha0@bbc.co.uk,Junior Executive,4278,1541,5819
40125,Mordy,Piser,mpisera1@admin.ch,Structural Engineer,2602,1178,3780
40131,Briny,Chaston,bchastona2@answers.com,Geologist I,3962,389,4351
40712,Doralynn,Callcott,dcallcotta5@flavors.me,Paralegal,9922,1635,11557
40446,Aleta,Whitlow,awhitlowa6@last.fm,Editor,2925,979,3904
40986,Pearl,Peterffy,ppeterffya8@earthlink.net,Cost Accountant,1970,369,2339
40239,Vivia,Scarffe,vscarffea9@instagram.com,Operator,3870,1303,5173
40946,Stefa,Jelly,sjellyaa@com.com,Research Associate,5892,1409,7301
40491,Agnese,Pawley,apawleyab@pbs.org,Assistant Professor,7020,1132,8152
40504,Vinnie,Limeburner,vlimeburnerac@chronoengine.com,Structural Analysis Engineer,3800,1358,5158
40080,Neils,Gindghill,ngindghillad@scribd.com,Civil Engineer,9996,1312,11308
40633,Zechariah,Hawkridge,zhawkridgeaf@vk.com,Clinical Specialist,5016,1436,6452
40688,Berthe,Piaggia,bpiaggiaag@cornell.edu,Human Resources Manager,9484,979,10463
40825,Ora,Trunkfield,otrunkfieldah@huffingtonpost.com,Teacher,6349,1096,7445
40833,Sophie,Napoli,snapoliai@canalblog.com,Dental Hygienist,4705,1474,6179
40611,Phyllida,Caudray,pcaudrayaj@java.com,Account Coordinator,4333,756,5089
40894,Courtnay,Clues,ccluesam@weebly.com,Statistician II,8588,785,9373
40165,Sarene,Cockman,scockmanao@tmall.com,Automation Specialist II,6456,307,6763
40191,Fredra,Levay,flevayap@cargocollective.com,Senior Quality Engineer,7339,210,7549
40460,Laverne,Tukesby,ltukesbyas@mozilla.org,Community Outreach Specialist,7792,1061,8853
40819,Lynde,Neat,lneatav@zdnet.com,Civil Engineer,7410,538,7948
40100,Paola,Kinzel,pkinzelaw@amazon.co.jp,Clinical Specialist,3183,384,3567
40132,Martyn,Mc-Kerley,mmckerleyay@utexas.edu,Desktop Support Technician,9620,1901,11521
40572,Alika,Sullly,asulllyaz@state.tx.us,Librarian,7016,1242,8258
40614,Harlie,Fillon,hfillonb1@mozilla.com,Physical Therapy Assistant,8863,1026,9889
40198,Iggie,Levesley,ilevesleyb2@springer.com,Professor,6349,1275,7624
40240,Flory,McCleod,fmccleodb3@jigsy.com,Account Executive,2266,1464,3730
40088,Stormie,Menco,smencob4@home.pl,Product Engineer,3018,1228,4246
40769,Teodora,Bunclark,tbunclarkb5@devhub.com,Social Worker,7340,671,8011
40832,Marylynne,De la Yglesia,mdelayglesiab7@examiner.com,Programmer Analyst I,6693,1344,8037
40674,Loella,Frissell,lfrissellb8@vk.com,Geological Engineer,8955,655,9610
40218,Swen,Pennell,spennellba@pen.io,Actuary,6758,1324,8082
40734,Diandra,Cheesman,dcheesmanbb@vkontakte.ru,Statistician I,5978,251,6229
40972,Carol-jean,Azemar,cazemarbc@webs.com,Social Worker,5749,590,6339
40822,Hayley,Nuttey,hnutteybd@xing.com,Research Associate,7502,1248,8750
40091,Boris,Biggans,bbiggansbf@networksolutions.com,VP Marketing,4009,432,4441
40926,Garrik,Paulus,gpaulusbj@nymag.com,General Manager,6295,678,6973
40397,Morgen,Akett,makettbl@latimes.com,Web Developer III,8430,224,8654
40798,Les,Cejka,lcejkabm@europa.eu,Information Systems Manager,3635,629,4264
40996,Ferdy,Aylett,faylettbo@adobe.com,Accountant II,9112,519,9631
40012,Nona,Bollands,nbollandsbp@xing.com,Media Manager II,2781,421,3202
40820,Iggy,Grigs,igrigsbs@vkontakte.ru,Web Designer I,3519,334,3853
40535,Otho,Harverson,oharversonbt@etsy.com,Pharmacist,3266,584,3850
40077,Lydia,Wonter,lwonterbv@ow.ly,Project Manager,6943,861,7804
40725,Tamiko,Firby,tfirbybx@hud.gov,Programmer Analyst IV,5712,970,6682
40575,Alis,Vossing,avossingby@moonfruit.com,Research Nurse,2530,595,3125
40252,Alfie,De Zuani,adezuanibz@loc.gov,Account Executive,3744,1005,4749
40888,Em,Linebarger,elinebargerc3@people.com.cn,Quality Control Specialist,6844,435,7279
40989,Eden,Bosma,ebosmac4@google.co.uk,Financial Analyst,7022,1751,8773
40886,Diahann,Greatbank,dgreatbankc6@goo.ne.jp,Software Test Engineer IV,3792,387,4179
40705,Floyd,Godfery,fgodferyc7@globo.com,Assistant Professor,4233,1672,5905
40774,Quentin,Skowcraft,qskowcraftca@pen.io,Administrative Assistant II,7939,1574,9513
40038,Erinn,Toffel,etoffelcc@tiny.cc,Geologist I,5154,1980,7134
40046,Maren,Hambric,mhambriccd@sciencedaily.com,Safety Technician II,7719,1626,9345
40810,Blondell,Piercy,bpiercyce@vinaora.com,VP Accounting,4286,1488,5774
40842,Ruthann,Taw,rtawcf@yandex.ru,Electrical Engineer,4701,1617,6318
40546,Stefanie,Sallings,ssallingsci@dyndns.org,Computer Systems Analyst I,3793,567,4360
40261,Aileen,Goodman,agoodmanck@wordpress.org,Business Systems Development Analyst,5669,760,6429
40362,Enid,Ickovic,eickoviccm@bizjournals.com,Internal Auditor,5630,1159,6789
40587,Lorenza,MacGee,lmacgeeco@gmpg.org,Quality Control Specialist,6618,1610,8228
40051,Steven,Mandeville,smandevillecp@ehow.com,Compensation Analyst,5102,1309,6411
40966,Llewellyn,Cowderay,lcowderaycs@desdev.cn,Programmer I,9191,1679,10870
40927,Eliza,Greason,egreasonct@dropbox.com,Research Nurse,7518,281,7799
40367,Vitia,Brooker,vbrookercu@mysql.com,Desktop Support Technician,6237,1659,7896
40208,Doro,Keelin,dkeelincv@examiner.com,Safety Technician II,7474,274,7748
40177,Irvin,Lumsdon,ilumsdoncw@fc2.com,Senior Editor,6775,798,7573
40727,Borden,Prandy,bprandycx@earthlink.net,Associate Professor,8274,1252,9526
40733,Hanny,Rambaut,hrambautcy@wiley.com,Senior Financial Analyst,7405,1086,8491
40420,William,Blaze,wblazecz@so-net.ne.jp,Senior Developer,1899,1933,3832
40578,Matias,Stoney,mstoneyd0@photobucket.com,Community Outreach Specialist,1711,259,1970
40644,Kahaleel,Bridgwater,kbridgwaterd1@epa.gov,Chief Design Engineer,3220,1038,4258
40435,Laraine,Minihan,lminihand2@deviantart.com,Geologist III,3625,493,4118
40571,Huberto,McWard,hmcwardd3@aboutads.info,Electrical Engineer,9544,269,9813
40110,Sax,Hallad,shalladd5@java.com,Analyst Programmer,2008,353,2361
40363,Annabelle,Videler,avidelerd6@live.com,Accountant II,7330,1273,8603
40307,Carlee,Biskup,cbiskupd8@nymag.com,Research Nurse,4414,1193,5607
40266,Tabbie,Geffcock,tgeffcockd9@wired.com,Assistant Manager,4296,1718,6014
40410,Brantley,Verry,bverrydb@purevolume.com,Assistant Professor,5229,647,5876
40524,Evangelia,Edgerley,eedgerleyde@fastcompany.com,Programmer Analyst I,1371,1152,2523
40432,Arlee,Barnwall,abarnwalldf@nydailynews.com,Pharmacist,6841,831,7672
40864,Bria,Gleadhell,bgleadhelldk@t-online.de,Safety Technician IV,2419,1162,3581
40599,Brooke,Cush,bcushdl@ibm.com,Director of Sales,1058,238,1296
40848,Myra,Syratt,msyrattdm@shop-pro.jp,Speech Pathologist,1082,1114,2196
40921,Reeva,Grinyov,rgrinyovdn@theglobeandmail.com,Tax Accountant,5574,1165,6739
40061,Juieta,Sabatier,jsabatierdo@home.pl,VP Marketing,4930,429,5359
40323,Bastian,Florey,bfloreydp@samsung.com,Nurse,4677,1458,6135
40643,Dieter,Veltmann,dveltmanndq@foxnews.com,Speech Pathologist,4842,1225,6067
40387,Alf,Kennicott,akennicottdr@woothemes.com,Health Coach IV,1903,1889,3792
40607,Peyter,Leuty,pleutyds@google.co.jp,Chemical Engineer,8729,350,9079
40375,Kaila,Chazotte,kchazottedu@nsw.gov.au,Mechanical Systems Engineer,4154,1943,6097
40248,Adelind,Pocke,apockedw@myspace.com,Chief Design Engineer,5482,682,6164
40779,Bernadine,Bonus,bbonusdy@imdb.com,Payment Adjustment Coordinator,4250,1900,6150
40987,Linc,Praundlin,lpraundlindz@webeden.co.uk,Accountant II,8323,651,8974
40933,Cameron,Gulliford,cgulliforde0@nih.gov,Account Coordinator,9671,1050,10721
40771,Jacky,Gillani,jgillanie3@bloomberg.com,Paralegal,9471,1311,10782
40559,Violante,Lumby,vlumbye5@army.mil,Clinical Specialist,1147,1132,2279
40929,Ddene,Aspinal,daspinale6@state.gov,Recruiting Manager,3611,694,4305
40032,Howie,Axford,haxforde8@blinklist.com,Nuclear Power Engineer,1082,1514,2596
40401,Guthrey,Saura,gsaurae9@timesonline.co.uk,Software Consultant,6863,503,7366
40961,Juliet,Tingcomb,jtingcombee@youtube.com,Software Engineer I,1212,1111,2323
40377,Jilleen,Wathell,jwathelleg@scribd.com,Marketing Manager,2805,1044,3849
40518,Base,Wildgoose,bwildgooseei@berkeley.edu,Data Coordiator,1209,1946,3155
40828,Case,Wharfe,cwharfeek@narod.ru,Senior Editor,5255,1137,6392
40173,Carolann,Fettes,cfettesem@miitbeian.gov.cn,Account Representative II,7428,1164,8592
40877,Elliot,Doget,edogeter@utexas.edu,Paralegal,8888,742,9630
40468,Roanna,Driussi,rdriussiet@yellowbook.com,Speech Pathologist,7020,1093,8113
40359,Georgine,Zute,gzuteew@weather.com,Assistant Media Planner,1561,624,2185
40573,Birdie,Dockray,bdockrayex@statcounter.com,Environmental Specialist,3682,1370,5052
40166,Ernesta,Overton,eovertoney@storify.com,Programmer III,3180,695,3875
40141,Stephanie,McKeachie,smckeachieez@nsw.gov.au,Editor,2317,1104,3421
40465,Carlyn,Dumbare,cdumbaref0@pen.io,Associate Professor,6212,1526,7738
40413,Mill,Pellman,mpellmanf1@twitpic.com,Assistant Media Planner,9670,266,9936
40399,Berkeley,Evanson,bevansonf6@businesswire.com,Software Test Engineer II,6547,785,7332
40699,Jethro,Kedie,jkedief7@sciencedirect.com,Media Manager I,6250,588,6838
40875,Rufe,Clohisey,rclohiseyfa@dailymail.co.uk,Senior Developer,5554,1851,7405
40975,Haydon,Patry,hpatryfg@mit.edu,Chemical Engineer,3642,725,4367
40438,Desi,Yuranovev,dyuranovevfi@nih.gov,VP Accounting,2011,261,2272
40952,Germaine,Jodlkowski,gjodlkowskifl@prweb.com,Help Desk Operator,4518,1229,5747
40437,Packston,Briance,pbriancefo@kickstarter.com,Staff Scientist,3422,1231,4653
40977,Obie,Bambrick,obambrickfp@hostgator.com,Teacher,9970,1533,11503
40136,Jacobo,Molden,jmoldenfs@woothemes.com,Data Coordiator,6404,685,7089
40464,Jefferey,Loadsman,jloadsmang2@theglobeandmail.com,Professor,3651,931,4582
40158,Joellen,Edginton,jedgintong5@hp.com,Nurse Practicioner,2998,683,3681
40135,Marquita,Squibb,msquibbg7@foxnews.com,Software Engineer I,4476,389,4865
40739,Dunn,Busek,dbusekg9@is.gd,Geologist III,2018,1256,3274
40963,Shelden,Pennick,spennickgc@arstechnica.com,Geological Engineer,8516,973,9489
40273,Loren,Mattecot,lmattecotgg@cdbaby.com,Human Resources Assistant II,6907,508,7415
40872,Dolf,Sapey,dsapeygi@fc2.com,Environmental Specialist,2949,1533,4482
40964,Aimee,Deverell,adeverellgl@purevolume.com,Civil Engineer,5868,552,6420
40547,Wood,Wevell,wwevellgm@theatlantic.com,Software Consultant,6354,492,6846
40094,Vern,Phair,vphairgn@dyndns.org,Business Systems Development Analyst,2487,482,2969
40697,Harmonia,Raymont,hraymontgo@weibo.com,Administrative Officer,7976,445,8421
40331,Dallas,Elsmore,delsmoregp@vkontakte.ru,Human Resources Manager,2343,625,2968
40615,Karisa,Fedynski,kfedynskigq@dell.com,Business Systems Development Analyst,7644,1496,9140
40019,Claretta,Geere,cgeeregr@miibeian.gov.cn,Staff Accountant IV,1203,1619,2822
40561,Fredrick,Simonnot,fsimonnotgs@mail.ru,Senior Quality Engineer,4117,653,4770
40146,Rosmunda,Janjusevic,rjanjusevicgt@upenn.edu,Analog Circuit Design manager,5872,390,6262
40353,D'arcy,Roscoe,droscoegv@parallels.com,Chief Design Engineer,6900,1029,7929
40314,Marleen,Hayhurst,mhayhurstgw@geocities.com,VP Marketing,5233,1927,7160
40445,Hailey,Grisley,hgrisleygy@amazon.co.jp,Developer I,5597,1565,7162
40289,Jerald,Burless,jburlessh0@surveymonkey.com,Recruiting Manager,7152,1215,8367
40775,Dene,Garlett,dgarletth1@mapquest.com,Analog Circuit Design manager,1473,1699,3172
40806,Hernando,Mawditt,hmawditth2@fema.gov,Human Resources Assistant III,9504,1850,11354
40119,Antonella,Spencock,aspencockh4@youtu.be,Occupational Therapist,1985,973,2958
40837,Frank,Rembaud,frembaudh6@google.de,Senior Editor,1766,1236,3002
40675,Waite,Pusey,wpuseyh7@themeforest.net,Dental Hygienist,3776,1683,5459
40278,Anni,Maidlow,amaidlowh9@rakuten.co.jp,Software Engineer IV,4258,1165,5423
40967,Ajay,Van der Spohr,avanderspohrha@pagesperso-orange.fr,Nuclear Power Engineer,5367,1727,7094
40114,Tucky,Saunt,tsaunthb@unc.edu,Cost Accountant,5486,1574,7060
40965,Ellswerth,Sommerled,esommerledhc@elegantthemes.com,Developer II,9808,1128,10936
40022,Antoinette,Roselli,arosellihf@technorati.com,Statistician III,8092,229,8321
40039,Gaylor,Arthurs,garthurshg@istockphoto.com,VP Marketing,1925,1423,3348
40169,Fee,Cheel,fcheelhh@discuz.net,Director of Sales,9977,1382,11359
40300,Reinhard,Chivers,rchivershi@shareasale.com,Analyst Programmer,7684,753,8437
40835,Tildy,Castelyn,tcastelynhj@abc.net.au,Food Chemist,6286,1192,7478
40168,Junette,Growy,jgrowyhk@washingtonpost.com,Actuary,6846,1711,8557
40014,Kingston,Aimson,kaimsonhl@oracle.com,Biostatistician III,5295,1232,6527
40707,Renaldo,Trewhitt,rtrewhitthm@redcross.org,Developer I,7343,1142,8485
40824,Elvira,Tutsell,etutsellho@uiuc.edu,Help Desk Technician,8023,695,8718
40687,Noble,Pothecary,npothecaryhr@aboutads.info,Nurse,9725,1836,11561
40652,Nicko,Arrighetti,narrighettiht@slashdot.org,Quality Control Specialist,3322,1353,4675
40101,Conni,Lartice,clarticehu@go.com,Assistant Media Planner,6756,393,7149
40453,Charyl,Jefferd,cjefferdhx@cbslocal.com,Community Outreach Specialist,3662,727,4389
40509,Ambros,Bendle,abendlehy@unblog.fr,Account Representative II,9319,228,9547
40682,Ogden,Gudgeon,ogudgeonhz@webmd.com,Chief Design Engineer,6642,1349,7991
40217,Juditha,Adds,jaddsi0@51.la,Staff Scientist,9426,693,10119
40678,Lanita,Wyeld,lwyeldi1@creativecommons.org,Senior Cost Accountant,1907,530,2437
40568,Obadiah,Luter,oluteri3@redcross.org,Quality Control Specialist,3457,1206,4663
40366,Franni,Reolfo,freolfoi4@cbslocal.com,Quality Engineer,9366,1672,11038
40586,Emili,Dyson,edysoni5@fotki.com,Help Desk Technician,9073,580,9653
40481,Elora,Farrow,efarrowi6@epa.gov,Environmental Tech,4220,1910,6130
40912,Hilary,Van Dalen,hvandaleni7@t-online.de,Technical Writer,1378,1701,3079
40016,Kinna,Tamlett,ktamletti9@jimdo.com,Design Engineer,8711,578,9289
40334,Tait,Cooke,tcookeia@t-online.de,Recruiter,5569,1919,7488
40606,Chadwick,Renison,crenisonib@blogs.com,Occupational Therapist,5896,1968,7864
40181,Nikolas,Kornilov,nkornilovid@histats.com,Technical Writer,5279,1241,6520
40529,Sasha,Elsworth,selsworthif@java.com,Community Outreach Specialist,4265,1570,5835
40368,Matt,Bonnavant,mbonnavantig@shutterfly.com,Legal Assistant,8418,574,8992
40425,Emalee,Sackes,esackesih@mozilla.com,Actuary,6543,1531,8074
40026,Kirby,Perham,kperhamij@mtv.com,Nurse,9598,1905,11503
40506,Katherina,Thurborn,kthurbornik@usda.gov,Operator,9294,1602,10896
40297,Valeria,Ordemann,vordemannil@fema.gov,Budget/Accounting Analyst III,9534,785,10319
40883,Libbi,Wabersich,lwabersichin@hao123.com,Analyst Programmer,9700,1857,11557
40816,Ethan,Gery,egeryir@privacy.gov.au,Software Test Engineer II,9085,558,9643
40442,Guthrey,Lambol,glambolis@nbcnews.com,Health Coach II,4148,1713,5861
40178,Salvatore,O'Leahy,soleahyiw@fc2.com,VP Quality Control,9213,1131,10344
40042,Prescott,Pywell,ppywelliy@paypal.com,Dental Hygienist,6990,532,7522
40479,Elmira,Tew,etewiz@taobao.com,Payment Adjustment Coordinator,3191,1159,4350
40917,Kiel,Deluca,kdelucaj0@linkedin.com,Developer IV,1517,1802,3319
40857,Morgan,Rainbow,mrainbowj2@ezinearticles.com,Editor,1733,1234,2967
40595,Rosanna,Tighe,rtighej4@ask.com,Nurse,3739,774,4513
40048,Tades,Schroeder,tschroederj6@macromedia.com,Civil Engineer,6753,344,7097
40993,Willyt,Coggan,wcogganj9@tinyurl.com,Nuclear Power Engineer,8175,325,8500
40565,Shane,Jeanenet,sjeanenetjb@icq.com,Web Designer II,2549,964,3513
40055,Nikola,Tilsley,ntilsleyjc@seesaa.net,Civil Engineer,5436,309,5745
40538,Helen,Thursfield,hthursfieldjd@ucoz.com,Compensation Analyst,2716,1956,4672
40441,Budd,Huxham,bhuxhamjf@usnews.com,Recruiter,4365,541,4906
40265,Cornelia,Swapp,cswappjk@wikipedia.org,Software Consultant,2600,1452,4052
40017,Dominica,Diwell,ddiwelljl@multiply.com,Clinical Specialist,3154,691,3845
40162,Anatola,Episcopi,aepiscopijm@wikispaces.com,Mechanical Systems Engineer,5722,690,6412
40436,Salem,Dumbrall,sdumbralljn@macromedia.com,Internal Auditor,3873,982,4855
40759,Saleem,Lebreton,slebretonjq@sogou.com,Electrical Engineer,6661,1620,8281
40539,Lucian,Twelves,ltwelvesjv@techcrunch.com,Information Systems Manager,3765,296,4061
40085,Catriona,Buffey,cbuffeyjx@mail.ru,VP Sales,4404,1192,5596
40554,Jobye,Clearley,jclearleyjy@si.edu,Office Assistant I,5184,1853,7037
40666,Teddie,Gullefant,tgullefantjz@furl.net,Paralegal,6940,272,7212
40843,Allis,Denness,adennessk0@apple.com,Media Manager IV,3962,654,4616
40185,Tate,Liepins,tliepinsk1@flickr.com,Technical Writer,8862,1909,10771
40272,Cherise,Kidston,ckidstonk2@histats.com,Administrative Officer,1841,410,2251
40228,Adelina,Beagen,abeagenk3@wp.com,Financial Analyst,6997,323,7320
40264,Ginger,Ayscough,gayscoughk6@telegraph.co.uk,Quality Engineer,5259,428,5687
40190,Karlik,Wordsworth,kwordsworthk7@smh.com.au,VP Sales,9150,1898,11048
40494,Nelson,Powdrell,npowdrellk8@stumbleupon.com,Systems Administrator II,5503,858,6361
40608,Linnie,Cossentine,lcossentinek9@tripod.com,Professor,8083,416,8499
40617,Katey,Perris,kperriskd@angelfire.com,Sales Associate,6822,1012,7834
40841,Helli,Sinderson,hsindersonkf@livejournal.com,Geological Engineer,8767,508,9275
40263,Filide,MacIlwrick,fmacilwrickkg@imgur.com,Health Coach IV,7214,1237,8451
40250,Yanaton,Stanfield,ystanfieldkj@intel.com,Junior Executive,9079,680,9759
40616,Kordula,Lapish,klapishkk@wikimedia.org,Quality Engineer,9093,1862,10955
40280,Elvin,Lyptrade,elyptradekm@berkeley.edu,Structural Analysis Engineer,6700,227,6927
40997,Bertie,Garaghan,bgaraghankr@netlog.com,Executive Secretary,9289,1595,10884
40737,Jemie,Dodds,jdoddskt@washingtonpost.com,Clinical Specialist,2998,1115,4113
40006,Nefen,Rodrigues,nrodriguesky@free.fr,Nurse Practicioner,8054,1112,9166
40760,Duke,Adenet,dadenetkz@odnoklassniki.ru,Electrical Engineer,7829,1148,8977
40618,Amelita,Cromwell,acromwelll0@princeton.edu,Software Test Engineer I,9804,306,10110
40543,Carolus,Straker,cstrakerl2@ucoz.com,Operator,2527,1613,4140
40579,Dulcy,Gooly,dgoolyl7@archive.org,Community Outreach Specialist,1790,1744,3534
40609,Ranique,Hubbuck,rhubbuckl8@tuttocitta.it,Nuclear Power Engineer,8217,1519,9736
40200,Courtnay,Bezzant,cbezzantl9@joomla.org,Administrative Assistant III,2380,1764,4144
40143,Vivia,Cossins,vcossinsla@merriam-webster.com,Engineer III,8546,1256,9802
40519,Maurita,Froud,mfroudle@livejournal.com,Nuclear Power Engineer,9938,577,10515
40777,Monique,Brunet,mbrunetlf@si.edu,Legal Assistant,6244,644,6888
40522,Vanni,Shacklady,vshackladylg@amazon.co.jp,Software Consultant,7467,233,7700
40768,Jule,Ciobutaro,jciobutaroli@parallels.com,Assistant Professor,4882,533,5415
40175,Duff,Sutherden,dsutherdenlk@un.org,Mechanical Systems Engineer,1201,590,1791
40829,Francisca,Levane,flevanelm@miibeian.gov.cn,Desktop Support Technician,5747,1159,6906
40852,Beatrisa,Springtorpe,bspringtorpeln@addthis.com,Speech Pathologist,2887,972,3859
40776,Hermina,Neising,hneisinglo@washington.edu,Internal Auditor,7301,772,8073
40232,Sinclair,Maudson,smaudsonlr@ezinearticles.com,Tax Accountant,7109,275,7384
40761,Alfredo,Labusquiere,alabusquierels@techcrunch.com,Paralegal,2770,1725,4495
40925,Thom,Haugen,thaugenlu@opensource.org,Editor,4670,1994,6664
40584,Heriberto,Babbidge,hbabbidgelx@ning.com,Software Engineer I,9531,1562,11093
40370,Gal,Coule,gcoulely@pbs.org,Health Coach II,4837,503,5340
40891,Tuckie,Semarke,tsemarkem0@chicagotribune.com,Staff Scientist,1950,953,2903
40199,Jodee,Adamsky,jadamskym1@sun.com,Budget/Accounting Analyst I,4490,1663,6153
40904,Jeannine,Tenant,jtenantm2@friendfeed.com,Nuclear Power Engineer,8241,725,8966
40803,Shell,Meere,smeerem3@indiatimes.com,Pharmacist,6429,435,6864
40214,Curt,Fritz,cfritzm4@ezinearticles.com,Staff Accountant II,5626,1844,7470
40321,Lazar,Pochon,lpochonm5@amazon.de,Statistician II,8741,287,9028
40766,Wes,Crann,wcrannm7@issuu.com,Account Coordinator,7349,312,7661
40922,Kikelia,Matevushev,kmatevushevm8@tamu.edu,Web Designer IV,9316,978,10294
40919,Michaeline,Morillas,mmorillasmc@nih.gov,Safety Technician II,3861,326,4187
40469,Luz,Coye,lcoyemd@pen.io,Biostatistician III,5895,1081,6976
40911,Valencia,Ambroise,vambroisemg@g.co,Nurse,9536,1729,11265
40270,Ursulina,Gooderidge,ugooderidgemj@hao123.com,Data Coordiator,7785,957,8742
40942,Maisey,Erridge,merridgemk@boston.com,VP Sales,2148,342,2490
40350,Andrey,Diggins,adigginsmm@desdev.cn,Assistant Professor,3960,1026,4986
40959,Bart,Vedekhin,bvedekhinmn@amazon.com,Staff Scientist,4226,1135,5361
40475,Shena,Peirce,speircemp@4shared.com,Financial Analyst,8273,1886,10159
40662,Lindy,Fulford,lfulfordmx@phpbb.com,Paralegal,4596,1437,6033
40025,Tiffie,Hankey,thankeymy@goodreads.com,Operator,1500,734,2234
40670,Oralie,Balleine,oballeinen0@theatlantic.com,Senior Developer,2757,1377,4134
40390,Ruttger,Wilmore,rwilmoren3@etsy.com,Environmental Tech,5405,854,6259
40075,Dermot,Farthin,dfarthinn4@nationalgeographic.com,Executive Secretary,7614,1310,8924
40431,Lynnett,Giacomasso,lgiacomasson6@statcounter.com,Tax Accountant,4128,830,4958
40809,Daron,Birdall,dbirdalln7@acquirethisname.com,Staff Accountant IV,7365,273,7638
40277,Vinny,Mingardi,vmingardina@google.com.hk,Staff Scientist,3661,243,3904
40429,Sheryl,Vogt,svogtnf@deviantart.com,Account Representative IV,1819,1354,3173
40308,Caitlin,Normant,cnormantng@godaddy.com,Nurse Practicioner,9936,927,10863
40459,Crichton,Sewall,csewallnj@tripod.com,Internal Auditor,6337,306,6643
40517,Nadya,Ivasyushkin,nivasyushkinnk@cloudflare.com,Teacher,8442,1928,10370
40193,Brandice,De Mitris,bdemitrisnm@si.edu,Software Engineer IV,2534,268,2802
40845,Sibel,Killner,skillnerno@bloomberg.com,Statistician II,8792,1140,9932
40592,Deloris,Lytton,dlyttonnp@phpbb.com,Biostatistician IV,6644,306,6950
40068,Roman,O'Rourke,rorourkenr@ifeng.com,Data Coordiator,9972,1429,11401
40324,Katalin,Olenchenko,kolenchenkons@dedecms.com,Geological Engineer,5209,1741,6950
40298,Shina,Reddoch,sreddochnt@netscape.com,Senior Cost Accountant,3705,1215,4920
40650,Gerda,Denty,gdentyny@harvard.edu,Database Administrator I,8292,1289,9581
40664,Marilin,Hacker,mhackernz@t-online.de,Chief Design Engineer,7865,443,8308
40534,Barn,Sayburn,bsayburno3@myspace.com,Analyst Programmer,9691,701,10392
40521,Silvio,Bradnock,sbradnocko6@t-online.de,Paralegal,4718,1573,6291
40722,Kelbee,Quakley,kquakleyo7@cbsnews.com,Accounting Assistant II,8290,862,9152
40224,Gannon,Beinke,gbeinkeo8@ifeng.com,Paralegal,1611,1732,3343
40694,Merry,Flament,mflamentoc@slate.com,Sales Representative,6016,1728,7744
40982,Lefty,Boecke,lboeckeoe@squarespace.com,Tax Accountant,5474,208,5682
40552,Sayer,Brownett,sbrownettof@yellowbook.com,Database Administrator IV,2257,690,2947
40485,Margret,Elwin,melwinog@live.com,GIS Technical Architect,1736,1692,3428
40484,Maxim,Trevaskus,mtrevaskusoh@4shared.com,Health Coach IV,8471,693,9164
40792,Prisca,Kobus,pkobusoi@reddit.com,Legal Assistant,3751,1975,5726
40557,Jayme,Sirmon,jsirmonoj@ifeng.com,Executive Secretary,5883,1224,7107
40548,Ariana,Curtin,acurtinon@bloomberg.com,VP Accounting,9459,358,9817
40023,Jeromy,Tollfree,jtollfreeoo@hibu.com,Web Designer II,1038,587,1625
40279,Gilda,Charlick,gcharlickop@mediafire.com,Environmental Tech,7797,678,8475
40690,Rosemonde,Lightman,rlightmanos@aol.com,Community Outreach Specialist,8513,1277,9790
40523,Lyndy,Stark,lstarkow@mapy.cz,Account Representative IV,3165,1428,4593
40364,Meier,Lotze,mlotzeox@linkedin.com,Biostatistician II,7776,1891,9667
40527,Cecelia,Lawton,clawtonoy@yandex.ru,Pharmacist,7835,1499,9334
40716,Seka,Sayes,ssayesp2@usnews.com,Senior Editor,1498,640,2138
40084,Gena,Kielty,gkieltyp4@nydailynews.com,Payment Adjustment Coordinator,4899,1661,6560
40403,Betti,Hailwood,bhailwoodp7@lulu.com,VP Accounting,8696,674,9370
40679,Nancie,Silcox,nsilcoxpc@twitter.com,Research Associate,2410,1287,3697
40885,Briggs,Sowerbutts,bsowerbuttspf@upenn.edu,Librarian,4109,937,5046
40873,Moe,Bellward,mbellwardpg@ucoz.ru,Account Coordinator,5023,201,5224
40371,Shellysheldon,Oppery,sopperypn@qq.com,Food Chemist,7929,1251,9180
40878,Angelita,Zorzenoni,azorzenonipq@pbs.org,Senior Editor,7357,424,7781
40337,Catarina,Kirsch,ckirschq0@google.nl,Graphic Designer,7225,821,8046
40116,Leland,Pinch,lpinchq1@berkeley.edu,Research Nurse,3556,300,3856
40120,Starr,Ingleson,singlesonq3@vistaprint.com,Structural Engineer,8543,776,9319
40647,Merrill,Keysall,mkeysallq9@ox.ac.uk,Product Engineer,6458,1752,8210
40627,Zorina,Lindenblatt,zlindenblattqa@opera.com,Senior Cost Accountant,4404,1375,5779
40340,Alexa,Joslow,ajoslowqc@uol.com.br,Assistant Manager,6799,1839,8638
40730,Noak,Pugh,npughqj@cbslocal.com,Human Resources Manager,6568,836,7404
40474,Guendolen,Isgar,gisgarqn@va.gov,Staff Scientist,7999,627,8626
40056,Sallyanne,Verrill,sverrillqo@phpbb.com,Help Desk Technician,5518,872,6390
40295,Filberte,Hanshawe,fhanshaweqq@microsoft.com,Help Desk Operator,8521,932,9453
40418,Brendin,Wych,bwychqr@scribd.com,Analog Circuit Design manager,8927,1539,10466
40482,Rosetta,Erb,rerbqv@japanpost.jp,Help Desk Operator,7546,1272,8818
40785,Ivor,Chitty,ichittyqy@tiny.cc,Teacher,2627,1978,4605
40823,Annabel,McKiddin,amckiddinr6@hud.gov,Professor,9689,1143,10832
40844,Nissie,Steven,nstevenr9@mozilla.com,Automation Specialist III,3681,1275,4956
40035,Manny,Conboy,mconboyra@surveymonkey.com,Staff Accountant III,6648,868,7516
40097,Carline,Begent,cbegentrb@e-recht24.de,Human Resources Assistant IV,9978,758,10736
40458,Jaymie,Pulfer,jpulferrc@wikia.com,Clinical Specialist,6566,413,6979
40327,Sol,Ibbison,sibbisonre@xing.com,Staff Scientist,7138,1911,9049
40253,Beryl,Bohey,bboheyrl@hud.gov,Senior Sales Associate,5378,316,5694
40567,Jacquelynn,Ketts,jkettsrn@dell.com,Design Engineer,9766,412,10178
40003,Sanders,Fosdick,sfosdickrp@seesaa.net,Human Resources Assistant IV,7199,292,7491
40058,Cristobal,Woodyer,cwoodyerrr@cargocollective.com,Clinical Specialist,8921,713,9634
41768,Kass,Kaiser,kkaiser0@sbwire.com,VP Quality Control,5485,695,6180
41646,Iorgos,Polland,ipolland1@oaic.gov.au,Administrative Officer,1433,463,1896
41296,Randi,Awin,rawin2@mapquest.com,Web Developer II,6199,1347,7546
41554,Anson,Boxall,aboxall3@photobucket.com,Geological Engineer,3533,374,3907
41097,Emanuel,Callaway,ecallaway4@webnode.com,Account Representative II,4411,971,5382
41456,Miltie,Bullion,mbullion5@sakura.ne.jp,Software Consultant,1249,1112,2361
41864,Minnnie,Biasi,mbiasi6@meetup.com,Financial Advisor,3586,1967,5553
41487,Florance,Clurow,fclurow7@fotki.com,Payment Adjustment Coordinator,5350,1493,6843
41059,Bobbi,Bellino,bbellino8@yale.edu,Geologist IV,8012,1536,9548
41433,Thalia,Derobert,tderobert9@columbia.edu,Biostatistician II,2106,1303,3409
41573,Bartlet,Slaight,bslaighta@shareasale.com,Research Assistant III,9312,642,9954
41721,Moss,Charker,mcharkerb@yahoo.com,Human Resources Assistant II,2155,1554,3709
41808,Daisie,Mayo,dmayoc@deliciousdays.com,Engineer I,7711,1155,8866
41722,Gradeigh,Haig,ghaigd@g.co,Senior Quality Engineer,3250,502,3752
41498,Johnny,Fasset,jfassete@myspace.com,Nuclear Power Engineer,5348,1217,6565
41116,Annora,Skamell,askamellf@usda.gov,Accounting Assistant I,2697,693,3390
41379,Marylin,Lyston,mlystong@vinaora.com,Help Desk Operator,3211,1214,4425
41380,Hashim,O'Docherty,hodochertyh@ucoz.ru,Librarian,3958,1310,5268
41967,Ewell,Lailey,elaileyi@sohu.com,Geologist III,6713,685,7398
41590,Tove,Chominski,tchominskij@ox.ac.uk,Research Nurse,2471,1165,3636
41827,Roddy,Decent,rdecentl@deliciousdays.com,Occupational Therapist,8157,1912,10069
41203,Mommy,Beisley,mbeisleym@networksolutions.com,Business Systems Development Analyst,2475,525,3000
41597,Derrik,Janu,djanun@walmart.com,Electrical Engineer,5997,1635,7632
41193,Nickolai,Welchman,nwelchmano@geocities.jp,Mechanical Systems Engineer,1829,298,2127
41698,Shara,Robottom,srobottomp@technorati.com,Developer I,4984,1339,6323
41447,Renard,Swaddle,rswaddleq@answers.com,VP Quality Control,9049,334,9383
41749,Eugenie,Hurling,ehurlingr@toplist.cz,Analyst Programmer,7825,753,8578
41547,Aloisia,Badcock,abadcocks@wikispaces.com,Associate Professor,2472,974,3446
41377,Gerik,Mingus,gmingust@ifeng.com,Web Developer I,3757,1898,5655
41224,Bradney,McCue,bmccueu@tripadvisor.com,Financial Analyst,9700,1999,11699
41720,Cheri,Vesty,cvestyv@a8.net,VP Sales,8335,385,8720
41612,Abbie,Lenglet,alengletw@dmoz.org,Programmer II,3227,406,3633
41985,Ruby,Decayette,rdecayettex@opensource.org,Social Worker,2616,1158,3774
41923,Leilah,Bygott,lbygotty@theguardian.com,Geologist III,7640,1028,8668
41012,Artur,Marde,amardez@rakuten.co.jp,Account Coordinator,8887,1724,10611
41984,Kipp,Wilcher,kwilcher10@guardian.co.uk,Web Developer I,9806,989,10795
41778,Kaia,Driussi,kdriussi11@g.co,Senior Cost Accountant,7967,360,8327
41426,Goddart,Batkin,gbatkin12@nsw.gov.au,Recruiter,3033,658,3691
41809,Falito,Havenhand,fhavenhand13@state.tx.us,Executive Secretary,6598,1925,8523
41956,Callean,Sprigin,csprigin14@si.edu,Financial Advisor,7856,320,8176
41860,Berty,Attenbrough,battenbrough15@answers.com,Chemical Engineer,7120,532,7652
41083,Sosanna,Sabattier,ssabattier16@yelp.com,Quality Engineer,5242,1703,6945
41589,Maris,Leppard,mleppard17@blogtalkradio.com,Desktop Support Technician,9412,1141,10553
41053,Darius,Khrishtafovich,dkhrishtafovich18@goo.ne.jp,Teacher,3441,1495,4936
41704,Vivyan,Bramo,vbramo19@gizmodo.com,Account Executive,6585,1017,7602
41806,Rustie,Rennox,rrennox1a@dion.ne.jp,Physical Therapy Assistant,1229,1336,2565
41767,Cyndi,MacGiffin,cmacgiffin1b@amazon.com,VP Accounting,5454,397,5851
41478,Ludwig,Brahan,lbrahan1c@wikia.com,Information Systems Manager,9921,1380,11301
41397,Alexandr,Spaven,aspaven1d@wp.com,Speech Pathologist,9925,262,10187
41045,Mommy,Quinane,mquinane1e@sina.com.cn,Engineer II,8559,1534,10093
41407,Allys,Sperski,asperski1f@microsoft.com,Chemical Engineer,2351,265,2616
41916,Ddene,Norwood,dnorwood1g@ycombinator.com,Software Consultant,2506,1910,4416
41599,Dinah,Hawkswood,dhawkswood1h@blinklist.com,Graphic Designer,4586,841,5427
41221,Riki,Pedrielli,rpedrielli1i@t.co,Staff Accountant I,3017,345,3362
41732,Urbanus,Finker,ufinker1j@hao123.com,Data Coordiator,1986,1690,3676
41946,Phylys,Leworthy,pleworthy1k@wikipedia.org,Teacher,3378,1824,5202
41385,Jenica,Lempenny,jlempenny1l@delicious.com,Teacher,3038,447,3485
41439,Rivalee,Woolstenholmes,rwoolstenholmes1m@clickbank.net,Pharmacist,9902,1219,11121
41862,Alayne,Cannan,acannan1n@is.gd,VP Marketing,5025,1022,6047
41802,Audrie,Tapin,atapin1o@hexun.com,Geologist II,3562,1108,4670
41230,Kayne,Sent,ksent1p@51.la,Engineer III,7298,227,7525
41815,Halette,Itzkovwitch,hitzkovwitch1q@usgs.gov,Programmer IV,4633,556,5189
41244,Alexandre,Slemming,aslemming1r@themeforest.net,Senior Sales Associate,7461,1890,9351
41061,Peyter,Ganing,pganing1s@webs.com,Software Test Engineer II,2050,1283,3333
41540,Marianna,Morden,mmorden1t@csmonitor.com,Geological Engineer,6344,690,7034
41711,Manfred,Deakin,mdeakin1u@naver.com,Sales Associate,4643,1302,5945
41728,Tadeo,Toll,ttoll1w@marriott.com,Analog Circuit Design manager,4758,1457,6215
41846,Brita,Antliff,bantliff1x@tinypic.com,Programmer IV,8414,1371,9785
41773,Korney,Alp,kalp1y@huffingtonpost.com,Human Resources Assistant III,6533,1572,8105
41570,Moreen,Noonan,mnoonan1z@nba.com,Speech Pathologist,5882,645,6527
41049,Felicdad,Harbidge,fharbidge20@geocities.jp,Environmental Specialist,2165,361,2526
41619,Leonanie,Bonwell,lbonwell21@discovery.com,Business Systems Development Analyst,7846,409,8255
41212,Laurice,Hebditch,lhebditch22@examiner.com,Registered Nurse,7366,881,8247
41929,Wrennie,Ezzle,wezzle23@java.com,Associate Professor,7926,1438,9364
41847,Eunice,Davidovicz,edavidovicz24@icio.us,Design Engineer,2894,1450,4344
41840,Gilberte,Lashley,glashley25@comcast.net,Financial Advisor,9241,212,9453
41790,Donal,Klaas,dklaas26@constantcontact.com,Research Associate,5694,1560,7254
41752,Marlow,Hancorn,mhancorn28@webmd.com,Project Manager,7926,686,8612
41913,Melamie,Reagan,mreagan29@etsy.com,VP Quality Control,4969,702,5671
41697,Lon,Pfeifer,lpfeifer2a@cbc.ca,Chemical Engineer,3853,1506,5359
41449,Verile,Medlin,vmedlin2b@istockphoto.com,Project Manager,5909,1629,7538
41630,Bran,Thursby,bthursby2c@blogtalkradio.com,Office Assistant IV,6798,457,7255
41914,Arline,Milburne,amilburne2e@foxnews.com,Marketing Assistant,4939,1343,6282
41340,Michaela,Gawkes,mgawkes2f@diigo.com,Software Test Engineer IV,3867,1447,5314
41253,Paten,Shearme,pshearme2g@omniture.com,Research Associate,2343,1410,3753
41851,Hartwell,Doerling,hdoerling2h@squidoo.com,Environmental Tech,4532,1459,5991
41372,Bentley,Sturgis,bsturgis2i@opera.com,Junior Executive,7347,654,8001
41653,Benedick,Mitchelhill,bmitchelhill2j@is.gd,Information Systems Manager,4307,1329,5636
41348,Christan,Fereday,cfereday2k@a8.net,Software Consultant,3183,1880,5063
41422,Rosamond,Braidley,rbraidley2l@shutterfly.com,Graphic Designer,2996,1332,4328
41309,Candice,McAleese,cmcaleese2m@theatlantic.com,Research Assistant IV,3337,291,3628
41948,Samantha,Forrester,sforrester2n@telegraph.co.uk,Internal Auditor,1031,1802,2833
41605,Clementia,Ticic,cticic2p@ted.com,Product Engineer,8086,1070,9156
41613,Aubert,Wharby,awharby2q@edublogs.org,VP Product Management,4847,1713,6560
41558,Rick,O'Hickee,rohickee2r@patch.com,Desktop Support Technician,1325,1168,2493
41415,Chloris,Pavkovic,cpavkovic2s@guardian.co.uk,Research Associate,9526,548,10074
41312,Zenia,Huggons,zhuggons2t@wordpress.com,Software Engineer III,1169,1826,2995
41572,Gustie,Cordeiro,gcordeiro2u@goo.ne.jp,Administrative Assistant III,3438,211,3649
41820,Quinn,Wasiel,qwasiel2v@cnn.com,Electrical Engineer,3074,339,3413
41473,Benjie,Hansberry,bhansberry2w@ezinearticles.com,Analyst Programmer,9013,934,9947
41368,Tracy,Lysaght,tlysaght2x@nbcnews.com,VP Quality Control,5854,766,6620
41011,Linc,Mussetti,lmussetti2y@army.mil,Assistant Professor,4159,566,4725
41211,Gae,Matthewson,gmatthewson2z@adobe.com,Database Administrator IV,8974,1387,10361
41277,Muire,Arntzen,marntzen31@people.com.cn,Analog Circuit Design manager,3615,1682,5297
41588,Gianina,Rollingson,grollingson32@over-blog.com,Account Coordinator,4108,1126,5234
41353,Ambrose,Yesson,ayesson33@behance.net,Engineer II,7186,201,7387
41496,Madalena,Tetther,mtetther34@howstuffworks.com,Accounting Assistant I,6958,1669,8627
41883,Cortie,Romanski,cromanski35@example.com,Environmental Specialist,2351,1095,3446
41888,Joline,St Clair,jstclair36@list-manage.com,Data Coordiator,9680,732,10412
41717,Abbey,Crottagh,acrottagh37@hostgator.com,Quality Control Specialist,2357,1525,3882
41245,Rhys,Noel,rnoel38@aol.com,Director of Sales,3252,627,3879
41007,Rena,Dunrige,rdunrige39@gravatar.com,Programmer III,1417,1952,3369
41567,Alexandr,Nuzzetti,anuzzetti3a@yelp.com,Librarian,8191,1896,10087
41534,Astrix,Stanners,astanners3b@technorati.com,Financial Advisor,6445,1660,8105
41306,Eugen,Collumbine,ecollumbine3c@barnesandnoble.com,Database Administrator I,8410,754,9164
41771,Ondrea,Pic,opic3d@unicef.org,Sales Associate,4622,1019,5641
41910,Tedman,Pirouet,tpirouet3e@google.nl,Civil Engineer,4460,2000,6460
41990,Sigrid,Mundell,smundell3f@jugem.jp,Developer IV,2818,1611,4429
41227,Delano,Carnell,dcarnell3g@google.com.au,Account Executive,1067,747,1814
41248,Rodolph,Meininking,rmeininking3h@alibaba.com,Analyst Programmer,3085,1331,4416
41365,Pincas,Donaho,pdonaho3i@diigo.com,Assistant Professor,8568,385,8953
41930,Dorree,Gittose,dgittose3j@adobe.com,Help Desk Technician,7078,570,7648
41483,Jacky,Moorey,jmoorey3k@free.fr,Marketing Assistant,8143,1988,10131
41066,Odille,Zanni,ozanni3l@skyrock.com,Analog Circuit Design manager,4580,1293,5873
41192,Booth,Singleton,bsingleton3m@google.de,Senior Quality Engineer,6272,1981,8253
41801,Joey,Beltzner,jbeltzner3n@cpanel.net,Software Engineer I,1221,1685,2906
41427,Evanne,Dew,edew3o@latimes.com,Geological Engineer,3634,655,4289
41927,Zebedee,Mattiazzi,zmattiazzi3p@icio.us,Software Test Engineer III,3333,499,3832
41213,Bill,Cubbon,bcubbon3q@economist.com,Internal Auditor,3321,1550,4871
41574,Marlene,Dionisetto,mdionisetto3r@fotki.com,Chemical Engineer,3360,1643,5003
41291,Domini,Baggallay,dbaggallay3s@washingtonpost.com,Food Chemist,2980,1863,4843
41798,Manon,Quigg,mquigg3t@studiopress.com,Office Assistant IV,6054,894,6948
41525,Rossie,Crumbie,rcrumbie3u@huffingtonpost.com,Web Developer IV,4437,1538,5975
41195,Dorice,Rigate,drigate3v@deviantart.com,Clinical Specialist,3168,1478,4646
41183,Luce,McGiffin,lmcgiffin3w@mail.ru,GIS Technical Architect,5092,1177,6269
41267,Cathie,Cowerd,ccowerd3x@hostgator.com,Pharmacist,7267,472,7739
41699,Magdalene,Retchless,mretchless3y@seattletimes.com,Compensation Analyst,2210,560,2770
41283,Karlotte,McGinnell,kmcginnell3z@shareasale.com,Occupational Therapist,9155,445,9600
41912,Rozamond,Cortes,rcortes40@vk.com,Computer Systems Analyst IV,1367,1608,2975
41418,Kelila,Dominicacci,kdominicacci41@w3.org,Director of Sales,5514,565,6079
41763,Chan,Eiler,ceiler42@si.edu,Account Coordinator,9526,1546,11072
41989,Elton,Starton,estarton44@canalblog.com,Structural Analysis Engineer,3831,1718,5549
41404,Saxe,Meriot,smeriot45@infoseek.co.jp,Electrical Engineer,7809,412,8221
41123,Janka,Tolchar,jtolchar47@addtoany.com,Help Desk Operator,4588,914,5502
41149,Letty,Van den Velden,lvandenvelden48@360.cn,Software Engineer IV,5482,1564,7046
41486,Clovis,Gulvin,cgulvin49@sitemeter.com,Staff Scientist,6767,234,7001
41772,Wyndham,Dimmer,wdimmer4a@quantcast.com,Electrical Engineer,9657,1352,11009
41557,Madlin,Rodliff,mrodliff4b@freewebs.com,Account Representative I,2250,1567,3817
41409,Forbes,Poulden,fpoulden4d@oracle.com,Analog Circuit Design manager,1377,641,2018
41411,Oates,Diack,odiack4e@clickbank.net,Analyst Programmer,4772,1416,6188
41667,Marie-ann,Abramcik,mabramcik4f@theglobeandmail.com,Assistant Media Planner,2911,1357,4268
41688,Cordie,McIlriach,cmcilriach4g@hatena.ne.jp,Director of Sales,5108,1538,6646
41037,Yolane,Scroggs,yscroggs4h@who.int,Research Nurse,2787,1652,4439
41398,Redford,Bertelsen,rbertelsen4i@independent.co.uk,Research Assistant I,9011,1769,10780
41677,Jania,Krop,jkrop4j@dell.com,Software Consultant,4561,1666,6227
41874,Hershel,Coopper,hcoopper4k@hhs.gov,Chief Design Engineer,3192,750,3942
41266,Juieta,Denver,jdenver4l@cloudflare.com,Mechanical Systems Engineer,5598,1564,7162
41614,Shelli,Farans,sfarans4n@reddit.com,Environmental Specialist,2034,730,2764
41174,Nady,Fumagall,nfumagall4p@sphinn.com,Accountant IV,5244,336,5580
41670,Pierre,Robez,probez4q@state.gov,Librarian,2968,277,3245
41637,Linda,Dumbrell,ldumbrell4r@angelfire.com,Health Coach IV,3217,747,3964
41319,Rossy,Ramas,rramas4s@hexun.com,Marketing Manager,6749,1518,8267
41225,Salvidor,Hadlow,shadlow4t@nifty.com,Human Resources Manager,2933,1359,4292
41359,Wildon,Hutable,whutable4u@odnoklassniki.ru,Actuary,6716,1755,8471
41048,Corissa,Croy,ccroy4v@opensource.org,Programmer Analyst III,4681,1877,6558
41633,Erma,Shemelt,eshemelt4w@newsvine.com,Software Consultant,4459,1066,5525
41466,Bartholomew,Doge,bdoge4x@acquirethisname.com,Programmer Analyst II,5545,1126,6671
41205,Minor,Attwoull,mattwoull4y@ed.gov,Analyst Programmer,6118,1692,7810
41355,Jewel,Grimbaldeston,jgrimbaldeston50@storify.com,Technical Writer,3442,1047,4489
41412,Kim,Gurnell,kgurnell51@hc360.com,Biostatistician III,2372,1956,4328
41890,Carr,Petruk,cpetruk52@flavors.me,General Manager,4666,311,4977
41044,Sisile,McDarmid,smcdarmid53@istockphoto.com,Engineer IV,9611,337,9948
41396,Jennie,Brent,jbrent54@hibu.com,VP Marketing,2979,666,3645
41094,Camile,Tabor,ctabor55@opensource.org,Staff Scientist,6327,905,7232
41881,Gwenneth,Brownsell,gbrownsell56@theatlantic.com,Nurse Practicioner,8111,1987,10098
41671,Ianthe,Limming,ilimming57@wp.com,Senior Financial Analyst,4089,1780,5869
41631,Madelle,Ludman,mludman58@i2i.jp,Actuary,5118,1793,6911
41361,Vanda,Cashford,vcashford59@usatoday.com,Account Coordinator,3492,206,3698
41029,Valentia,Diggin,vdiggin5a@ebay.com,GIS Technical Architect,6391,1919,8310
41485,Nisse,Ridge,nridge5c@ca.gov,Assistant Manager,6702,457,7159
41395,Sybille,Treverton,streverton5d@google.co.jp,Business Systems Development Analyst,7976,930,8906
41706,Diarmid,Noakes,dnoakes5g@1und1.de,Environmental Tech,5794,1342,7136
41275,Davey,Plessing,dplessing5h@time.com,Occupational Therapist,9298,1329,10627
41555,Hertha,Rosengren,hrosengren5i@elegantthemes.com,Financial Analyst,4017,744,4761
41367,Sidonia,Sinkins,ssinkins5j@buzzfeed.com,Graphic Designer,9802,1668,11470
41008,Hugibert,Saddleton,hsaddleton5k@army.mil,Help Desk Technician,8177,1634,9811
41638,Humfried,O' Byrne,hobyrne5l@de.vu,Speech Pathologist,7103,1464,8567
41922,Ettie,Turton,eturton5m@dropbox.com,VP Product Management,4536,925,5461
41658,Row,Bennen,rbennen5n@nymag.com,Accounting Assistant II,8601,1582,10183
41853,Way,Allinson,wallinson5o@nba.com,Cost Accountant,1368,1257,2625
41436,Jody,Phillcox,jphillcox5p@studiopress.com,Financial Analyst,6973,1018,7991
41315,Tonya,Botly,tbotly5r@msn.com,Librarian,9578,1967,11545
41099,Rachel,Astill,rastill5s@feedburner.com,Programmer Analyst IV,2309,997,3306
41310,Calvin,Derkes,cderkes5u@boston.com,Staff Scientist,1067,849,1916
41143,Donnie,Dobbin,ddobbin5v@g.co,Safety Technician III,9784,304,10088
41925,Chevy,Garza,cgarza5z@slideshare.net,Office Assistant IV,1510,774,2284
41775,Felipa,Pyne,fpyne60@discovery.com,Professor,3584,820,4404
41151,Andra,MacGown,amacgown61@scientificamerican.com,Dental Hygienist,9811,504,10315
41693,Mallorie,Gallihaulk,mgallihaulk62@ucla.edu,Registered Nurse,1064,568,1632
41060,Clary,Mardy,cmardy63@gizmodo.com,Web Developer II,9547,1913,11460
41924,Elissa,Catterell,ecatterell64@rambler.ru,Health Coach I,5923,1797,7720
41839,Anthea,Loweth,aloweth65@chronoengine.com,Speech Pathologist,2125,1948,4073
41408,Jodi,Grahamslaw,jgrahamslaw68@senate.gov,Administrative Officer,6570,1852,8422
41034,Cheslie,Handrik,chandrik69@1688.com,Environmental Specialist,3426,1324,4750
41527,Jose,Adlington,jadlington6b@ca.gov,Staff Scientist,9280,1061,10341
41369,Phip,Gosney,pgosney6c@unesco.org,Chief Design Engineer,2609,1843,4452
41038,Sholom,Shasnan,sshasnan6d@omniture.com,Human Resources Assistant II,4537,715,5252
41668,Leontyne,Oscroft,loscroft6e@myspace.com,Sales Representative,9482,1305,10787
41096,Barnabas,Labarre,blabarre6f@ucoz.com,Director of Sales,5442,759,6201
41198,Arron,Woodwing,awoodwing6g@paginegialle.it,Computer Systems Analyst III,1618,617,2235
41962,Lauralee,Kinvig,lkinvig6h@apache.org,Internal Auditor,4688,1175,5863
41781,Hamid,Cavell,hcavell6i@github.io,Media Manager II,3899,862,4761
41702,Rolfe,O'Rudden,rorudden6k@gmpg.org,Account Representative I,9050,1928,10978
41582,Graig,Summerton,gsummerton6l@surveymonkey.com,Technical Writer,7418,1447,8865
41850,Rogers,Wilne,rwilne6m@twitpic.com,Research Nurse,7846,1731,9577
41993,Sherline,Reith,sreith6o@dion.ne.jp,Programmer Analyst I,6723,1155,7878
41650,Bartolomeo,Huscroft,bhuscroft6q@narod.ru,VP Quality Control,9586,1617,11203
41141,Deane,Cammack,dcammack6r@slate.com,General Manager,9841,841,10682
41256,Isadora,Titley,ititley6s@va.gov,Civil Engineer,1695,1819,3514
41509,Samara,Harflete,sharflete6t@state.gov,Structural Analysis Engineer,8298,793,9091
41320,Ric,Towsey,rtowsey6u@independent.co.uk,Physical Therapy Assistant,3720,1081,4801
41872,Arlie,Bogays,abogays6w@liveinternet.ru,Community Outreach Specialist,7899,844,8743
41273,Werner,Lawrey,wlawrey6x@php.net,Web Designer II,2906,1491,4397
41672,Viviyan,Mandrake,vmandrake6y@google.fr,Administrative Officer,8778,1307,10085
41294,Jules,Kellie,jkellie72@netlog.com,Electrical Engineer,2310,1778,4088
41140,Robbyn,Lippi,rlippi73@surveymonkey.com,VP Marketing,4043,656,4699
41101,Christy,Hasker,chasker74@blogs.com,Account Coordinator,4792,1238,6030
41958,Godwin,Duggen,gduggen75@cloudflare.com,Software Consultant,9106,797,9903
41035,Les,Belhome,lbelhome76@newyorker.com,Accountant IV,1905,360,2265
41204,Ferdinande,Pandya,fpandya77@disqus.com,Executive Secretary,1986,1167,3153
41489,Valry,De Dantesie,vdedantesie78@shinystat.com,Graphic Designer,3682,1796,5478
41078,Jarred,Yarrow,jyarrow79@qq.com,Chief Design Engineer,7674,1761,9435
41753,Hobie,Bottinelli,hbottinelli7a@senate.gov,Senior Cost Accountant,3841,672,4513
41531,Anabal,Ventura,aventura7b@discuz.net,VP Accounting,2364,514,2878
41718,Xena,Spalding,xspalding7c@theglobeandmail.com,Associate Professor,5471,981,6452
41968,Blanca,Guidera,bguidera7d@nps.gov,Professor,9704,1768,11472
41131,Ashil,Keld,akeld7e@uiuc.edu,Speech Pathologist,2525,1214,3739
41595,Carson,Sawell,csawell7f@abc.net.au,Programmer Analyst IV,5075,1691,6766
41657,Franklyn,Coe,fcoe7h@amazon.co.jp,Social Worker,8180,920,9100
41494,Vincents,Yerrill,vyerrill7j@msu.edu,Dental Hygienist,7005,336,7341
41734,Lilia,Lowcock,llowcock7k@ustream.tv,Executive Secretary,5030,1304,6334
41966,Erik,Shrubshall,eshrubshall7l@slashdot.org,Associate Professor,9599,292,9891
41587,Mendel,Ungerechts,mungerechts7m@slate.com,Structural Analysis Engineer,4432,362,4794
41576,Conney,Dashper,cdashper7o@usa.gov,Teacher,9032,405,9437
41609,Del,Prisk,dprisk7r@arstechnica.com,Health Coach IV,9271,1381,10652
41460,Lindy,Cullingworth,lcullingworth7s@digg.com,Nurse Practicioner,9903,1062,10965
41695,Adelina,Lefeaver,alefeaver7t@wired.com,Chemical Engineer,9972,326,10298
41134,Archambault,Lutwyche,alutwyche7u@columbia.edu,Community Outreach Specialist,2498,1538,4036
41893,Davita,Gormally,dgormally7v@harvard.edu,Compensation Analyst,3293,331,3624
41343,Lesley,Droghan,ldroghan7w@dell.com,Operator,8947,1186,10133
41419,Kalindi,Barstow,kbarstow7x@addthis.com,Sales Representative,1647,510,2157
41663,Cornie,Bernard,cbernard7y@mayoclinic.com,Administrative Assistant IV,7631,883,8514
41236,Hartwell,Brimacombe,hbrimacombe7z@aol.com,Associate Professor,4413,1435,5848
41960,Leland,Baptist,lbaptist80@fema.gov,Tax Accountant,4413,667,5080
41106,Barde,Jewise,bjewise81@nifty.com,Clinical Specialist,4990,1544,6534
41179,Dianna,Lorente,dlorente85@springer.com,Senior Cost Accountant,4113,1174,5287
41817,Carlynne,Elcott,celcott86@xinhuanet.com,GIS Technical Architect,3005,1310,4315
41265,Adriano,Erie,aerie89@princeton.edu,Dental Hygienist,2134,1844,3978
41301,Karissa,Croster,kcroster8a@latimes.com,VP Accounting,1947,1555,3502
41086,Dara,Vasilik,dvasilik8b@army.mil,Systems Administrator I,8157,300,8457
41501,Alfy,Lerwill,alerwill8c@netscape.com,Help Desk Technician,9006,704,9710
41089,Matt,Amner,mamner8d@earthlink.net,Analog Circuit Design manager,2490,1677,4167
41580,Salem,O'Scandall,soscandall8e@nps.gov,Sales Representative,9320,1878,11198
41830,Lark,Sherrocks,lsherrocks8f@yelp.com,Software Test Engineer III,5965,1259,7224
41417,Ada,Reville,areville8g@networkadvertising.org,Operator,5637,1190,6827
41905,Jay,Evill,jevill8h@squarespace.com,Professor,8222,257,8479
41197,Bobbye,Rhys,brhys8k@ebay.co.uk,Food Chemist,6832,525,7357
41729,Zsa zsa,Muttock,zmuttock8m@go.com,Research Associate,2876,1534,4410
41655,Robert,Thomton,rthomton8o@utexas.edu,Developer II,8885,874,9759
41901,Nevin,Wilmott,nwilmott8p@gnu.org,Professor,1048,1382,2430
41033,Philomena,Doogan,pdoogan8q@sciencedaily.com,Human Resources Manager,2883,303,3186
41288,Heddi,Duxbarry,hduxbarry8s@hubpages.com,Assistant Manager,8939,850,9789
41678,Reagan,Campbell,rcampbell8u@economist.com,Analyst Programmer,6927,890,7817
41822,Aarika,Douberday,adouberday8w@pbs.org,Software Consultant,8976,570,9546
41661,Kip,Mulberry,kmulberry8y@youtu.be,Programmer I,2260,527,2787
41023,Sibelle,Hindsberg,shindsberg90@geocities.jp,Administrative Assistant IV,4887,1744,6631
41733,Maurita,Browett,mbrowett92@google.fr,Assistant Manager,9056,729,9785
41680,Sande,Bartell,sbartell94@oaic.gov.au,Pharmacist,1457,1862,3319
41207,Davey,Sushams,dsushams95@kickstarter.com,Pharmacist,3190,1588,4778
41128,Tabbatha,Dowthwaite,tdowthwaite97@hao123.com,Web Designer II,8904,1917,10821
41533,Diarmid,Klauer,dklauer98@engadget.com,Community Outreach Specialist,4393,703,5096
41514,Britteny,Kovnot,bkovnot9b@time.com,Research Assistant III,7166,968,8134
41072,Babbie,Baudasso,bbaudasso9d@auda.org.au,Financial Analyst,6646,1871,8517
41508,Caralie,Blayney,cblayney9e@nsw.gov.au,Business Systems Development Analyst,8378,1526,9904
41608,Anastasia,Kobierra,akobierra9f@furl.net,Research Assistant IV,3538,414,3952
41190,Harli,Lowthian,hlowthian9g@live.com,Geologist I,1681,293,1974
41598,Mendel,Pyle,mpyle9h@newyorker.com,VP Sales,5168,236,5404
41068,Bearnard,Leatherborrow,bleatherborrow9i@spiegel.de,Assistant Media Planner,9310,1669,10979
41765,Sergio,Ovid,sovid9j@squarespace.com,Staff Accountant IV,7757,1320,9077
41794,Angelo,Hessle,ahessle9k@theatlantic.com,Research Assistant II,6409,884,7293
41513,Giulio,Melson,gmelson9l@hao123.com,Technical Writer,4996,548,5544
41935,Eddi,Tampion,etampion9m@desdev.cn,Help Desk Operator,4948,921,5869
41600,Reeta,Valerio,rvalerio9n@senate.gov,Assistant Media Planner,4496,1090,5586
41617,Katrinka,Finnie,kfinnie9o@sohu.com,Tax Accountant,1811,347,2158
41625,Artemis,Dominichelli,adominichelli9q@sakura.ne.jp,Account Executive,8913,778,9691
41137,Darryl,Bottrell,dbottrell9s@kickstarter.com,Business Systems Development Analyst,5472,653,6125
41538,Darcy,Silcocks,dsilcocks9t@myspace.com,Statistician II,9429,540,9969
41942,Paolo,Pettingill,ppettingill9v@scribd.com,Payment Adjustment Coordinator,4925,2000,6925
41713,Mady,Eagling,meagling9w@jiathis.com,Chief Design Engineer,2838,1995,4833
41844,Maynord,Rosenshine,mrosenshine9x@blogs.com,Legal Assistant,4512,1715,6227
41219,Aileen,Bruinsma,abruinsma9y@webs.com,Business Systems Development Analyst,3116,679,3795
41063,Giuditta,Jacobowicz,gjacobowicz9z@psu.edu,Analyst Programmer,6904,1069,7973
41421,Doy,Beville,dbevillea1@redcross.org,Librarian,3597,1648,5245
41293,Fields,Ickowics,fickowicsa2@shareasale.com,Computer Systems Analyst II,2163,1733,3896
41378,Jakob,Dundredge,jdundredgea4@dropbox.com,Media Manager II,8038,696,8734
41739,Earlie,Dedrick,ededricka6@nytimes.com,Automation Specialist IV,1177,583,1760
41210,Davie,Pinchback,dpinchbackaa@gizmodo.com,Senior Financial Analyst,5143,299,5442
41374,Jordan,Galliard,jgalliardad@newyorker.com,Statistician II,7074,1939,9013
41147,Hilliary,Cayford,hcayfordaf@cpanel.net,Food Chemist,1672,1862,3534
41199,Brodie,Morrallee,bmorralleeag@hc360.com,Statistician I,8697,1872,10569
41020,Lenora,Soltan,lsoltanah@stanford.edu,VP Sales,4131,322,4453
41769,Somerset,Champneys,schampneysai@pinterest.com,VP Product Management,8349,1025,9374
41284,Cris,Valintine,cvalintineal@nba.com,Business Systems Development Analyst,6914,434,7348
41362,Errol,Arrandale,earrandaleam@opera.com,Physical Therapy Assistant,4266,1930,6196
41511,Cletis,Traite,ctraitean@xrea.com,Graphic Designer,2064,471,2535
41166,Raff,Spuner,rspunerao@arizona.edu,Internal Auditor,4106,1704,5810
41107,Suellen,Spitaro,sspitaroap@webmd.com,Professor,1325,1687,3012
41639,Ambur,Durnian,adurnianaq@blogs.com,Quality Control Specialist,1928,1398,3326
41270,Juliet,Vasilischev,jvasilischevar@webeden.co.uk,Research Associate,9634,1591,11225
41934,Randene,Copsey,rcopseyas@independent.co.uk,General Manager,8967,1470,10437
41121,Cirillo,Jaime,cjaimeat@businessinsider.com,Account Coordinator,2312,703,3015
41977,Opaline,Rodolphe,orodolpheav@sitemeter.com,Developer IV,5726,819,6545
41833,Kile,McElhargy,kmcelhargyaw@qq.com,Recruiting Manager,9904,661,10565
41317,Dallis,Seabon,dseabonay@sfgate.com,Senior Editor,6060,1050,7110
41457,Ines,Drohun,idrohunaz@imageshack.us,Financial Advisor,7258,1084,8342
41517,Daryl,McKerley,dmckerleyb1@naver.com,Mechanical Systems Engineer,6166,1926,8092
41606,Keelia,Gommes,kgommesb2@usnews.com,Quality Control Specialist,3219,576,3795
41928,Adelind,Splaven,asplavenb3@webmd.com,Chief Design Engineer,9910,1752,11662
41454,Dunstan,Palia,dpaliab4@miitbeian.gov.cn,Administrative Assistant III,3871,1452,5323
41941,Harris,Widger,hwidgerb5@cnn.com,Database Administrator IV,3227,1285,4512
41282,Betsy,Helgass,bhelgassb6@admin.ch,Speech Pathologist,2264,1020,3284
41335,Eward,Bindley,ebindleyb7@163.com,Design Engineer,7874,401,8275
41559,Victoria,Pierrepont,vpierrepontb8@europa.eu,Web Designer III,1059,1209,2268
41280,Inger,Wareing,iwareingba@com.com,Nuclear Power Engineer,4469,1402,5871
41254,Marnia,Galvan,mgalvanbb@clickbank.net,Assistant Media Planner,9786,1203,10989
41462,Humbert,Vossgen,hvossgenbc@nifty.com,Senior Developer,9393,204,9597
41915,Tiphanie,Booth-Jarvis,tboothjarvisbd@toplist.cz,Sales Representative,5028,365,5393
41394,Dominic,Haythorne,dhaythornebe@nydailynews.com,Software Test Engineer II,8118,1557,9675
41976,Patrice,Yearns,pyearnsbf@yellowpages.com,Analyst Programmer,5194,1774,6968
41126,Englebert,Sinott,esinottbh@dell.com,Senior Developer,5607,903,6510
41401,Abbott,Laughton,alaughtonbi@topsy.com,Programmer IV,9624,1085,10709
41018,Brok,Farrall,bfarrallbk@addtoany.com,Chemical Engineer,2706,1497,4203
41103,Lon,Bendel,lbendelbl@goodreads.com,Research Nurse,8071,476,8547
41144,Annabella,Leverage,aleveragebm@histats.com,VP Accounting,8101,1317,9418
41583,Guillema,Sergeaunt,gsergeauntbo@drupal.org,Accountant IV,1100,1518,2618
41050,Shelli,Robbert,srobbertbp@salon.com,Staff Accountant I,9805,294,10099
41375,Kimbra,Gravet,kgravetbq@wikia.com,Paralegal,4137,1482,5619
41848,Paxon,Kleanthous,pkleanthousbr@icio.us,Software Consultant,4695,1267,5962
41429,Hamil,Mattityahou,hmattityahoubt@dion.ne.jp,Nuclear Power Engineer,1404,1088,2492
41371,Thane,Kiljan,tkiljanbu@fastcompany.com,Senior Editor,1093,391,1484
41871,Mandy,Gosnall,mgosnallbv@ning.com,Geological Engineer,9855,256,10111
41443,Nathanael,Rowbrey,nrowbreybw@biblegateway.com,Software Consultant,2847,910,3757
41920,Reiko,Humbie,rhumbiebx@elpais.com,Web Developer IV,8333,1682,10015
41041,Netty,D'Errico,nderricobz@whitehouse.gov,Tax Accountant,2549,1666,4215
41601,Adeline,MacNess,amacnessc3@toplist.cz,Legal Assistant,2341,1793,4134
41470,Brock,Trillo,btrilloc5@dell.com,Staff Accountant III,9263,1668,10931
41110,Basile,Oliva,bolivac6@yahoo.com,Data Coordiator,7904,1024,8928
41381,Gardener,Grelik,ggrelikc9@adobe.com,Internal Auditor,7094,784,7878
41521,Jeanine,Whife,jwhifecc@sourceforge.net,Mechanical Systems Engineer,5516,991,6507
41730,Gianina,Pieroni,gpieronicd@ycombinator.com,Analog Circuit Design manager,2599,1679,4278
41333,Sharron,Tippetts,stippettscg@boston.com,Engineer III,2988,1670,4658
41970,Miguela,Iorns,miornsch@springer.com,Professor,4441,369,4810
41821,Ripley,Glisane,rglisaneci@lulu.com,Chief Design Engineer,8679,820,9499
41724,Pegeen,Griffe,pgriffecj@wordpress.org,Automation Specialist III,9161,549,9710
41727,Hedwiga,Delamar,hdelamarck@utexas.edu,Environmental Tech,1404,1220,2624
41635,Ambrosi,Kembrey,akembreycm@wordpress.org,Recruiting Manager,1602,933,2535
41364,Broddy,Stirland,bstirlandcn@google.cn,Systems Administrator IV,6414,729,7143
41067,Owen,Corse,ocorseco@sakura.ne.jp,Chief Design Engineer,9147,1810,10957
41831,Arline,Beale,abealecq@google.ru,Account Executive,9533,1534,11067
41592,Aylmer,O'Kenny,aokennycu@princeton.edu,Computer Systems Analyst I,3878,1780,5658
41973,Griffy,Lapish,glapishd0@nbcnews.com,Compensation Analyst,1373,1257,2630
41327,Kathye,Skipton,kskiptond1@amazon.de,Actuary,3858,1426,5284
41707,Lauryn,Lynett,llynettd2@eventbrite.com,Account Executive,6451,1515,7966
41561,Brittni,Golightly,bgolightlyd3@ifeng.com,Health Coach I,1925,595,2520
41318,Zacharia,Gummery,zgummeryd4@cdc.gov,Financial Analyst,3878,1684,5562
41216,Lelia,Saylor,lsaylord5@fastcompany.com,Tax Accountant,9339,882,10221
41258,Dasie,Leindecker,dleindeckerd7@google.cn,Financial Analyst,7015,488,7503
41251,Elli,Hagley,ehagleyd8@networkadvertising.org,Budget/Accounting Analyst IV,8267,519,8786
41529,Sigismund,Jovovic,sjovovicda@soup.io,Media Manager II,8010,1061,9071
41869,Kary,Levens,klevensdb@hp.com,Marketing Assistant,8735,1709,10444
41793,Gifford,Denial,gdenialdc@stumbleupon.com,Geologist IV,2280,1924,4204
41139,Sheila,Kybert,skybertdd@com.com,Director of Sales,6866,292,7158
41679,Loree,Asch,laschde@nasa.gov,Design Engineer,8575,1970,10545
41170,Ronny,Rikkard,rrikkarddh@google.ru,Food Chemist,4398,1105,5503
41331,Rachelle,Orgen,rorgendj@behance.net,Chief Design Engineer,3640,224,3864
41228,Bambie,Chalmers,bchalmersdl@networksolutions.com,Health Coach II,8489,572,9061
41824,Aurea,Mifflin,amifflindm@51.la,Web Designer I,2174,1460,3634
41071,Jodie,Wickwarth,jwickwarthdn@google.pl,Assistant Manager,4824,738,5562
41424,Herman,Lorman,hlormando@dedecms.com,Developer I,8842,824,9666
41738,Tabor,Weddup,tweddupdp@wisc.edu,Structural Analysis Engineer,6688,346,7034
41360,Karrah,Dumbar,kdumbardq@friendfeed.com,Assistant Media Planner,9038,1360,10398
41024,Joanne,Oakenford,joakenfordds@auda.org.au,VP Product Management,5490,1041,6531
41249,Byram,Kiehne,bkiehnedt@bluehost.com,Librarian,3192,699,3891
41356,Randee,Watmough,rwatmoughdu@mit.edu,Systems Administrator II,3285,1996,5281
41903,Gena,Blagburn,gblagburndw@amazon.co.jp,Web Designer II,3145,469,3614
41651,Farly,Dils,fdilsdx@1688.com,General Manager,2164,1850,4014
41347,Pier,Toma,ptomadz@mysql.com,Health Coach I,3722,1697,5419
41747,Vinson,Stadden,vstaddene2@nymag.com,Geologist II,3075,1467,4542
41894,Nerissa,Craythorne,ncraythornee3@paypal.com,Social Worker,1147,1517,2664
41607,Vasili,Dellenbach,vdellenbache5@lulu.com,Associate Professor,3382,1509,4891
41222,Beverley,Hawkeridge,bhawkeridgee6@techcrunch.com,Data Coordiator,4853,1200,6053
41951,Rachael,Chastand,rchastande9@tripadvisor.com,Account Coordinator,7960,726,8686
41918,Shena,Grayshon,sgrayshoneb@soundcloud.com,Accountant II,8177,1314,9491
41435,Allyce,Barrowcliffe,abarrowcliffeef@nhs.uk,Engineer II,1153,1801,2954
41838,Mallory,Gorden,mgordeneg@indiatimes.com,Administrative Assistant I,8825,376,9201
41229,Tiler,Scottini,tscottinieh@is.gd,Sales Representative,4022,1824,5846
41900,Paco,Ishchenko,pishchenkoej@linkedin.com,VP Accounting,2804,918,3722
41122,Jeane,Fowgies,jfowgiesek@biblegateway.com,Junior Executive,3107,852,3959
41299,Pansy,Banasiak,pbanasiakel@economist.com,Media Manager III,7213,449,7662
41032,Bamby,Brigden,bbrigdeneo@gov.uk,Account Coordinator,5654,958,6612
41074,Jessalin,Dosdale,jdosdaleeq@skyrock.com,Product Engineer,1142,1245,2387
41167,Archibold,Measey,ameaseyet@ifeng.com,Help Desk Technician,3728,1899,5627
41641,Patsy,Ferneyhough,pferneyhougheu@buzzfeed.com,Programmer Analyst III,4469,767,5236
41056,Urson,Peverell,upeverelley@statcounter.com,Health Coach IV,1580,1929,3509
41629,Andie,Bosman,abosmanf0@behance.net,Office Assistant I,6856,1352,8208
41105,Nate,Alleyne,nalleynef2@photobucket.com,Senior Editor,6803,1768,8571
41155,Alexis,Jurzyk,ajurzykf3@europa.eu,Pharmacist,2677,1776,4453
41263,Davon,Langstone,dlangstonef4@senate.gov,Administrative Assistant III,4070,676,4746
41832,Celia,Iamittii,ciamittiif7@ovh.net,Programmer III,4759,765,5524
41636,Ketty,Colter,kcolterf9@skyrock.com,Administrative Assistant IV,7384,828,8212
41168,Stacey,Addionisio,saddionisiofb@google.ca,Legal Assistant,7381,1703,9084
41013,Rachael,Josef,rjoseffc@imgur.com,Human Resources Manager,1051,569,1620
41065,Zarla,Bradbury,zbradburyff@techcrunch.com,Chemical Engineer,8701,822,9523
41354,Carmella,Jossum,cjossumfh@aol.com,Junior Executive,3926,626,4552
41479,Morley,Gunningham,mgunninghamfi@discovery.com,Sales Representative,1093,688,1781
41124,Harry,Yesipov,hyesipovfj@netvibes.com,Senior Cost Accountant,7018,891,7909
41855,Staford,Laird,slairdfl@hatena.ne.jp,Analyst Programmer,6593,1450,8043
41431,Jobyna,Tordoff,jtordofffm@ebay.com,Accounting Assistant I,9477,1605,11082
41504,Vito,Skeleton,vskeletonfp@wikispaces.com,Data Coordiator,1064,1100,2164
41877,Katleen,Archambault,karchambaultfr@qq.com,Executive Secretary,3768,1521,5289
41532,Bax,Shenton,bshentonft@cbslocal.com,Nurse,6324,1982,8306
41814,Patrick,Henrych,phenrychfw@weather.com,Librarian,9608,1235,10843
41184,Ladonna,Coulton,lcoultonfx@so-net.ne.jp,Analyst Programmer,3065,1995,5060
41524,Cybill,Stripling,cstriplingg1@forbes.com,Senior Cost Accountant,9767,1055,10822
41748,Rivalee,Breen,rbreeng3@blogspot.com,Tax Accountant,5346,775,6121
41591,Arnie,Lummasana,alummasanag6@indiatimes.com,Budget/Accounting Analyst IV,3443,1622,5065
41805,Hanan,McCarl,hmccarlg7@boston.com,Account Coordinator,4665,1124,5789
41510,Tracey,Castelyn,tcastelyng9@mit.edu,Food Chemist,1950,543,2493
41325,Perceval,Sizeland,psizelandgc@state.gov,Tax Accountant,1602,749,2351
41373,Modesta,Hrishchenko,mhrishchenkogh@newyorker.com,Biostatistician IV,3055,1485,4540
41410,Mathilde,Redmell,mredmellgi@discuz.net,Nurse,4836,1978,6814
41358,Mady,Attle,mattlegj@columbia.edu,VP Sales,5874,963,6837
41719,Tomlin,Lampbrecht,tlampbrechtgk@phpbb.com,Marketing Manager,6963,1230,8193
41344,Gusella,Cheverton,gchevertongl@themeforest.net,Chief Design Engineer,7976,1832,9808
41620,Jeremiah,Poluzzi,jpoluzzigm@yahoo.com,VP Accounting,2071,1216,3287
41708,Retha,Zanelli,rzanelligo@live.com,Design Engineer,5591,1488,7079
41171,Herculie,Dulen,hdulengp@123-reg.co.uk,Compensation Analyst,8746,295,9041
41338,Maegan,Scholler,mschollergr@tripadvisor.com,Senior Developer,8804,1166,9970
41413,Duane,McCrohon,dmccrohongt@nps.gov,Research Nurse,6157,1782,7939
41303,Kalinda,Le Galle,klegallegu@google.nl,Professor,9141,875,10016
41865,Nance,Korneluk,nkornelukgw@whitehouse.gov,Junior Executive,2508,405,2913
41316,Shaughn,Sinney,ssinneygx@cisco.com,Director of Sales,4078,1577,5655
41441,Lorette,Moneypenny,lmoneypennygy@cam.ac.uk,Physical Therapy Assistant,8540,977,9517
41961,Sasha,Courtman,scourtmangz@storify.com,Professor,5054,676,5730
41382,Nahum,Freake,nfreakeh1@wordpress.com,Design Engineer,5276,829,6105
41109,Nestor,Titchmarsh,ntitchmarshh3@marketwatch.com,Administrative Officer,3206,1515,4721
41825,Templeton,Elmes,telmesh4@joomla.org,Marketing Manager,2434,404,2838
41715,Christiana,Klampt,cklampth5@jugem.jp,Accounting Assistant II,6867,262,7129
41988,Petronilla,Clausson,pclaussonh6@friendfeed.com,Office Assistant I,7483,1840,9323
41136,Lyssa,Witcherley,lwitcherleyh9@icq.com,Geological Engineer,2628,504,3132
41138,Louis,Hazart,lhazartha@eventbrite.com,Assistant Professor,9377,444,9821
41127,Tomlin,Wickie,twickiehc@kickstarter.com,Account Representative I,4688,854,5542
41289,Burty,Jefford,bjeffordhh@merriam-webster.com,Administrative Officer,2799,1325,4124
41978,Justus,Glencros,jglencroshi@walmart.com,Budget/Accounting Analyst II,2691,1775,4466
41539,Iona,Irlam,iirlamhj@newyorker.com,Senior Quality Engineer,9097,1906,11003
41584,Mead,Warder,mwarderhk@mit.edu,Account Executive,6595,990,7585
41233,Letizia,Dombrell,ldombrellhn@yellowpages.com,Analog Circuit Design manager,1962,1919,3881
41799,Randie,Rabb,rrabbho@addtoany.com,Budget/Accounting Analyst IV,6352,353,6705
41334,Belicia,Wreath,bwreathhq@java.com,Automation Specialist II,1727,1469,3196
41854,Lindie,Antonucci,lantonucciht@ftc.gov,Senior Developer,7325,1889,9214
41162,Ashleigh,Ebsworth,aebsworthhv@xinhuanet.com,Account Coordinator,2473,1796,4269
41446,Ursuline,Pringell,upringellhw@blogger.com,Quality Control Specialist,6036,1474,7510
41919,Demetria,Maypole,dmaypolehy@pbs.org,Dental Hygienist,5538,514,6052
41807,Jo-ann,Shildrick,jshildrickhz@ucla.edu,Junior Executive,6833,544,7377
41321,Benjamen,Rustman,brustmani2@gov.uk,Accountant I,2595,695,3290
41098,Tadd,Griniov,tgriniovi3@smugmug.com,Assistant Media Planner,2877,214,3091
41117,Amos,Espadater,aespadateri4@ycombinator.com,Financial Analyst,5421,345,5766
41042,Galina,Axworthy,gaxworthyi5@go.com,Account Executive,6011,1962,7973
41209,Nelie,Wagge,nwaggei6@mac.com,Physical Therapy Assistant,2408,499,2907
41491,Gordon,Iffland,gifflandia@quantcast.com,Dental Hygienist,6816,290,7106
41710,Roxine,Frowen,rfrowenib@google.com,Research Nurse,9406,680,10086
41897,Leontyne,Gair,lgairic@sciencedaily.com,Software Test Engineer I,7259,1042,8301
41998,Sara,Ridley,sridleyif@europa.eu,Product Engineer,5030,1358,6388
41304,Alistair,Blayd,ablaydig@cdbaby.com,Business Systems Development Analyst,6146,1592,7738
41507,Josy,Kettley,jkettleyii@edublogs.org,Account Representative I,6942,1920,8862
41257,Nicolina,Rathbone,nrathboneik@cocolog-nifty.com,Quality Control Specialist,9587,763,10350
41047,Haleigh,Tomanek,htomanekil@unblog.fr,Clinical Specialist,7639,730,8369
41450,Eleanora,Dellenbach,edellenbachim@tinyurl.com,Dental Hygienist,5352,968,6320
41867,Pavlov,O'Mailey,pomaileyio@booking.com,Analog Circuit Design manager,9496,1286,10782
41302,Barris,Gillian,bgillianip@umn.edu,Research Associate,1291,270,1561
41467,Clari,Hollyer,chollyeriq@toplist.cz,Marketing Assistant,1627,1508,3135
41779,Merwin,Wolfe,mwolfeis@dot.gov,Executive Secretary,7840,1939,9779
41181,Maurise,Tweedell,mtweedellit@photobucket.com,Pharmacist,3095,1898,4993
41979,Ernest,D'Emanuele,edemanueleiv@163.com,Chemical Engineer,1136,1486,2622
41917,Kimball,Piquard,kpiquardix@statcounter.com,GIS Technical Architect,4983,1951,6934
41852,Perl,Enrico,penricoj0@discuz.net,Software Test Engineer II,5764,1448,7212
41492,Quintilla,Seage,qseagej2@chronoengine.com,Business Systems Development Analyst,3040,989,4029
41972,Ches,Bramelt,cbrameltj6@desdev.cn,Environmental Tech,8956,690,9646
41530,Sybille,Burnel,sburnelj7@bloglines.com,Desktop Support Technician,2795,1198,3993
41777,Christy,Bonnette,cbonnettej8@themeforest.net,Technical Writer,9829,444,10273
41870,Dasya,Hatrey,dhatreyj9@java.com,Web Designer I,3588,555,4143
41223,Erinna,Seawright,eseawrightja@epa.gov,Operator,1570,1980,3550
41019,Kristine,Bortolozzi,kbortolozzijb@phoca.cz,Systems Administrator III,1214,692,1906
41535,Ashil,MacAllen,amacallenjc@meetup.com,Assistant Professor,7004,1627,8631
41392,Marcus,Tilt,mtiltje@drupal.org,Editor,3280,770,4050
41247,Tybie,Battye,tbattyejf@uiuc.edu,Health Coach III,6423,977,7400
41405,Onfre,Rainard,orainardjg@intel.com,Research Assistant III,3636,1488,5124
41471,Rebbecca,Yesenin,ryeseninjh@java.com,Financial Analyst,8910,578,9488
41788,Noble,Pickerin,npickerinjl@dion.ne.jp,Database Administrator III,9122,330,9452
41187,Cherlyn,Quilleash,cquilleashjm@skype.com,Teacher,8187,999,9186
41986,Shalne,Brobak,sbrobakjn@ed.gov,Internal Auditor,4913,294,5207
41681,Edin,Hiskey,ehiskeyjo@wikispaces.com,Marketing Assistant,1704,1881,3585
41593,Walton,Philipeaux,wphilipeauxjp@so-net.ne.jp,Geologist IV,7814,701,8515
41686,Leisha,Aucourte,laucourtejs@time.com,Paralegal,8981,1210,10191
41892,Kristian,Treadaway,ktreadawayjw@upenn.edu,Research Nurse,7248,787,8035
41015,Giulia,Danilchenko,gdanilchenkojy@infoseek.co.jp,Biostatistician III,5864,1599,7463
41164,Arch,Cratchley,acratchleyk1@paypal.com,Software Test Engineer IV,1859,1909,3768
41351,Husain,Brownbill,hbrownbillk4@wp.com,Software Test Engineer III,8892,1569,10461
41694,Abbe,Doore,adoorek8@vimeo.com,Chief Design Engineer,4675,1412,6087
41370,Sinclare,Normaville,snormavillek9@geocities.com,Graphic Designer,4428,995,5423
41111,Eberto,Yallowley,eyallowleyka@ustream.tv,VP Product Management,1226,652,1878
41569,Glynda,Danett,gdanettkb@springer.com,Help Desk Operator,3485,759,4244
41323,Baxie,Malshinger,bmalshingerkd@123-reg.co.uk,Assistant Media Planner,5600,1435,7035
41497,Paulita,Deem,pdeemke@geocities.com,Clinical Specialist,2056,954,3010
41528,Miltie,Ebbutt,mebbuttkf@nbcnews.com,Research Associate,5737,891,6628
41949,Hyatt,O'Leahy,holeahykj@nbcnews.com,Senior Developer,6901,1363,8264
41604,Madelle,Tessington,mtessingtonkk@discuz.net,VP Accounting,5231,1218,6449
41165,Wittie,Merrell,wmerrellkq@gov.uk,Physical Therapy Assistant,9217,1903,11120
41297,Sullivan,Leithgoe,sleithgoekt@sohu.com,Recruiting Manager,2621,857,3478
41186,Obed,Rosbrough,orosbroughku@google.nl,Executive Secretary,8449,640,9089
41475,Corbin,Heathfield,cheathfieldkv@psu.edu,Senior Sales Associate,4845,214,5059
41878,Humberto,Titmarsh,htitmarshky@statcounter.com,Chief Design Engineer,2736,1345,4081
41626,Nerti,Maxted,nmaxtedkz@yellowbook.com,Physical Therapy Assistant,8217,1249,9466
41005,Jesselyn,Ranby,jranbyl2@bizjournals.com,VP Sales,7376,1060,8436
41090,Barnabas,Grassick,bgrassickl3@barnesandnoble.com,Analog Circuit Design manager,5307,1839,7146
41648,Kristos,Brunetti,kbrunettil9@google.co.jp,Human Resources Assistant IV,9501,1834,11335
41577,Quill,Reichhardt,qreichhardtla@goo.ne.jp,Programmer Analyst I,7172,1605,8777
41158,Francesca,Vitet,fvitetlb@cnet.com,GIS Technical Architect,5810,638,6448
41761,Cristie,Jacobs,cjacobsle@google.com.br,Desktop Support Technician,7590,1436,9026
41813,Roslyn,Griffe,rgriffelg@mapquest.com,Professor,1043,1030,2073
41438,Arnaldo,Selliman,asellimanlj@ihg.com,Account Representative I,9755,855,10610
41054,Conway,Blunsom,cblunsomlk@google.com.au,Design Engineer,6202,602,6804
41463,Wren,Rickcord,wrickcordlm@qq.com,Office Assistant IV,8931,1284,10215
41581,Glenn,Bubbings,gbubbingslp@opensource.org,Community Outreach Specialist,8847,337,9184
41634,Ewart,Maylott,emaylottls@gnu.org,Paralegal,6136,1960,8096
41548,Teodoor,Kynoch,tkynochlv@istockphoto.com,Teacher,1172,1826,2998
41357,Elka,Carlisso,ecarlissolx@com.com,Human Resources Manager,3269,463,3732
41712,Leigha,Gauntley,lgauntleym1@wsj.com,Accounting Assistant IV,3212,466,3678
41241,Delcine,Senechault,dsenechaultm2@jalbum.net,Account Representative IV,8054,1754,9808
41189,Sheffy,Jankovsky,sjankovskym5@answers.com,Chief Design Engineer,3640,1929,5569
41811,Lizzy,Bailey,lbaileym7@hatena.ne.jp,Senior Editor,8305,1889,10194
41766,Giffer,Miskelly,gmiskellym8@wufoo.com,Programmer II,4192,546,4738
41009,Carla,Crowther,ccrowtherm9@uol.com.br,Human Resources Manager,2308,777,3085
41541,Hilary,Godden,hgoddenmb@gnu.org,Engineer II,3489,1900,5389
41829,Gusta,Elston,gelstonmc@yelp.com,Budget/Accounting Analyst IV,6830,1133,7963
41308,Ravi,Haliburton,rhaliburtonmg@sina.com.cn,Environmental Specialist,3172,398,3570
41154,Shurlocke,Durbridge,sdurbridgemo@shop-pro.jp,Analog Circuit Design manager,2023,304,2327
41159,Brett,Bridgett,bbridgettmq@wordpress.org,Quality Engineer,2891,948,3839
41845,Gretel,McGarel,gmcgarelmr@delicious.com,Statistician II,3041,842,3883
41286,Ban,Aylesbury,baylesburymw@nymag.com,Marketing Manager,8974,247,9221
41484,Daphene,Korejs,dkorejsmx@google.ca,Project Manager,6255,860,7115
41789,Elsinore,Coaten,ecoatenn0@nps.gov,Financial Analyst,2032,549,2581
41476,Sadie,Luby,slubyn1@sphinn.com,Legal Assistant,4418,1603,6021
41787,Wat,MacSharry,wmacsharryn6@economist.com,General Manager,1179,1903,3082
41031,Ryley,Piercey,rpierceyn7@amazon.co.jp,Research Nurse,3797,561,4358
41542,Eamon,Swanborough,eswanboroughna@purevolume.com,Quality Engineer,9642,305,9947
41058,Gawen,Faivre,gfaivrenc@parallels.com,Executive Secretary,7788,1997,9785
41740,Asa,O'Tuohy,aotuohyne@xing.com,Accountant I,2188,241,2429
41981,Cornelius,Gonnin,cgonninng@hc360.com,Programmer IV,8823,1200,10023
41797,Kevin,Thurborn,kthurbornnh@taobao.com,Developer I,4707,801,5508
41468,Hermine,Penfold,hpenfoldni@meetup.com,Human Resources Assistant IV,4231,209,4440
41800,Filmore,Schwander,fschwanderno@topsy.com,Mechanical Systems Engineer,1210,874,2084
41120,Jaine,Rotter,jrotternp@columbia.edu,Recruiter,8981,680,9661
41842,Milton,Stubbs,mstubbsnq@economist.com,Financial Advisor,2967,1825,4792
41150,Harbert,Grafom,hgrafomns@who.int,Software Consultant,2362,1857,4219
41274,Chantalle,Stothard,cstothardnw@dot.gov,Community Outreach Specialist,8227,1939,10166
41518,Bryon,Abrahm,babrahmnx@blinklist.com,Systems Administrator II,5428,1086,6514
41907,Pammy,Nixon,pnixono0@chicagotribune.com,Electrical Engineer,3227,1652,4879
41502,Sallyann,O'Dowling,sodowlingo6@parallels.com,VP Accounting,2898,1978,4876
41549,Ozzy,Cornbell,ocornbello8@tinyurl.com,Software Engineer III,7615,1069,8684
41276,Torrin,Tonks,ttonksoa@hugedomains.com,Computer Systems Analyst I,2545,1403,3948
41563,Manya,Tanzig,mtanzigob@twitter.com,Electrical Engineer,4249,1020,5269
41329,Curr,Wathen,cwathenoc@hao123.com,VP Accounting,9358,1821,11179
41030,Barrett,Ameer-Beg,bameerbegoi@mediafire.com,VP Marketing,5155,552,5707
41188,Kin,Toby,ktobyoj@google.co.uk,Safety Technician IV,1428,1276,2704
41259,Jone,Lamkin,jlamkinol@digg.com,Web Designer IV,8282,708,8990
41621,Gayla,Wyd,gwydon@rediff.com,Developer II,5710,562,6272
41434,Kippy,Benmore,kbenmoreoo@princeton.edu,Paralegal,8644,1557,10201
41242,Tann,Lidgey,tlidgeyop@nymag.com,Senior Developer,8526,1360,9886
41073,Sula,Estrella,sestrellaot@fastcompany.com,Marketing Assistant,6100,1650,7750
41022,Sullivan,Mate,smateov@state.tx.us,Staff Scientist,5790,681,6471
41737,Arther,Goscar,agoscarox@hao123.com,Information Systems Manager,6325,311,6636
41102,Paola,Rookledge,prookledgep3@skyrock.com,Quality Control Specialist,7722,797,8519
41996,Quinlan,Bonham,qbonhamp6@mapquest.com,Senior Cost Accountant,2988,1068,4056
41959,Stefan,Kilgrove,skilgrovep8@360.cn,Associate Professor,5282,1729,7011
41217,Eloise,Zanicchelli,ezanicchellipa@oaic.gov.au,Food Chemist,6791,1746,8537
41828,Christye,M'Quhan,cmquhanpb@yahoo.co.jp,Physical Therapy Assistant,9871,1834,11705
41786,Gayler,Winter,gwinterpl@forbes.com,Software Engineer II,3348,1124,4472
41947,Frans,Chettoe,fchettoepp@bravesites.com,Desktop Support Technician,4034,1442,5476
41145,Stephannie,Rolling,srollingps@independent.co.uk,Chemical Engineer,5281,551,5832
41493,Simmonds,Frood,sfroodpu@flickr.com,Electrical Engineer,6249,756,7005
41400,Clara,Aldie,caldiepw@sciencedirect.com,Human Resources Manager,9924,288,10212
41160,Malva,Iggulden,migguldenpx@bloglovin.com,Executive Secretary,6844,1137,7981
41628,Zacherie,Cardoo,zcardoopz@mozilla.org,Actuary,3739,1930,5669
41654,Mack,Castiblanco,mcastiblancoq3@symantec.com,Geologist III,9524,1618,11142
41004,Tate,Stourton,tstourtonq6@free.fr,Automation Specialist IV,9807,421,10228
41459,Bernard,Dalbey,bdalbeyqb@hibu.com,Editor,2452,1608,4060
41079,Wilma,Lendrem,wlendremqe@nbcnews.com,Compensation Analyst,7895,215,8110
41537,Karena,Rydings,krydingsqf@nps.gov,Assistant Manager,7798,1333,9131
41596,Maxy,Vennings,mvenningsqi@yandex.ru,Software Consultant,8488,1170,9658
41683,Arluene,Grieger,agriegerqk@fda.gov,Accountant II,9879,1758,11637
41921,Maynard,Nail,mnailqp@state.gov,Occupational Therapist,1589,611,2200
41782,Caprice,Geldard,cgeldardqq@yandex.ru,Actuary,3986,1455,5441
41516,Misti,Aindrais,maindraisqu@marketwatch.com,Accountant II,5343,1227,6570
41995,Maggi,Lowell,mlowellqv@gizmodo.com,Software Engineer IV,2806,735,3541
41665,Page,Gaymar,pgaymarqw@craigslist.org,Research Associate,5307,1321,6628
41975,Maurine,Bryan,mbryanr2@marriott.com,Account Executive,8905,1148,10053
41819,Terry,Punt,tpuntr3@unc.edu,Web Developer IV,6160,1370,7530
41632,Sansone,Ginman,sginmanr5@taobao.com,Marketing Manager,6764,276,7040
41936,Simonette,Coie,scoier6@is.gd,Cost Accountant,2911,473,3384
41834,Billie,Poon,bpoonr9@symantec.com,Pharmacist,1476,1584,3060
41100,Paula,Milligan,pmilliganra@plala.or.jp,Director of Sales,1063,1346,2409
41025,Evangelin,Muncey,emunceyrc@about.me,Associate Professor,8680,466,9146
41085,Arnold,Roose,arooserd@studiopress.com,Sales Associate,8997,649,9646
41755,Rudolfo,Hincks,rhincksre@un.org,Research Assistant IV,6518,508,7026
41506,Shannan,Westcarr,swestcarrrf@google.co.jp,Social Worker,3519,517,4036
41891,Philly,Gauld,pgauldrj@freewebs.com,VP Marketing,3098,865,3963
41725,Esme,Verity,everityrl@mapquest.com,Geologist III,1625,767,2392
41622,Dermot,Ortner,dortnerrq@answers.com,Project Manager,7532,1400,8932
42443,Frederigo,Jaycocks,fjaycocks0@pbs.org,Help Desk Technician,4110,1558,5668
42778,Tiphanie,Bengtson,tbengtson1@dmoz.org,Marketing Manager,6807,231,7038
42529,Demetria,Ronnay,dronnay2@bbc.co.uk,Help Desk Technician,6888,832,7720
42972,Jared,Reburn,jreburn3@state.tx.us,Account Coordinator,6287,1758,8045
42627,Nariko,O'Farris,nofarris4@dion.ne.jp,Senior Financial Analyst,1427,1912,3339
42774,Abraham,Rayment,arayment5@free.fr,Recruiting Manager,1187,738,1925
42922,Erda,Heggison,eheggison6@gmpg.org,Research Assistant IV,9899,823,10722
42246,Glennie,Stennings,gstennings7@1688.com,Developer I,4603,1865,6468
42547,Torre,Shreeves,tshreeves9@geocities.jp,Recruiting Manager,4821,1695,6516
42781,Ruddy,Longmire,rlongmireb@furl.net,Health Coach III,6885,333,7218
42558,Lotta,Ledson,lledsonc@com.com,Senior Editor,4930,330,5260
42331,Marielle,McCudden,mmccuddend@vinaora.com,Recruiter,9992,317,10309
42171,Lindsy,Showte,lshowtee@npr.org,Environmental Specialist,3335,1947,5282
42326,Kimberli,Abadam,kabadamf@arstechnica.com,Electrical Engineer,5856,1821,7677
42567,Heall,Margrem,hmargremg@wired.com,Analog Circuit Design manager,7782,1042,8824
42679,Aksel,Iacoviello,aiacovielloh@yellowbook.com,Information Systems Manager,1170,1717,2887
42745,Crissy,Heditch,cheditchi@cocolog-nifty.com,Project Manager,9153,1314,10467
42436,Sigmund,Munsey,smunseyj@techcrunch.com,Senior Developer,6274,1032,7306
42336,Pace,Ida,pidak@goo.ne.jp,Analog Circuit Design manager,1391,378,1769
42298,Elbertine,Keirle,ekeirlel@squarespace.com,Project Manager,1336,571,1907
42611,Lionel,Seedhouse,lseedhousem@mlb.com,Director of Sales,1077,1246,2323
42519,Tracy,Gaudin,tgaudinn@blogtalkradio.com,Payment Adjustment Coordinator,7215,1572,8787
42369,Lisabeth,Mulford,lmulfordo@sfgate.com,Quality Control Specialist,9981,795,10776
42021,Dorella,Elies,deliesp@sohu.com,Account Executive,2444,991,3435
42231,Mikaela,Muldoon,mmuldoonq@ning.com,Director of Sales,3266,1876,5142
42480,Helene,Dracksford,hdracksfordr@yahoo.co.jp,Human Resources Manager,5205,205,5410
42583,Obed,Mattock,omattocks@webeden.co.uk,Developer I,4702,1412,6114
42635,Tallie,Pavinese,tpavineset@canalblog.com,Statistician IV,3297,1308,4605
42062,Barr,Arthy,barthyu@usatoday.com,Civil Engineer,5084,973,6057
42578,Ofelia,Seckom,oseckomv@icio.us,Dental Hygienist,8022,1776,9798
42332,Patrizia,Davenport,pdavenportw@newsvine.com,Product Engineer,5935,723,6658
42675,Sheree,Hayto,shaytoy@feedburner.com,Internal Auditor,7669,1096,8765
42296,Jaquenetta,Culpen,jculpenz@ow.ly,GIS Technical Architect,3909,636,4545
42953,Bengt,Stoddart,bstoddart10@sfgate.com,Internal Auditor,5716,1832,7548
42312,Theresita,Late,tlate11@163.com,Product Engineer,7564,1243,8807
42846,Rudolf,Markel,rmarkel12@sogou.com,Physical Therapy Assistant,8223,538,8761
42410,Tawsha,Tarbet,ttarbet13@tinyurl.com,Mechanical Systems Engineer,2626,499,3125
42355,Margalo,Swalough,mswalough14@networkadvertising.org,Help Desk Operator,8320,1775,10095
42682,Roley,Carver,rcarver15@delicious.com,Health Coach III,5455,1996,7451
42809,Kingsly,Dobkin,kdobkin16@amazon.co.jp,Accountant II,3900,1029,4929
42647,Wood,Murr,wmurr17@ftc.gov,Health Coach III,2333,518,2851
42353,Horton,Huelin,hhuelin18@dailymail.co.uk,Project Manager,1734,579,2313
42761,Jacquelynn,Maylam,jmaylam19@businessweek.com,Electrical Engineer,4554,1893,6447
42235,Brigida,McCluskey,bmccluskey1a@jigsy.com,Quality Engineer,9859,725,10584
42263,Shaylynn,Radbourn,sradbourn1c@goo.ne.jp,Chief Design Engineer,1705,1753,3458
42736,Tobie,Dumblton,tdumblton1d@columbia.edu,VP Quality Control,8501,431,8932
42009,Candida,Antosch,cantosch1e@parallels.com,Marketing Manager,6283,286,6569
42815,Andriette,Barth,abarth1f@sina.com.cn,Executive Secretary,3473,502,3975
42899,Tamma,Gippes,tgippes1g@washington.edu,Biostatistician IV,9843,1938,11781
42496,Marilee,Philliskirk,mphilliskirk1h@howstuffworks.com,Software Test Engineer I,5108,559,5667
42991,Eziechiele,Perle,eperle1i@independent.co.uk,Assistant Professor,4429,662,5091
42434,Deane,Haffard,dhaffard1j@google.de,Pharmacist,2286,1400,3686
42982,Dorise,Tessington,dtessington1k@bloglines.com,Statistician I,4592,1257,5849
42632,Cull,Gebbe,cgebbe1l@sakura.ne.jp,Geologist II,5886,1685,7571
42315,Amabelle,MacQuaker,amacquaker1m@themeforest.net,Professor,5310,1608,6918
42925,Hugh,Gooda,hgooda1n@statcounter.com,Paralegal,9496,1040,10536
42513,Hester,Ruler,hruler1o@i2i.jp,Engineer I,1043,1368,2411
42214,Luci,Hatchard,lhatchard1p@cbc.ca,Tax Accountant,7324,922,8246
42219,Nilson,Abeau,nabeau1q@comcast.net,Office Assistant III,6786,1257,8043
42936,Danielle,Stawell,dstawell1r@networkadvertising.org,Geologist I,9272,301,9573
42708,Frazer,Zaple,fzaple1s@dmoz.org,Recruiting Manager,8389,1500,9889
42013,Jereme,Brooker,jbrooker1t@angelfire.com,Administrative Assistant I,6935,1583,8518
42760,Corty,Driussi,cdriussi1u@biglobe.ne.jp,Paralegal,8308,1151,9459
42975,Alf,Yegorkov,ayegorkov1v@sciencedaily.com,Administrative Assistant II,4086,1358,5444
42676,Vikki,Hengoed,vhengoed1w@omniture.com,Administrative Assistant IV,6308,1190,7498
42800,Daryl,Stollenbeck,dstollenbeck1x@ning.com,Media Manager IV,8975,1488,10463
42866,Chloette,Yaldren,cyaldren1y@cornell.edu,Occupational Therapist,2570,622,3192
42010,Dillon,Trase,dtrase1z@trellian.com,Database Administrator I,4941,987,5928
42725,Joel,Simanenko,jsimanenko20@pinterest.com,GIS Technical Architect,4076,1294,5370
42864,Jaimie,Nance,jnance21@csmonitor.com,VP Marketing,1991,1607,3598
42582,Ashlen,Frizell,afrizell22@nhs.uk,Accounting Assistant IV,7132,1262,8394
42543,Kanya,Brewin,kbrewin23@wikispaces.com,Food Chemist,5543,1614,7157
42220,Ramsay,Meffan,rmeffan24@freewebs.com,Chief Design Engineer,8684,409,9093
42432,Alameda,Bernardotti,abernardotti26@kickstarter.com,Senior Sales Associate,5980,779,6759
42002,Kristel,Cavil,kcavil27@joomla.org,Marketing Manager,5882,1661,7543
42437,Sal,Christophle,schristophle28@storify.com,Electrical Engineer,1914,1745,3659
42648,Seka,Feaks,sfeaks29@rakuten.co.jp,Administrative Officer,6172,1496,7668
42560,Ethe,Sheaf,esheaf2b@senate.gov,Senior Quality Engineer,1879,1893,3772
42302,Flossie,Blenkensop,fblenkensop2c@geocities.jp,Biostatistician I,8074,1225,9299
42290,Audry,Carvell,acarvell2d@cnbc.com,Data Coordiator,1372,1953,3325
42654,Sarene,Minnis,sminnis2e@bbb.org,Accountant II,4936,1725,6661
42377,Shaina,Gyngell,sgyngell2f@list-manage.com,Geologist III,1181,214,1395
42327,Gillian,Collister,gcollister2g@cmu.edu,Dental Hygienist,7055,1829,8884
42119,Leeann,Furlonge,lfurlonge2h@smugmug.com,Registered Nurse,5588,1359,6947
42237,Natalya,Alishoner,nalishoner2i@cmu.edu,VP Quality Control,9968,1664,11632
42557,Vachel,Atcock,vatcock2j@icq.com,Senior Quality Engineer,1401,512,1913
42848,Janek,Conlon,jconlon2k@cyberchimps.com,Graphic Designer,7853,1284,9137
42789,Emylee,Depka,edepka2l@blogs.com,Sales Associate,2817,1353,4170
42952,Ellie,Jurkowski,ejurkowski2m@blogspot.com,Mechanical Systems Engineer,8199,1777,9976
42236,Phebe,Grint,pgrint2n@merriam-webster.com,Research Assistant III,5252,849,6101
42965,Gwendolyn,Mosdell,gmosdell2o@youtu.be,Design Engineer,5686,1002,6688
42252,Maible,Tretter,mtretter2p@a8.net,Developer I,9519,775,10294
42276,Vern,Swinn,vswinn2q@nymag.com,Database Administrator I,1343,1108,2451
42362,Gerik,Lamperd,glamperd2r@state.gov,Nurse,2042,1121,3163
42085,Friedrich,Fruen,ffruen2t@walmart.com,Database Administrator III,2833,396,3229
42795,Malina,Blayney,mblayney2u@cdbaby.com,Product Engineer,8408,479,8887
42051,Kris,Feary,kfeary2w@msu.edu,Environmental Tech,2640,1743,4383
42384,Cathrine,Formby,cformby2x@bluehost.com,Health Coach II,2755,1824,4579
42655,West,Trelevan,wtrelevan2y@joomla.org,Social Worker,6749,1008,7757
42381,Gregorio,Cressor,gcressor2z@ning.com,Statistician II,9961,1952,11913
42075,Marlin,Dallewater,mdallewater30@wufoo.com,Director of Sales,8924,832,9756
42510,Dolorita,Chisnell,dchisnell31@etsy.com,General Manager,3671,1783,5454
42226,Jodi,Earwaker,jearwaker32@msu.edu,Help Desk Technician,2782,1475,4257
42186,Josselyn,Hardin,jhardin33@weibo.com,Senior Cost Accountant,9952,1803,11755
42258,Jenni,Campe,jcampe34@ebay.co.uk,Social Worker,1507,1552,3059
42018,Gennifer,Spinage,gspinage35@usatoday.com,Assistant Professor,1237,632,1869
42399,Janette,Hussy,jhussy36@squidoo.com,Nurse,6477,1135,7612
42971,Valencia,Dorricott,vdorricott37@telegraph.co.uk,Software Engineer II,6426,639,7065
42605,Jyoti,Mountfort,jmountfort38@taobao.com,Software Consultant,2081,1348,3429
42500,Eve,Smallcombe,esmallcombe39@ow.ly,Help Desk Technician,9785,1197,10982
42539,Jaquelin,Gabriely,jgabriely3a@linkedin.com,Community Outreach Specialist,5182,1514,6696
42065,Simone,Conwell,sconwell3b@cargocollective.com,General Manager,3194,307,3501
42149,Shell,Cullagh,scullagh3c@devhub.com,Teacher,7820,1582,9402
42542,Udall,Fillgate,ufillgate3d@blogger.com,Legal Assistant,7481,1180,8661
42750,Gertruda,Androsik,gandrosik3e@facebook.com,Pharmacist,2972,521,3493
42376,Derick,Pendlebury,dpendlebury3f@about.com,VP Sales,8709,686,9395
42003,Theo,Merali,tmerali3g@privacy.gov.au,Accountant I,4175,1986,6161
42950,Jerri,Haselwood,jhaselwood3h@rakuten.co.jp,Administrative Officer,2717,497,3214
42572,Vanda,Eatock,veatock3i@desdev.cn,Associate Professor,9448,838,10286
42875,Alison,Waszczyk,awaszczyk3j@auda.org.au,VP Quality Control,8392,1208,9600
42014,Elinore,Durdy,edurdy3k@google.com.br,Dental Hygienist,5098,1276,6374
42770,Evyn,Enriquez,eenriquez3l@virginia.edu,Graphic Designer,4780,620,5400
42923,Lyndsie,Brosnan,lbrosnan3m@ucsd.edu,Account Executive,2778,477,3255
42825,Cristabel,Buffy,cbuffy3n@slashdot.org,Human Resources Manager,4589,1992,6581
42883,Cristen,Lenoir,clenoir3o@forbes.com,Database Administrator II,3585,980,4565
42910,Lesley,Accum,laccum3p@epa.gov,Paralegal,4623,1680,6303
42674,Belia,Millthorpe,bmillthorpe3q@wunderground.com,Data Coordiator,3072,609,3681
42152,Roderick,Kellie,rkellie3r@imageshack.us,Nurse,2572,1428,4000
42268,Nilson,Offener,noffener3s@seattletimes.com,Administrative Assistant I,3256,305,3561
42810,Artemis,Hydes,ahydes3t@networkadvertising.org,Pharmacist,1998,1120,3118
42477,Rozella,Douche,rdouche3u@mlb.com,Accounting Assistant III,4010,782,4792
42565,Dollie,Sjostrom,dsjostrom3v@nymag.com,Engineer II,8820,908,9728
42354,Ermina,Durnall,edurnall3w@statcounter.com,Nurse Practicioner,8045,1768,9813
42744,Holmes,Poley,hpoley3x@barnesandnoble.com,Assistant Manager,7958,462,8420
42467,Lebbie,Morena,lmorena3y@cam.ac.uk,Automation Specialist II,6451,436,6887
42586,Idalia,Sinnatt,isinnatt40@pcworld.com,Librarian,4088,1013,5101
42004,Zelda,Spivey,zspivey41@chicagotribune.com,Internal Auditor,8552,1796,10348
42737,Dotti,Leathley,dleathley42@tmall.com,Senior Cost Accountant,3511,1177,4688
42167,Gabey,O'Glassane,goglassane43@auda.org.au,Systems Administrator II,2498,970,3468
42734,Terencio,Rickard,trickard44@imageshack.us,Speech Pathologist,8255,463,8718
42929,Margarette,Breitler,mbreitler45@aol.com,Analog Circuit Design manager,3963,1889,5852
42259,Ferdinand,Jevons,fjevons46@deviantart.com,Web Designer II,6081,439,6520
42022,Konstance,Donoghue,kdonoghue47@latimes.com,Operator,2083,731,2814
42208,Jessamine,Duplain,jduplain48@npr.org,Biostatistician I,3863,1869,5732
42164,Rozele,De Biasi,rdebiasi49@surveymonkey.com,Computer Systems Analyst III,8135,613,8748
42160,Christy,Judd,cjudd4a@jigsy.com,Biostatistician II,1766,1638,3404
42609,Joceline,Speedy,jspeedy4b@artisteer.com,Operator,1641,710,2351
42255,Morgana,Heephy,mheephy4c@yolasite.com,Senior Cost Accountant,2991,951,3942
42128,Whitby,Locock,wlocock4d@mozilla.org,Programmer Analyst IV,1024,1225,2249
42484,Delmor,Bellows,dbellows4f@google.cn,Nuclear Power Engineer,2927,252,3179
42884,Clarie,Keat,ckeat4g@un.org,Editor,8207,474,8681
42421,Artair,Macer,amacer4h@acquirethisname.com,Database Administrator IV,9139,584,9723
42196,Bobbie,Freeman,bfreeman4i@prlog.org,Web Designer I,6769,395,7164
42321,Claire,Capun,ccapun4k@springer.com,Accounting Assistant IV,3311,1046,4357
42837,Odell,Cowl,ocowl4l@bandcamp.com,Automation Specialist II,4573,1675,6248
42396,Gibb,Wennam,gwennam4m@bigcartel.com,Business Systems Development Analyst,3349,1318,4667
42726,Meara,Amort,mamort4n@cocolog-nifty.com,Health Coach IV,7708,1760,9468
42822,Deirdre,Giller,dgiller4o@smh.com.au,Legal Assistant,1221,1435,2656
42227,Bryna,Sworder,bsworder4p@washingtonpost.com,Research Nurse,7578,1248,8826
42613,Pansie,Shapcott,pshapcott4q@ca.gov,Quality Control Specialist,3885,215,4100
42594,Vida,Richardon,vrichardon4r@tuttocitta.it,Statistician IV,8116,1741,9857
42144,Emelita,Spencelayh,espencelayh4s@phoca.cz,Accountant II,8987,1031,10018
42808,Corie,Downham,cdownham4t@unc.edu,Senior Financial Analyst,6038,805,6843
42370,Morissa,Flay,mflay4u@china.com.cn,Account Coordinator,9379,248,9627
42643,Josee,McCroft,jmccroft4v@washington.edu,Internal Auditor,2558,628,3186
42505,Scarface,Ramos,sramos4w@mit.edu,Structural Analysis Engineer,8100,678,8778
42865,Yank,Riddel,yriddel4x@google.fr,Help Desk Technician,3332,310,3642
42034,Ingaberg,Canlin,icanlin4y@wisc.edu,Human Resources Assistant III,6661,1079,7740
42071,Rosabella,Towsie,rtowsie4z@cdbaby.com,Account Coordinator,4997,1436,6433
42814,Lilly,Mollin,lmollin50@artisteer.com,Database Administrator II,5677,431,6108
42455,Cori,Richardeau,crichardeau51@sitemeter.com,Senior Editor,8072,1770,9842
42498,Dyane,Sommerfeld,dsommerfeld52@devhub.com,Structural Analysis Engineer,2581,1777,4358
42693,Candy,Kerne,ckerne55@sitemeter.com,Data Coordiator,9433,500,9933
42125,Isadora,Deares,ideares56@sun.com,Computer Systems Analyst IV,9878,1348,11226
42095,Mervin,Cholonin,mcholonin58@usgs.gov,Recruiting Manager,3044,1012,4056
42101,Raul,Imort,rimort5a@jugem.jp,Staff Accountant II,1995,1584,3579
42282,Emelita,Doddemeade,edoddemeade5b@vkontakte.ru,Financial Analyst,9975,320,10295
42812,Addie,McLemon,amclemon5d@tamu.edu,Cost Accountant,9599,301,9900
42780,Katlin,Delgado,kdelgado5e@smh.com.au,Nurse,9097,950,10047
42742,Rickey,Albinson,ralbinson5f@go.com,Physical Therapy Assistant,1390,892,2282
42313,Halsy,Itzhak,hitzhak5g@comcast.net,Data Coordiator,1245,292,1537
42242,Ferdy,L' Anglois,flanglois5h@bing.com,Recruiting Manager,2992,809,3801
42595,Garnette,Loche,gloche5j@loc.gov,Internal Auditor,1274,1466,2740
42148,Marillin,Bonnick,mbonnick5k@salon.com,Nuclear Power Engineer,4051,1562,5613
42346,Jessa,Kliemann,jkliemann5m@mit.edu,Community Outreach Specialist,7721,1308,9029
42361,Helena,Slobom,hslobom5n@twitpic.com,Analog Circuit Design manager,7862,1325,9187
42459,Debor,Tredinnick,dtredinnick5o@bing.com,Marketing Manager,1714,1723,3437
42389,Kipp,Eilers,keilers5p@instagram.com,Recruiting Manager,5811,381,6192
42603,Rodge,Gannicleff,rgannicleff5q@adobe.com,Research Assistant III,5299,1269,6568
42876,Verge,Coal,vcoal5r@berkeley.edu,Research Associate,7872,1938,9810
42511,Daniele,Spoors,dspoors5s@amazon.de,Environmental Tech,6950,375,7325
42316,Dulsea,Billings,dbillings5t@goodreads.com,Assistant Manager,2126,778,2904
42093,Sigrid,Danelut,sdanelut5u@weibo.com,VP Accounting,8329,1733,10062
42661,Brande,Verne,bverne5w@abc.net.au,Administrative Officer,7323,1905,9228
42142,Cornelia,Culligan,cculligan5x@nydailynews.com,Mechanical Systems Engineer,3183,1319,4502
42043,Willy,Greenside,wgreenside5y@twitter.com,Office Assistant IV,8130,1625,9755
42527,Kinnie,Abramski,kabramski5z@typepad.com,Pharmacist,4217,998,5215
42147,Gertrudis,Gillmore,ggillmore61@sciencedirect.com,Research Nurse,9639,357,9996
42828,Edithe,Halversen,ehalversen62@independent.co.uk,Tax Accountant,6228,1148,7376
42690,Lyndsie,Duxbury,lduxbury63@google.ca,Project Manager,1999,913,2912
42245,Cam,Penritt,cpenritt64@ox.ac.uk,Director of Sales,6503,1367,7870
42008,Martyn,Grayham,mgrayham65@mtv.com,Research Assistant II,2520,1049,3569
42210,Shanan,Kern,skern66@nsw.gov.au,Nurse,3967,806,4773
42449,Ganny,Grieves,ggrieves67@sciencedaily.com,Senior Financial Analyst,8601,622,9223
42677,Theresa,Fowden,tfowden68@dion.ne.jp,Staff Accountant II,8185,1012,9197
42041,Christie,Ivanov,civanov69@npr.org,Accounting Assistant IV,2159,1069,3228
42507,Laverne,Ahern,lahern6a@sphinn.com,Registered Nurse,1644,1441,3085
42629,Veronike,Wakelam,vwakelam6b@symantec.com,Senior Editor,2523,1435,3958
42794,Cherise,Agutter,cagutter6c@woothemes.com,Nuclear Power Engineer,2877,1405,4282
42840,Gilbertina,Gotch,ggotch6d@huffingtonpost.com,Help Desk Technician,3301,1867,5168
42912,Kristel,Swayton,kswayton6e@pbs.org,Senior Editor,9457,420,9877
42681,Wheeler,Rushbury,wrushbury6h@springer.com,Director of Sales,7982,441,8423
42492,Verney,Soppit,vsoppit6i@comsenz.com,Teacher,2746,1183,3929
42394,Malorie,Orrom,morrom6j@discovery.com,Financial Advisor,3901,434,4335
42564,Gradey,Dunston,gdunston6k@mapy.cz,Geological Engineer,6052,1310,7362
42458,Daloris,Dignan,ddignan6m@amazon.co.jp,VP Sales,9311,768,10079
42833,Elisha,Gillise,egillise6n@thetimes.co.uk,Financial Analyst,6276,311,6587
42631,Daphne,Pepon,dpepon6o@jimdo.com,Staff Scientist,4310,1289,5599
42729,Tomaso,Tomalin,ttomalin6q@dropbox.com,Computer Systems Analyst IV,1573,929,2502
42834,Brooke,Leys,bleys6r@live.com,Marketing Manager,9392,764,10156
42518,Seth,Poat,spoat6s@simplemachines.org,Account Executive,5394,1682,7076
42939,Margarethe,Statter,mstatter6v@ebay.com,Social Worker,9857,1046,10903
42364,Currey,Sapshed,csapshed6w@census.gov,Actuary,1032,1847,2879
42379,Kelsy,Clulee,kclulee6y@usnews.com,Community Outreach Specialist,3463,1756,5219
42428,Kaitlyn,Readhead,kreadhead6z@disqus.com,Help Desk Operator,3243,1400,4643
42580,Talya,Willatt,twillatt70@phpbb.com,Computer Systems Analyst III,3348,1269,4617
42206,Katlin,Winn,kwinn72@unc.edu,Software Consultant,5808,1877,7685
42329,Zsazsa,Dupoy,zdupoy73@europa.eu,Project Manager,6642,1667,8309
42621,Arthur,Brannan,abrannan76@jalbum.net,Payment Adjustment Coordinator,8049,1569,9618
42239,Annmarie,Spofforth,aspofforth77@nytimes.com,Teacher,1418,905,2323
42408,Shelby,McDonogh,smcdonogh79@simplemachines.org,Nurse Practicioner,3073,471,3544
42671,Archibold,Bonney,abonney7a@artisteer.com,Desktop Support Technician,2533,213,2746
42785,Marietta,Evershed,mevershed7c@moonfruit.com,Librarian,8676,1625,10301
42524,Vivien,Sybe,vsybe7e@bing.com,Junior Executive,1670,943,2613
42995,Irvine,Loins,iloins7f@fotki.com,Internal Auditor,3027,1181,4208
42946,Viva,Inglefield,vinglefield7h@cnbc.com,Analog Circuit Design manager,2920,1673,4593
42612,Liesa,Soars,lsoars7j@vimeo.com,Senior Financial Analyst,8311,1414,9725
42446,Matty,Hockey,mhockey7k@foxnews.com,Occupational Therapist,7869,348,8217
42269,Kikelia,Hrishchenko,khrishchenko7l@yale.edu,Editor,8508,322,8830
42596,Aileen,Woolmore,awoolmore7n@drupal.org,Health Coach II,4820,1057,5877
42141,Clyve,Seymour,cseymour7o@mapquest.com,Software Consultant,5774,922,6696
42026,Thoma,Sowerby,tsowerby7q@merriam-webster.com,Professor,7708,646,8354
42622,Lenore,Agar,lagar7r@bbb.org,Graphic Designer,4142,1850,5992
42363,Grayce,McGucken,gmcgucken7s@cornell.edu,Senior Editor,7433,725,8158
42981,Dorisa,Mateus,dmateus7t@google.co.uk,Food Chemist,5212,1129,6341
42521,Karlee,Noweak,knoweak7u@biblegateway.com,Registered Nurse,3835,595,4430
42974,Corenda,Guinnane,cguinnane7v@epa.gov,Community Outreach Specialist,7531,499,8030
42608,Reina,Barrack,rbarrack7w@livejournal.com,Geological Engineer,1430,319,1749
42292,Steffen,Telfer,stelfer7z@forbes.com,Food Chemist,1197,1055,2252
42861,Nicholle,Bilovsky,nbilovsky80@macromedia.com,Systems Administrator III,2420,1553,3973
42869,Sonnie,Stieger,sstieger82@examiner.com,Quality Engineer,7320,1588,8908
42767,Garrett,Sugarman,gsugarman83@last.fm,Editor,3258,849,4107
42383,Drucill,Norcott,dnorcott84@skyrock.com,Associate Professor,9588,1752,11340
42115,Cosetta,Benne,cbenne87@blogspot.com,Electrical Engineer,8303,503,8806
42913,Paolina,Clubley,pclubley88@dailymotion.com,Financial Advisor,6402,1138,7540
42706,Kalila,Piff,kpiff89@tamu.edu,Pharmacist,3669,1767,5436
42253,Cinderella,Tincombe,ctincombe8a@shinystat.com,Financial Analyst,7538,1585,9123
42768,Kendell,Troop,ktroop8b@patch.com,Biostatistician II,2037,1237,3274
42771,Ardith,Karpmann,akarpmann8c@printfriendly.com,Electrical Engineer,9907,1542,11449
42516,Ezra,Shinefield,eshinefield8d@vimeo.com,Environmental Tech,3299,479,3778
42759,Quinta,Pincked,qpincked8e@tamu.edu,Financial Advisor,4219,318,4537
42917,Alaster,Elfleet,aelfleet8f@goodreads.com,Nurse,3217,574,3791
42688,Damien,Delhay,ddelhay8g@springer.com,Business Systems Development Analyst,9269,736,10005
42870,Gabriel,Caverhill,gcaverhill8i@quantcast.com,Senior Cost Accountant,6059,1161,7220
42357,Becca,Exeter,bexeter8l@kickstarter.com,Information Systems Manager,6779,1848,8627
42264,Bud,Brundale,bbrundale8n@dailymail.co.uk,Internal Auditor,7119,973,8092
42306,Artemas,Seakin,aseakin8o@dot.gov,Information Systems Manager,1487,448,1935
42328,Bibbie,Bedenham,bbedenham8t@upenn.edu,Recruiting Manager,2450,1243,3693
42769,Aubree,Lott,alott8w@myspace.com,Programmer III,5434,771,6205
42266,Laverna,Shropsheir,lshropsheir8x@wix.com,Accounting Assistant II,2322,1689,4011
42549,Jocelyn,Gantzman,jgantzman8y@utexas.edu,Accountant IV,8448,355,8803
42451,Eugene,Rosi,erosi8z@tinyurl.com,Accounting Assistant III,6138,1551,7689
42916,Freda,Abelov,fabelov90@paginegialle.it,Automation Specialist I,6904,1660,8564
42106,Kyle,Goodings,kgoodings91@auda.org.au,Nurse,7446,329,7775
42275,Darnell,Halsted,dhalsted92@studiopress.com,VP Sales,7205,406,7611
42579,Amargo,Neath,aneath94@nasa.gov,Mechanical Systems Engineer,3238,233,3471
42999,Annissa,Waud,awaud96@histats.com,Nurse,5021,754,5775
42804,Austine,Whiterod,awhiterod97@jigsy.com,Systems Administrator IV,2407,1015,3422
42512,Feliks,Argile,fargile98@forbes.com,Sales Representative,4093,1267,5360
42843,Denys,Heaney,dheaney99@ucoz.com,Senior Quality Engineer,8591,1454,10045
42723,Devi,Ebhardt,debhardt9a@washington.edu,Database Administrator III,9851,1548,11399
42456,Tory,Salway,tsalway9c@china.com.cn,Accounting Assistant I,5629,368,5997
42960,Christopher,Fishbourne,cfishbourne9d@xing.com,Environmental Specialist,2899,577,3476
42951,Gabriella,Ping,gping9e@photobucket.com,VP Accounting,5238,336,5574
42963,Berke,Bradforth,bbradforth9g@dailymotion.com,Internal Auditor,9876,1564,11440
42525,Emmey,Froome,efroome9h@privacy.gov.au,Nuclear Power Engineer,6895,1972,8867
42897,Constantino,Trewin,ctrewin9j@upenn.edu,Programmer III,5165,1863,7028
42130,Lombard,Whordley,lwhordley9k@scribd.com,Research Nurse,8856,1589,10445
42166,Skipp,Dillintone,sdillintone9n@shinystat.com,Structural Analysis Engineer,8069,1417,9486
42307,Flossy,Daens,fdaens9p@wiley.com,Senior Editor,8825,1493,10318
42590,Theressa,Ellick,tellick9q@ted.com,Sales Associate,2069,1866,3935
42019,Brett,Ceschini,bceschini9s@psu.edu,Office Assistant I,1601,1809,3410
42651,Gaspard,Goulborne,ggoulborne9t@jigsy.com,Administrative Assistant IV,2919,566,3485
42978,Catharina,Broomhead,cbroomhead9u@smh.com.au,Accountant I,2371,1009,3380
42426,Christian,Wheildon,cwheildon9v@fc2.com,Internal Auditor,3765,493,4258
42531,Ahmed,Doby,adoby9x@g.co,Financial Analyst,8264,392,8656
42574,Adolph,Missenden,amissendena1@netvibes.com,Health Coach III,2017,1863,3880
42150,Estel,Petriello,epetrielloa6@vkontakte.ru,Nurse,5827,1259,7086
42475,Janine,Shortland,jshortlanda7@engadget.com,Information Systems Manager,9793,1910,11703
42600,Karlens,Renbold,krenboldab@reuters.com,Financial Analyst,3401,1495,4896
42429,Gordon,Rebeiro,grebeiroad@howstuffworks.com,Quality Control Specialist,6242,576,6818
42488,Abe,Bissex,abissexaf@hostgator.com,Chief Design Engineer,7940,1431,9371
42832,Tomas,Grassett,tgrassettag@amazon.co.jp,Research Assistant IV,2115,1639,3754
42365,Wolfy,Fright,wfrightah@usnews.com,Senior Financial Analyst,4972,1339,6311
42998,Rivkah,Braywood,rbraywoodai@cocolog-nifty.com,Project Manager,2832,1893,4725
42497,Hamlen,Dudgeon,hdudgeonaj@npr.org,Developer III,8282,298,8580
42301,Janifer,McKew,jmckewal@ibm.com,Engineer IV,7810,1540,9350
42104,Deloris,Dikle,ddiklean@dot.gov,Librarian,5035,1738,6773
42514,Fey,Toping,ftopingao@deliciousdays.com,VP Marketing,5656,835,6491
42404,Egon,Mount,emountap@businessinsider.com,Civil Engineer,7981,1334,9315
42880,Corri,Samsworth,csamsworthar@cnn.com,Product Engineer,5032,849,5881
42824,Ches,McGeraghty,cmcgeraghtyas@japanpost.jp,Physical Therapy Assistant,8260,780,9040
42976,Stanwood,Brockett,sbrockettat@purevolume.com,Design Engineer,8944,1189,10133
42801,Jannel,Zanutti,jzanuttiau@pcworld.com,Dental Hygienist,1126,858,1984
42430,Risa,Sudworth,rsudworthaw@cam.ac.uk,Senior Financial Analyst,7464,1589,9053
42714,Hedi,Fosten,hfostenay@xrea.com,Nurse,4650,1622,6272
42165,Gertrud,Pharrow,gpharrowaz@jugem.jp,Database Administrator IV,6697,605,7302
42114,Yalonda,Vondra,yvondrab1@canalblog.com,Geological Engineer,6494,1648,8142
42687,Hi,Domney,hdomneyb2@constantcontact.com,Recruiter,3362,614,3976
42758,Rhianon,Ayto,raytob3@indiatimes.com,Data Coordiator,1418,252,1670
42747,Mab,Bulger,mbulgerb4@tumblr.com,Registered Nurse,8974,1975,10949
42476,Lindon,Sugden,lsugdenb5@constantcontact.com,Marketing Manager,7943,1911,9854
42535,Sherline,Eagell,seagellb7@yelp.com,Assistant Media Planner,1426,449,1875
42145,Pru,Le Grys,plegrysb8@reverbnation.com,Geologist II,8104,1572,9676
42460,Nanete,Huband,nhubandb9@mit.edu,Marketing Manager,8784,1812,10596
42792,Sutherland,Hawkshaw,shawkshawba@si.edu,Associate Professor,1123,1969,3092
42464,Carey,Carwardine,ccarwardinebb@cornell.edu,VP Marketing,8832,1216,10048
42403,Stanislas,Kiloh,skilohbd@ca.gov,Chemical Engineer,4437,851,5288
42468,Bettina,Callis,bcallisbg@unc.edu,Software Engineer III,6945,307,7252
42038,Burt,Lentsch,blentschbi@europa.eu,Account Representative I,9181,914,10095
42180,Eydie,Wildman,ewildmanbj@timesonline.co.uk,Environmental Specialist,2193,1272,3465
42819,Willa,Creasey,wcreaseybk@tinypic.com,Senior Cost Accountant,2902,1995,4897
42599,Mindy,Riguard,mriguardbl@engadget.com,Computer Systems Analyst III,1492,1653,3145
42474,Aubrey,Getsham,agetshambm@fda.gov,Recruiting Manager,8147,746,8893
42915,Iggie,Cridge,icridgebn@yelp.com,VP Marketing,1183,1761,2944
42985,Tobye,Bedham,tbedhambo@opera.com,Dental Hygienist,1346,1436,2782
42836,Eachelle,Scrivner,escrivnerbp@vistaprint.com,Account Coordinator,7618,1184,8802
42894,Sanson,Pickless,spicklessbq@slate.com,Software Consultant,7325,1662,8987
42024,Brigid,Matthius,bmatthiusbr@upenn.edu,Social Worker,4617,1375,5992
42783,Nowell,Mooring,nmooringbs@wunderground.com,Research Nurse,2373,246,2619
42360,Marney,Vanyukov,mvanyukovbv@ucsd.edu,Quality Control Specialist,3429,237,3666
42118,Dick,Flury,dflurybw@imageshack.us,Graphic Designer,2271,1616,3887
42617,Jethro,Benfell,jbenfellbx@tripod.com,Computer Systems Analyst I,6562,1626,8188
42689,Caddric,Woolrich,cwoolrichby@newyorker.com,Speech Pathologist,6599,1724,8323
42234,Mag,Palumbo,mpalumbobz@domainmarket.com,Administrative Assistant I,3017,220,3237
42515,Iosep,Laurentino,ilaurentinoc0@usda.gov,Systems Administrator III,1418,1464,2882
42959,Ted,Scarfe,tscarfec1@walmart.com,Research Assistant I,8294,1716,10010
42248,Dory,Espasa,despasac4@mozilla.org,Executive Secretary,6110,681,6791
42918,Domenico,Brockest,dbrockestc5@wp.com,Structural Engineer,8861,601,9462
42683,Danell,Aujean,daujeanc6@de.vu,Recruiter,1440,755,2195
42486,Violet,Randales,vrandalesc7@usatoday.com,Design Engineer,3165,558,3723
42441,Dorella,Bonnor,dbonnorc8@ca.gov,Pharmacist,5999,1790,7789
42616,David,Black,dblackc9@skyrock.com,Financial Advisor,8654,1404,10058
42191,Georgianna,Damrell,gdamrellca@chronoengine.com,Graphic Designer,8924,1430,10354
42413,Gerry,Nabarro,gnabarrocc@independent.co.uk,Web Designer I,1172,219,1391
42748,Ross,Pobjoy,rpobjoycd@reddit.com,Account Executive,1339,1324,2663
42105,Ardyth,Challin,achallince@java.com,Financial Analyst,1573,618,2191
42131,Annabela,Schroter,aschrotercf@answers.com,Software Consultant,1379,1747,3126
42247,Klemens,McCullough,kmcculloughcg@mayoclinic.com,Staff Scientist,7510,332,7842
42238,Howie,Ing,hingch@bloomberg.com,Assistant Manager,3282,1215,4497
42340,Haven,Rebbeck,hrebbeckci@homestead.com,Chief Design Engineer,6656,1399,8055
42435,Kaylyn,Giovannacc@i,kgiovannaccicm@ted.com,Research Assistant I,5972,322,6294
42862,Tedmund,Mulloch,tmullochcn@purevolume.com,Database Administrator I,8503,1871,10374
42146,Ichabod,McDougald,imcdougaldco@hc360.com,Senior Financial Analyst,6824,1715,8539
42544,Orren,Cullinan,ocullinancq@yahoo.com,Software Consultant,6854,1141,7995
42039,Helli,Londing,hlondingcr@pagesperso-orange.fr,Community Outreach Specialist,4520,1516,6036
42317,Neel,Heathcott,nheathcottcs@sitemeter.com,VP Marketing,7973,1928,9901
42126,Brinna,Kent,bkentct@wikimedia.org,Graphic Designer,1154,1311,2465
42200,Artemis,Van Der Walt,avanderwaltcv@sohu.com,VP Accounting,8813,1708,10521
42776,Kevon,Challoner,kchallonercy@netscape.com,Financial Analyst,9027,566,9593
42183,Sully,Gair,sgaird0@drupal.org,Paralegal,4314,1968,6282
42120,Rickert,Gabbot,rgabbotd1@flavors.me,Electrical Engineer,3753,1047,4800
42807,Kermy,Casetta,kcasettad2@rambler.ru,Dental Hygienist,2720,217,2937
42123,Lionello,Guyot,lguyotd4@upenn.edu,Technical Writer,1107,1803,2910
42082,Elysee,Messent,emessentd5@bloomberg.com,Engineer III,7345,1184,8529
42738,Phil,Goodsal,pgoodsald7@google.com.br,Account Coordinator,8863,1833,10696
42324,Alidia,Ortzen,aortzend8@biblegateway.com,Associate Professor,8585,905,9490
42422,Lukas,Delucia,ldeluciada@epa.gov,Administrative Assistant IV,7156,760,7916
42718,Hartwell,Tierney,htierneydc@hubpages.com,Paralegal,8499,211,8710
42739,Courtnay,Clint,cclintdd@devhub.com,Account Representative I,1818,404,2222
42072,Florida,Bettington,fbettingtonde@cnet.com,Social Worker,4652,311,4963
42889,Marius,Burgiss,mburgissdf@reference.com,Quality Control Specialist,2402,1093,3495
42438,Odelle,Scholey,oscholeydj@paginegialle.it,Human Resources Manager,8730,1029,9759
42387,Richie,Darville,rdarvilledk@artisteer.com,Human Resources Manager,2103,1775,3878
42584,Gretchen,Charrier,gcharrierdl@goodreads.com,Senior Quality Engineer,9375,1349,10724
42169,Thayne,Spohr,tspohrdq@tamu.edu,Health Coach III,6432,1963,8395
42491,Rebeka,Yakuntzov,ryakuntzovdr@addthis.com,Automation Specialist IV,2825,1980,4805
42652,Moira,Early,mearlydt@answers.com,General Manager,3776,767,4543
42842,Guthry,Dornin,gdornindu@soup.io,Software Consultant,2067,1889,3956
42905,Chickie,Burke,cburkee0@freewebs.com,Financial Analyst,1630,547,2177
42176,Jobye,Spalls,jspallse1@sina.com.cn,Web Designer IV,4010,1245,5255
42222,Catie,Du Hamel,cduhamele2@csmonitor.com,Assistant Media Planner,2784,658,3442
42323,Marys,Kimbling,mkimblinge3@meetup.com,Occupational Therapist,8163,1485,9648
42703,Sloan,D'Costa,sdcostae4@mashable.com,Health Coach III,4762,788,5550
42490,Nollie,Lernihan,nlernihane6@liveinternet.ru,Cost Accountant,3380,1103,4483
42134,Reinhard,Goldstraw,rgoldstrawe8@hexun.com,Account Representative IV,9205,927,10132
42224,Georgeanne,Dabes,gdabese9@sakura.ne.jp,Office Assistant I,8302,720,9022
42570,Jock,Haborn,jhabornea@example.com,Junior Executive,2186,1404,3590
42566,Yardley,Hutchens,yhutchenseb@mail.ru,Human Resources Assistant IV,3270,337,3607
42348,Damian,McGing,dmcgingec@theglobeandmail.com,Editor,9516,1312,10828
42420,Joletta,Rotherham,jrotherhamed@google.fr,Safety Technician II,2065,346,2411
42135,Jarrid,Olcot,jolcotee@google.es,Staff Scientist,4055,1364,5419
42934,Shalna,Todhunter,stodhunteref@smh.com.au,VP Product Management,1517,1456,2973
42293,Birk,Gerrill,bgerrilleg@cornell.edu,Actuary,6719,490,7209
42962,Skylar,Mabley,smableyeh@tmall.com,Marketing Manager,1705,1625,3330
42872,Katinka,Tafani,ktafaniei@ameblo.jp,Accountant I,7533,352,7885
42225,Shaylynn,Cherrie,scherrieej@goodreads.com,Physical Therapy Assistant,4497,1671,6168
42425,Gun,Huntingford,ghuntingfordel@weebly.com,Computer Systems Analyst III,4387,1612,5999
42345,Virginie,Fermin,vferminem@google.pl,VP Sales,7479,1868,9347
42414,Edwina,Kleinplac,ekleinplaceo@fc2.com,Help Desk Operator,4973,404,5377
42773,Elly,Adamik,eadamikep@mac.com,Junior Executive,2977,1074,4051
42501,Dario,Sponder,dspondereq@php.net,Teacher,9564,1575,11139
42562,Bobbye,Dudden,bduddenes@netscape.com,VP Sales,1664,1110,2774
42503,Claudius,Vassie,cvassieeu@cnbc.com,Quality Engineer,1331,1169,2500
42400,Jarrett,Minty,jmintyev@rakuten.co.jp,Statistician I,6426,1216,7642
42786,Ruy,Kenn,rkennew@msu.edu,Assistant Professor,6891,1634,8525
42409,Dick,McDade,dmcdadeez@e-recht24.de,Nuclear Power Engineer,7685,1346,9031
42537,Flore,Coggon,fcoggonf1@printfriendly.com,Electrical Engineer,5605,321,5926
42163,Teriann,Humpatch,thumpatchf2@webnode.com,Financial Analyst,3345,1875,5220
42784,Padriac,Rehor,prehorf3@ted.com,Systems Administrator I,2570,652,3222
42386,Gale,Stirgess,gstirgessf4@webs.com,Professor,4464,341,4805
42108,Shelden,Speerman,sspeermanf5@tamu.edu,Recruiter,6335,1478,7813
42860,Olenolin,Berrigan,oberriganf6@example.com,Geologist IV,7055,402,7457
42419,Joshia,Cano,jcanofa@shinystat.com,Assistant Professor,2493,1098,3591
42445,Cymbre,Tomek,ctomekfd@army.mil,Technical Writer,4250,217,4467
42256,Corenda,Frankis,cfrankisff@github.io,Analog Circuit Design manager,6007,368,6375
42990,Melantha,Braunston,mbraunstonfg@blogtalkradio.com,Information Systems Manager,9374,1056,10430
42942,Ardelis,Scrowby,ascrowbyfh@google.co.jp,VP Sales,2251,226,2477
42161,Sibyl,Kohrding,skohrdingfk@squarespace.com,Software Engineer IV,9778,1963,11741
42320,Seward,Colvie,scolviefn@t-online.de,Operator,5191,1468,6659
42885,Vin,Buscombe,vbuscombefp@hc360.com,Technical Writer,3466,1591,5057
42722,Etan,Worner,ewornerfq@dailymotion.com,Human Resources Manager,7385,393,7778
42172,Lodovico,Hars,lharsfs@wunderground.com,Systems Administrator III,3841,1562,5403
42879,Ronda,Renzini,rrenzinifu@creativecommons.org,General Manager,6425,1520,7945
42241,Reider,Limbourne,rlimbournefv@liveinternet.ru,Recruiter,2736,1412,4148
42402,Rheba,Ewbach,rewbachfx@deviantart.com,Recruiter,7038,1299,8337
42646,Mallory,Planks,mplanksfy@chicagotribune.com,Quality Control Specialist,9005,765,9770
42338,Clevey,Quainton,cquaintonfz@ebay.co.uk,Chief Design Engineer,4433,710,5143
42630,Fedora,Lademann,flademanng0@ovh.net,Internal Auditor,8571,1463,10034
42569,Steffie,McEachern,smceacherng2@oakley.com,Environmental Specialist,4482,443,4925
42001,Merla,Leveret,mleveretg3@people.com.cn,Mechanical Systems Engineer,4636,1525,6161
42623,Yevette,Woolforde,ywoolfordeg5@howstuffworks.com,Biostatistician IV,7838,712,8550
42588,Craig,Ferrieres,cferrieresg6@wp.com,Geological Engineer,7063,1824,8887
42052,Mellie,Ervin,merving7@state.gov,Software Engineer IV,5370,312,5682
42261,Tyrus,Pilpovic,tpilpovicg8@utexas.edu,Community Outreach Specialist,4353,1827,6180
42644,Solomon,Douglass,sdouglassg9@go.com,Librarian,9103,877,9980
42173,Niles,Wiffen,nwiffenga@over-blog.com,Nurse,9680,217,9897
42602,Pippy,Melanaphy,pmelanaphygb@mysql.com,Speech Pathologist,4839,1974,6813
42762,Ulric,Badsey,ubadseygc@technorati.com,Account Executive,4889,481,5370
42845,Tiffi,Kemmer,tkemmergf@instagram.com,Marketing Assistant,6666,1270,7936
42281,Marcus,Scudders,mscuddersgg@altervista.org,Research Associate,5332,529,5861
42495,Odette,Le Blanc,oleblancgh@springer.com,Senior Quality Engineer,1531,1624,3155
42702,Man,Grote,mgrotegi@dmoz.org,Environmental Specialist,5261,971,6232
42228,Modesta,Raleston,mralestongj@si.edu,Programmer I,9857,228,10085
42728,Nerti,Took,ntookgn@mozilla.org,Analyst Programmer,4526,543,5069
42099,Anne-corinne,Dorton,adortongp@discuz.net,Assistant Media Planner,1118,824,1942
42151,Jefferson,Pendleberry,jpendleberrygq@w3.org,Nurse,1790,434,2224
42585,Ham,Giacoppoli,hgiacoppoligr@redcross.org,Internal Auditor,3350,1025,4375
42526,Mab,Caulwell,mcaulwellgt@homestead.com,Librarian,9464,1904,11368
42700,Jean,Leathwood,jleathwoodgv@xing.com,Account Executive,4540,290,4830
42740,Cinda,Trethewey,ctretheweygx@t-online.de,Staff Accountant I,2057,1703,3760
42920,Burty,Lewknor,blewknorgy@engadget.com,Graphic Designer,5970,591,6561
42592,Olly,MacTrustrie,omactrustriegz@reuters.com,Nurse Practicioner,9857,410,10267
42412,Ranique,de Clercq,rdeclercqh0@ezinearticles.com,Junior Executive,4285,1633,5918
42935,Temple,Swannell,tswannellh1@pen.io,Dental Hygienist,7793,282,8075
42756,Tuck,Chsteney,tchsteneyh4@marketwatch.com,Financial Advisor,3655,1998,5653
42799,Rhonda,MacQueen,rmacqueenh5@tripadvisor.com,Geological Engineer,8966,1411,10377
42534,Jania,Beevens,jbeevensh7@indiegogo.com,Occupational Therapist,7895,1585,9480
42461,Nichol,Helks,nhelksh9@wunderground.com,Administrative Officer,4769,1800,6569
42561,Livvy,Burnapp,lburnapphb@umn.edu,Sales Associate,1001,624,1625
42271,Myrah,Divine,mdivinehe@mysql.com,Research Nurse,4148,1616,5764
42453,Kakalina,Olrenshaw,kolrenshawhg@boston.com,Chief Design Engineer,9428,862,10290
42672,Tannie,Coo,tcoohh@google.pl,Human Resources Manager,4429,1905,6334
42201,Toby,Wiffill,twiffillhi@weather.com,VP Marketing,7061,687,7748
42333,Saw,Gerssam,sgerssamhj@reddit.com,Biostatistician II,1549,1927,3476
42797,Curry,Chason,cchasonhk@sfgate.com,Senior Cost Accountant,7272,1740,9012
42577,Trish,Kilfeather,tkilfeatherhl@mtv.com,Speech Pathologist,5122,1323,6445
42968,Imogen,Hunter,ihunterho@noaa.gov,Tax Accountant,7601,1655,9256
42175,Julieta,MacClenan,jmacclenanht@mediafire.com,Financial Analyst,3343,652,3995
42987,Devan,Stenner,dstennerhv@themeforest.net,Research Associate,2977,556,3533
42610,Korella,Petru,kpetruhw@mail.ru,Administrative Officer,3251,501,3752
42017,Araldo,Prewer,aprewerhx@rambler.ru,Operator,4220,1165,5385
42286,Skyler,Kitchen,skitchenhy@printfriendly.com,Quality Engineer,2605,1153,3758
42337,Wilone,Murrhardt,wmurrhardthz@issuu.com,Speech Pathologist,2058,1075,3133
42334,Welsh,Comolli,wcomollii0@hatena.ne.jp,Operator,8407,1160,9567
42417,Jeana,Newson,jnewsoni3@forbes.com,Senior Quality Engineer,7243,1837,9080
42886,Rosemary,Rappa,rrappai8@opera.com,Paralegal,5015,265,5280
42198,Perkin,Widdison,pwiddisonib@lulu.com,Executive Secretary,9491,616,10107
42796,Michail,Neicho,mneichoie@miibeian.gov.cn,Social Worker,6885,1728,8613
42927,Gordon,Worsley,gworsleyif@php.net,Design Engineer,8727,1286,10013
42798,Frank,O'Fihily,fofihilyig@hatena.ne.jp,Senior Developer,1085,301,1386
42373,Jeannine,Samuels,jsamuelsii@purevolume.com,Human Resources Manager,6330,1227,7557
42218,Jenda,Reinbeck,jreinbeckij@eventbrite.com,Engineer IV,1721,1267,2988
42520,Chrystal,Bredgeland,cbredgelandik@cbc.ca,Sales Associate,2455,285,2740
42903,Lula,Lates,llatesin@walmart.com,Food Chemist,8359,695,9054
42504,Steffie,Uttermare,suttermareip@ucoz.ru,Sales Associate,6256,1832,8088
42665,Zachery,Napoli,znapoliiw@moonfruit.com,Paralegal,7695,713,8408
42398,Leta,Overbury,loverburyix@amazon.de,Environmental Tech,2126,651,2777
42717,Sherwin,Vellender,svellenderiy@toplist.cz,Software Engineer III,8062,1482,9544
42685,Marthe,Syplus,msyplusj0@t.co,Financial Analyst,9553,1730,11283
42139,Merl,Cronkshaw,mcronkshawj1@symantec.com,Financial Analyst,4641,1631,6272
42715,Beverly,Badrick,bbadrickj2@weather.com,Developer I,8145,1226,9371
42874,Doralynn,Edger,dedgerj3@reddit.com,Operator,7820,1980,9800
42096,Darsey,Mungan,dmunganj4@surveymonkey.com,Senior Cost Accountant,8400,1136,9536
42867,Constantina,Newark,cnewarkj6@amazon.co.uk,Director of Sales,9578,1206,10784
42479,Elysee,Brown,ebrownj8@list-manage.com,Web Designer III,2680,1823,4503
42757,Kriste,Bodesson,kbodessonj9@slideshare.net,Internal Auditor,8154,431,8585
42385,Torin,Pledge,tpledgeja@ucla.edu,Assistant Media Planner,7420,631,8051
42649,Verna,Cowen,vcowenjb@networksolutions.com,Web Designer IV,6414,215,6629
42411,Sumner,Badgers,sbadgersje@w3.org,Financial Analyst,8723,1045,9768
42940,Marchelle,Ray,mrayjg@unesco.org,Librarian,7748,1903,9651
42233,Dyan,Reeder,dreederji@ow.ly,Quality Engineer,4870,404,5274
42050,Yanaton,Barnshaw,ybarnshawjj@stanford.edu,Administrative Assistant II,5912,229,6141
42660,Randal,Wimsett,rwimsettjk@uol.com.br,Desktop Support Technician,1820,408,2228
42873,Jeanna,Nestoruk,jnestorukjl@barnesandnoble.com,Automation Specialist I,9567,1598,11165
42909,Carri,Houchin,chouchinjo@wikipedia.org,Editor,3473,455,3928
42035,Sidonia,Bindley,sbindleyjq@opera.com,Marketing Manager,4468,1819,6287
42593,Jasmina,Gayforth,jgayforthjs@salon.com,Web Developer I,9716,1791,11507
42278,Loralie,Linscott,llinscottju@bbb.org,Professor,7435,1831,9266
42986,Helenka,Gilman,hgilmanjv@spiegel.de,Mechanical Systems Engineer,9644,1729,11373
42109,Lesly,Preece,lpreecejw@opensource.org,Biostatistician IV,9728,1101,10829
42502,Phebe,Salery,psaleryjz@tripadvisor.com,Director of Sales,9824,1217,11041
42382,Lexy,Beddie,lbeddiek2@i2i.jp,Safety Technician III,4355,1991,6346
42552,Simonette,Driffill,sdriffillk5@archive.org,Developer III,5556,499,6055
42805,Ringo,McFie,rmcfiek7@symantec.com,Accountant IV,1048,337,1385
42727,Cy,Innocenti,cinnocentik8@macromedia.com,Geologist III,6975,688,7663
42138,Indira,Rubinfeld,irubinfeldka@bloglines.com,Chief Design Engineer,1835,661,2496
42958,Betty,Carabet,bcarabetkg@eepurl.com,Senior Developer,4292,361,4653
42107,Orion,O'Dowling,oodowlingki@prweb.com,Financial Advisor,4086,723,4809
42637,Gerta,Ledwith,gledwithkl@eventbrite.com,Software Consultant,7134,1134,8268
42853,Waylon,Broadey,wbroadeykm@blinklist.com,Electrical Engineer,2217,1416,3633
42356,Humbert,Creeghan,hcreeghanko@nbcnews.com,Computer Systems Analyst II,8254,342,8596
42625,Lanette,Hulkes,lhulkeskp@nymag.com,Junior Executive,5825,1089,6914
42347,Pandora,Keme,pkemekr@columbia.edu,Quality Control Specialist,5399,763,6162
42344,Zoe,Christer,zchristerks@blinklist.com,Nurse,6241,1445,7686
42779,Art,Falkinder,afalkinderkv@flickr.com,Account Executive,2653,1460,4113
42111,Annecorinne,Barnsley,abarnsleykw@nytimes.com,Financial Analyst,4780,1819,6599
42045,Ailee,Addenbrooke,aaddenbrookekx@amazon.com,Legal Assistant,4436,972,5408
42074,Morgen,McCurtain,mmccurtainkz@xrea.com,Pharmacist,8322,456,8778
42048,Candice,Lacheze,clachezel0@dyndns.org,Associate Professor,1711,579,2290
42830,Valli,Braidwood,vbraidwoodl1@yahoo.com,Biostatistician IV,5605,226,5831
42283,Gabey,Espinazo,gespinazol2@accuweather.com,Administrative Officer,3692,299,3991
42658,Cassandra,Fearfull,cfearfulll5@nsw.gov.au,Clinical Specialist,1846,243,2089
42005,Nicol,Gellan,ngellanl6@phoca.cz,Help Desk Technician,8562,321,8883
42352,Gard,McCarry,gmccarryl9@digg.com,Chemical Engineer,1189,1154,2343
42203,Salome,Slark,sslarkld@newyorker.com,Paralegal,6277,1356,7633
42775,Padraig,Sked,pskedle@ft.com,General Manager,4810,1511,6321
42011,Morissa,Vuitton,mvuittonlf@deviantart.com,Health Coach III,7629,226,7855
42787,Lucina,Ridsdell,lridsdelllh@sourceforge.net,Internal Auditor,8728,227,8955
42260,Kaylil,Qualtro,kqualtrolj@opera.com,Paralegal,4655,1880,6535
42140,Kaela,Khan,kkhanlm@craigslist.org,Clinical Specialist,7389,1290,8679
42249,Korney,Muncie,kmuncielq@cpanel.net,Cost Accountant,7400,870,8270
42251,Pansie,Benedicto,pbenedictolr@gnu.org,Office Assistant I,6201,736,6937
42957,Rosalia,Bedford,rbedfordlu@chronoengine.com,Account Coordinator,8377,1590,9967
42424,Massimiliano,Leidecker,mleideckerlv@accuweather.com,Senior Sales Associate,7942,1035,8977
42083,Giacopo,Nolleth,gnollethlz@wikia.com,Staff Accountant IV,4445,1326,5771
42790,Dianne,Skoggins,dskogginsm0@tripod.com,Administrative Officer,8617,572,9189
42078,Tris,Mattosoff,tmattosoffm2@acquirethisname.com,Chief Design Engineer,8506,1553,10059
42181,Alberto,Broddle,abroddlem5@issuu.com,Quality Engineer,6616,297,6913
42188,Isidro,Bauckham,ibauckhamm6@prnewswire.com,Desktop Support Technician,4052,1731,5783
42919,Rosette,Perdue,rperduem7@techcrunch.com,Professor,1714,1709,3423
42731,Pauli,Banyard,pbanyardm9@cocolog-nifty.com,Account Representative III,1722,1777,3499
42892,Cecil,Broscombe,cbroscombemb@linkedin.com,Chemical Engineer,5184,226,5410
42653,Inglis,Helsby,ihelsbymc@state.tx.us,Junior Executive,8908,391,9299
42906,Leilah,Duxbarry,lduxbarrymd@lulu.com,Legal Assistant,6212,1271,7483
42509,Tadeo,Crookshanks,tcrookshanksmf@uol.com.br,Assistant Media Planner,1192,201,1393
42117,Kennedy,Corker,kcorkermg@google.ca,Staff Scientist,6614,651,7265
42523,Tine,Langfat,tlangfatmh@latimes.com,Occupational Therapist,4764,1641,6405
42575,Jo,Staten,jstatenmi@goo.gl,Information Systems Manager,2126,879,3005
42697,Jacinda,Trevethan,jtrevethanmj@chicagotribune.com,Software Test Engineer II,5256,792,6048
42314,Neale,Dallman,ndallmanmk@ted.com,Nuclear Power Engineer,7812,646,8458
42211,Silas,Sentance,ssentanceml@nymag.com,Assistant Manager,1407,1312,2719
42064,May,Ramstead,mramsteadmm@businessinsider.com,Senior Sales Associate,4124,740,4864
42604,Stanford,Floch,sflochmr@huffingtonpost.com,Actuary,5765,1404,7169
42102,Eli,Wones,ewonesms@squarespace.com,Media Manager II,9234,1016,10250
42431,Ardisj,Byng,abyngmu@t.co,Budget/Accounting Analyst II,1314,201,1515
42854,Madel,Kobierski,mkobierskimv@studiopress.com,Speech Pathologist,8777,777,9554
42926,Beltran,Gronou,bgronoumx@virginia.edu,Editor,1888,1332,3220
42499,Petronella,Frisdick,pfrisdickmz@nbcnews.com,Environmental Specialist,4994,879,5873
42591,Lowrance,Mongan,lmongann0@oaic.gov.au,Executive Secretary,6010,844,6854
42931,Jerry,Mieville,jmievillen1@hp.com,Assistant Manager,6402,1292,7694
42707,Debee,Maudlin,dmaudlinn2@sun.com,Systems Administrator III,5213,1047,6260
42896,Noah,Wilding,nwildingn5@answers.com,Quality Engineer,2300,317,2617
42122,Evin,Itzkovsky,eitzkovskyn9@nationalgeographic.com,Tax Accountant,6010,530,6540
42720,Tonye,Halworth,thalworthna@blog.com,Software Consultant,1581,1297,2878
42371,Hildagarde,Spyer,hspyernc@privacy.gov.au,Senior Developer,2634,1044,3678
42782,Avie,Pawden,apawdennf@cbsnews.com,Social Worker,2868,694,3562
42056,Kellen,Osgood,kosgoodnn@bigcartel.com,Geological Engineer,2799,1874,4673
43000,Hazlett,Wingfield,hwingfieldno@plala.or.jp,Quality Control Specialist,8317,1290,9607
42478,Merv,Munkley,mmunkleynt@cornell.edu,VP Product Management,2734,1759,4493
42541,Keenan,MacAless,kmacalessnu@un.org,Chief Design Engineer,7108,602,7710
42351,Persis,Easbie,peasbieo2@mozilla.com,Project Manager,7354,1618,8972
42746,Gussy,Gilardengo,ggilardengoo3@sogou.com,Food Chemist,6245,1444,7689
42308,Krysta,Bercevelo,kberceveloo7@illinois.edu,Technical Writer,8443,1915,10358
42136,Donnie,Teffrey,dteffreyo8@facebook.com,Food Chemist,7129,1011,8140
42232,Lenci,O'Shavlan,loshavlanog@tamu.edu,Human Resources Assistant III,1780,1681,3461
42888,Rudolph,Jervis,rjervisoh@ed.gov,Account Representative I,4165,1591,5756
42189,Agatha,Milsom,amilsomoi@bluehost.com,Associate Professor,6205,1552,7757
42696,Coletta,Langmuir,clangmuirom@rakuten.co.jp,Staff Scientist,8189,344,8533
42368,Mandy,Mallall,mmallalloq@webnode.com,Web Designer IV,6819,1709,8528
42007,Gabie,Haugen,ghaugenor@alexa.com,Analog Circuit Design manager,2531,1552,4083
42367,Kassandra,Rawlins,krawlinsou@cmu.edu,Marketing Assistant,5940,1122,7062
42536,Coleen,Hollyar,chollyarp1@google.cn,Nurse Practicioner,4437,1342,5779
42743,Serena,Readett,sreadettp6@sbwire.com,Marketing Manager,1400,1559,2959
42852,Cyndie,Grzegorzewski,cgrzegorzewskip8@amazon.co.jp,Analyst Programmer,8319,277,8596
42831,Fields,Beavon,fbeavonp9@economist.com,Internal Auditor,6432,1244,7676
42763,Selina,Legister,slegisterpb@newsvine.com,Nurse Practicioner,3097,685,3782
42267,Siouxie,Rennels,srennelspf@wikia.com,Human Resources Manager,8249,1441,9690
42199,Ardith,Matiashvili,amatiashviliph@mozilla.com,Physical Therapy Assistant,6022,1848,7870
42701,Valentijn,O'Donnelly,vodonnellypi@creativecommons.org,Senior Financial Analyst,4518,1831,6349
42663,Ruy,Sawer,rsawerpj@tumblr.com,Assistant Manager,3834,1975,5809
42855,Ignace,Woolaston,iwoolastonpq@cmu.edu,Tax Accountant,1486,1925,3411
42156,Jyoti,Vines,jvinesps@nydailynews.com,Graphic Designer,7163,335,7498
42066,Libbi,Symmons,lsymmonspv@eepurl.com,Financial Analyst,9863,656,10519
42821,Allister,Twinterman,atwintermanpx@discovery.com,Geologist III,8777,595,9372
42713,Tristam,Fallowes,tfallowespz@yolasite.com,Quality Control Specialist,2765,1197,3962
42318,Loretta,Kays,lkaysq6@pinterest.com,Environmental Specialist,7938,1277,9215
42550,Kevin,Fulle,kfulleqa@infoseek.co.jp,VP Quality Control,9880,1884,11764
42182,Glynis,Beldan,gbeldanqe@msu.edu,Financial Analyst,6548,910,7458
42829,Cornela,Aynsley,caynsleyqj@istockphoto.com,Legal Assistant,8910,1952,10862
42037,Huberto,Lasselle,hlasselleql@usgs.gov,Programmer II,8471,1747,10218
42904,Garrik,Conti,gcontiqm@exblog.jp,Speech Pathologist,9497,922,10419
42730,Albina,Couch,acouchqn@1688.com,Research Associate,4384,787,5171
42553,Lennie,Pinnegar,lpinnegarqo@examiner.com,Associate Professor,5546,1903,7449
42076,Pierre,Scudamore,pscudamoreqq@constantcontact.com,Business Systems Development Analyst,8795,765,9560
42485,Dulci,Blowing,dblowingqs@google.com.hk,Actuary,4468,1412,5880
42473,Dotty,Torbeck,dtorbeckqv@gmpg.org,Software Consultant,2905,949,3854
42452,Susi,Oganian,soganianqx@google.com,Environmental Tech,6758,364,7122
42753,Mylo,Sentance,msentancer6@desdev.cn,Database Administrator III,6750,1699,8449
42350,Corly,Gieves,cgievesr9@ox.ac.uk,Design Engineer,4289,1984,6273
42036,Jolene,Batrick,jbatrickra@usnews.com,Recruiter,2843,1757,4600
42077,Deloria,Dorro,ddorrorb@examiner.com,Biostatistician IV,1052,1941,2993
42493,Sargent,Tapsell,stapsellre@wix.com,Budget/Accounting Analyst I,4902,927,5829
42274,Gail,Dowrey,gdowreyrh@so-net.ne.jp,Web Designer II,2704,1484,4188
42216,Krishna,Ficken,kfickenrp@ocn.ne.jp,Programmer I,6723,1386,8109
43187,Esme,Bottomer,ebottomer0@51.la,Programmer Analyst II,7370,505,7875
43665,Tammie,Cisec,tcisec1@examiner.com,Occupational Therapist,5065,1329,6394
43190,Dunstan,McQuarrie,dmcquarrie2@narod.ru,Programmer Analyst III,9463,1580,11043
43555,Ann-marie,Jentin,ajentin3@etsy.com,Analog Circuit Design manager,7378,376,7754
43118,Brett,Giraudat,bgiraudat4@epa.gov,Developer I,5344,265,5609
43166,Nikolaos,McKeating,nmckeating5@ezinearticles.com,Teacher,9771,778,10549
43593,Rudolph,Carnegy,rcarnegy6@wunderground.com,Statistician IV,7100,428,7528
43317,Deeyn,Bratchell,dbratchell7@cbslocal.com,Software Test Engineer III,7616,1035,8651
43422,Shay,Skylett,sskylett8@youku.com,Project Manager,2596,1864,4460
43170,Dredi,Mathissen,dmathissen9@wikispaces.com,Software Engineer IV,5006,1699,6705
43480,Valentine,Swatheridge,vswatheridgea@youtube.com,Chemical Engineer,5781,485,6266
43257,Benny,Braam,bbraamb@google.com.au,Design Engineer,5999,1066,7065
43195,Mariejeanne,Smithson,msmithsonc@networksolutions.com,Quality Control Specialist,2012,689,2701
43217,Gualterio,Slyvester,gslyvesterd@opensource.org,Electrical Engineer,2529,379,2908
43492,Falkner,Orme,formee@diigo.com,Web Designer IV,7073,1846,8919
43188,Brandy,Rubens,brubensf@privacy.gov.au,Engineer I,1111,535,1646
43455,Iver,Sodeau,isodeaug@discuz.net,Structural Engineer,2586,837,3423
43498,Tommy,Challicum,tchallicumh@umich.edu,Accountant IV,2294,756,3050
43156,Angela,Allsup,aallsupi@example.com,Speech Pathologist,5112,719,5831
43697,Randolph,Walles,rwallesk@chicagotribune.com,Teacher,3417,1126,4543
43006,Jandy,Cundey,jcundeyl@cisco.com,Geologist IV,9728,1213,10941
43371,Kalie,Wallicker,kwallickerm@pen.io,Junior Executive,4280,806,5086
43292,Dory,Corradino,dcorradinon@wufoo.com,Database Administrator I,6389,1410,7799
43250,Gaultiero,Spaice,gspaiceo@friendfeed.com,Administrative Officer,6016,1559,7575
43523,Maureene,Spores,msporesp@weebly.com,Speech Pathologist,4297,1249,5546
43873,Powell,Allonby,pallonbyq@zdnet.com,Media Manager IV,7806,471,8277
43623,Clarke,Lampaert,clampaertr@friendfeed.com,VP Product Management,4268,334,4602
43043,Debby,Amor,damors@umich.edu,Administrative Officer,7549,549,8098
43901,Conn,Hague,chaguet@time.com,Sales Representative,3680,1348,5028
43727,Moselle,Ogbourne,mogbourneu@imgur.com,Actuary,3219,1940,5159
43528,Hedvig,Cogger,hcoggerv@google.de,Financial Analyst,7184,753,7937
43310,Amii,Duguid,aduguidw@artisteer.com,Actuary,2878,942,3820
43755,Bale,Buchett,bbuchettx@redcross.org,Senior Editor,5650,1621,7271
43157,Dimitri,Gosnoll,dgosnolly@opera.com,Account Coordinator,4166,1821,5987
43515,Gates,Bossel,gbosselz@thetimes.co.uk,Physical Therapy Assistant,4875,725,5600
43936,Violante,Permain,vpermain10@cmu.edu,Senior Sales Associate,9606,1859,11465
43981,Gael,Gerhardt,ggerhardt11@smh.com.au,Data Coordiator,8878,1304,10182
43959,Kalindi,Cartmail,kcartmail12@fotki.com,Database Administrator II,6809,1075,7884
43945,Mattias,Huffey,mhuffey13@si.edu,Professor,2401,743,3144
43759,Chloette,Roskruge,croskruge14@mit.edu,Geologist I,1639,1028,2667
43340,Bengt,Clague,bclague15@dailymotion.com,Community Outreach Specialist,2942,812,3754
43248,Wallis,Rohmer,wrohmer16@1und1.de,Web Developer IV,5941,1941,7882
43527,Rufus,Escolme,rescolme17@macromedia.com,Budget/Accounting Analyst II,3747,1473,5220
43345,Haze,McLellan,hmclellan18@theguardian.com,Business Systems Development Analyst,6645,1924,8569
43470,Stacy,Ranfield,sranfield19@stanford.edu,Speech Pathologist,7826,1798,9624
43289,Terrance,Giacopini,tgiacopini1a@paypal.com,Research Nurse,8541,1349,9890
43179,Eugene,Jevon,ejevon1b@dagondesign.com,Developer I,9274,781,10055
43099,Josephine,Prichet,jprichet1c@illinois.edu,Nurse,4231,452,4683
43032,Priscilla,Golborne,pgolborne1d@lycos.com,Librarian,6323,1314,7637
43474,Cyril,Varah,cvarah1e@etsy.com,Environmental Specialist,2424,876,3300
43076,Lorry,McGairl,lmcgairl1f@themeforest.net,Food Chemist,9120,808,9928
43007,Erin,Dinsell,edinsell1g@multiply.com,Research Associate,2066,1147,3213
43548,Flss,Avramovitz,favramovitz1h@xing.com,VP Product Management,9471,652,10123
43673,Leonelle,Firmin,lfirmin1i@networkadvertising.org,Junior Executive,1618,748,2366
43070,Dorella,Gorvette,dgorvette1j@plala.or.jp,Desktop Support Technician,3237,1950,5187
43998,Lu,Pearcy,lpearcy1k@redcross.org,Automation Specialist I,3262,1074,4336
43930,Clea,Birdsall,cbirdsall1l@gizmodo.com,Project Manager,8351,223,8574
43678,Dru,Deverick,ddeverick1m@scientificamerican.com,Project Manager,2972,344,3316
43337,Rockie,McWard,rmcward1o@sbwire.com,Social Worker,6904,1896,8800
43386,Quill,Gorghetto,qgorghetto1p@google.ca,Sales Associate,7832,1286,9118
43191,Waring,Fowden,wfowden1q@hexun.com,Help Desk Operator,3380,671,4051
43514,Hansiain,McDougald,hmcdougald1r@kickstarter.com,Software Consultant,8196,715,8911
43856,Imogene,Pashba,ipashba1s@tinyurl.com,Budget/Accounting Analyst I,6469,1405,7874
43761,Rozele,Burston,rburston1t@mozilla.com,Quality Control Specialist,6318,837,7155
43295,Kirsten,Tockell,ktockell1u@list-manage.com,Administrative Officer,5474,1693,7167
43915,Read,Leare,rleare1v@imageshack.us,Business Systems Development Analyst,8197,1671,9868
43650,Halsey,Mandell,hmandell1w@weibo.com,Social Worker,5800,1129,6929
43631,Giacomo,Grutchfield,ggrutchfield1x@de.vu,Staff Accountant IV,2509,1554,4063
43824,Kellyann,Rait,krait1y@usgs.gov,Geologist II,6826,1816,8642
43411,Dennie,Batalini,dbatalini1z@springer.com,VP Product Management,1562,391,1953
43314,Marcelline,Demkowicz,mdemkowicz20@etsy.com,VP Quality Control,5726,1450,7176
43653,Engracia,Stuffins,estuffins21@nhs.uk,Civil Engineer,9314,774,10088
43311,Delainey,Dimberline,ddimberline22@google.com,Clinical Specialist,4138,235,4373
43723,Ingar,Faust,ifaust23@cdbaby.com,Compensation Analyst,6149,1511,7660
43954,Zorah,Ramelet,zramelet24@skyrock.com,Nurse,1550,672,2222
43282,Patten,Keaveny,pkeaveny25@chron.com,Senior Editor,8756,1183,9939
43630,Burt,Hardwick,bhardwick26@pcworld.com,Operator,9992,1369,11361
43158,Vito,Hendron,vhendron27@wikipedia.org,Research Assistant IV,4911,327,5238
43707,Bryna,Hollingsbee,bhollingsbee28@abc.net.au,Research Nurse,7309,1579,8888
43931,Leena,Dive,ldive29@ibm.com,Occupational Therapist,7836,1423,9259
43477,Benedetto,Densun,bdensun2a@eepurl.com,Junior Executive,4078,858,4936
43355,Aleda,Drummer,adrummer2b@marriott.com,Assistant Manager,4057,1492,5549
43123,Jeanne,Lashmar,jlashmar2c@nature.com,Operator,2034,1579,3613
43116,Quinta,Richfield,qrichfield2d@bravesites.com,Web Designer III,9253,396,9649
43570,Vaclav,Vynarde,vvynarde2e@icio.us,Help Desk Operator,2619,1624,4243
43974,Maxie,Ollivierre,mollivierre2f@jugem.jp,Assistant Professor,9189,1124,10313
43471,Nelson,Tatershall,ntatershall2g@istockphoto.com,Sales Associate,8760,471,9231
43932,Mufi,Gittoes,mgittoes2h@stanford.edu,Senior Cost Accountant,8921,923,9844
43103,Yvonne,Chark,ychark2i@ow.ly,Senior Quality Engineer,4748,909,5657
43300,Alisander,Sheehan,asheehan2j@de.vu,Legal Assistant,6387,1261,7648
43435,Ryann,Dymidowski,rdymidowski2k@harvard.edu,Business Systems Development Analyst,6970,662,7632
43729,Derrik,Tice,dtice2l@cargocollective.com,Senior Editor,8738,1042,9780
43704,Timi,Faires,tfaires2m@w3.org,Geologist IV,8142,1148,9290
43012,Anson,Pembry,apembry2o@flavors.me,Technical Writer,7347,1842,9189
43651,Winona,Fulmen,wfulmen2p@ycombinator.com,Recruiter,4227,1911,6138
43595,Foster,Vescovini,fvescovini2r@washington.edu,Business Systems Development Analyst,4401,1779,6180
43669,Corabel,Ianizzi,cianizzi2t@tuttocitta.it,Executive Secretary,8186,1959,10145
43061,Marin,Kelland,mkelland2u@creativecommons.org,Media Manager II,9449,818,10267
43862,Chevy,Cossum,ccossum2v@microsoft.com,Software Engineer III,8081,1867,9948
43313,Lilah,Avrashin,lavrashin2w@meetup.com,Teacher,7785,944,8729
43938,Trevar,Leyzell,tleyzell2x@theglobeandmail.com,Product Engineer,3542,1926,5468
43452,Cornelius,Leggen,cleggen2y@tripadvisor.com,Budget/Accounting Analyst II,6209,1663,7872
43376,Dav,Paulillo,dpaulillo2z@microsoft.com,Professor,2742,1682,4424
43541,Heddie,Tubble,htubble30@cafepress.com,Registered Nurse,2798,1086,3884
43377,Damien,Farrance,dfarrance31@shareasale.com,Structural Engineer,1200,1025,2225
43648,Burnard,Brimson,bbrimson32@altervista.org,VP Product Management,3565,866,4431
43168,Roxy,Castanyer,rcastanyer33@ucla.edu,Marketing Manager,4290,1659,5949
43601,Elene,Haburne,ehaburne34@oaic.gov.au,Senior Editor,2361,1653,4014
43359,Myra,Breeds,mbreeds35@diigo.com,Software Test Engineer II,4732,1241,5973
43731,Elsy,Willets,ewillets36@foxnews.com,Research Associate,4331,482,4813
43199,Adel,Speare,aspeare37@opensource.org,Nurse,1682,377,2059
43014,Clareta,Allberry,callberry38@mtv.com,Account Executive,3186,449,3635
43234,Bronny,Brecher,bbrecher39@bravesites.com,Paralegal,6104,610,6714
43010,Waylen,Danielkiewicz,wdanielkiewicz3a@webeden.co.uk,GIS Technical Architect,9380,1176,10556
43747,Silvie,Serrier,sserrier3b@reuters.com,Senior Developer,4328,844,5172
43718,Eduard,Sabati,esabati3c@angelfire.com,Editor,1193,665,1858
43668,Hewitt,Stollen,hstollen3e@go.com,Physical Therapy Assistant,6784,1105,7889
43861,Hoebart,Ubsdall,hubsdall3f@engadget.com,Staff Accountant II,4892,233,5125
43086,Candra,Brabin,cbrabin3g@seattletimes.com,Payment Adjustment Coordinator,9700,776,10476
43267,Hillary,Eles,heles3h@slate.com,Staff Accountant III,6590,1305,7895
43305,Abra,Sinnat,asinnat3i@imgur.com,Compensation Analyst,2905,664,3569
43276,Jewel,Creech,jcreech3k@yelp.com,Product Engineer,3362,1817,5179
43288,Tallie,Hyde,thyde3l@mashable.com,Geologist II,6519,410,6929
43008,Olivier,Sturmey,osturmey3m@techcrunch.com,Accounting Assistant I,6450,623,7073
43080,Darrelle,Boles,dboles3n@toplist.cz,Operator,3471,457,3928
43469,Edeline,Pundy,epundy3o@jugem.jp,Executive Secretary,4518,1312,5830
43617,Damiano,Laudham,dlaudham3q@accuweather.com,Human Resources Manager,5274,1551,6825
43584,Saloma,Blick,sblick3s@harvard.edu,Database Administrator III,2436,532,2968
43049,Ariadne,Graveston,agraveston3t@linkedin.com,Dental Hygienist,9367,550,9917
43449,Erika,Stollenbecker,estollenbecker3v@nydailynews.com,Senior Quality Engineer,3882,1104,4986
43792,Maurice,Sutherns,msutherns3w@smugmug.com,Graphic Designer,5734,756,6490
43171,Saxon,Allam,sallam3x@cnet.com,Automation Specialist I,7248,1030,8278
43438,Mendel,Aronovich,maronovich3y@weather.com,Research Assistant II,8218,1198,9416
43232,Lyda,Deex,ldeex3z@mashable.com,Environmental Specialist,3822,387,4209
43382,Ad,Cusiter,acusiter40@xinhuanet.com,Senior Editor,5414,1208,6622
43618,Robin,Shobrook,rshobrook42@columbia.edu,Research Assistant III,2817,1153,3970
43161,Aarika,Hemms,ahemms43@4shared.com,Assistant Media Planner,5903,1953,7856
43726,Gwenore,Hurn,ghurn44@stanford.edu,Assistant Manager,3425,1959,5384
43321,Edee,Salmon,esalmon45@shareasale.com,Environmental Tech,9192,1409,10601
43544,Korey,Josskovitz,kjosskovitz46@goo.gl,Sales Representative,2901,1433,4334
43146,Jerrie,Roomes,jroomes4a@behance.net,Research Nurse,5885,1983,7868
43529,Noelle,Biswell,nbiswell4b@php.net,Account Executive,3319,1231,4550
43381,Thurstan,Giraudo,tgiraudo4c@tinyurl.com,Account Executive,6453,1278,7731
43245,Gerhardt,Skain,gskain4d@soup.io,Senior Sales Associate,2548,1366,3914
43322,Jacinta,Hinrich,jhinrich4g@ft.com,Web Developer III,2800,1221,4021
43811,Judie,Herche,jherche4h@mayoclinic.com,Clinical Specialist,1175,1238,2413
43580,Ottilie,Barneveld,obarneveld4i@nifty.com,Software Test Engineer IV,2111,615,2726
43758,Betta,Polon,bpolon4j@jimdo.com,Clinical Specialist,1542,1850,3392
43717,Marigold,Pear,mpear4l@walmart.com,Sales Representative,5565,471,6036
43539,Sile,Tice,stice4m@posterous.com,Legal Assistant,3549,1368,4917
43046,Aldridge,Gawthrope,agawthrope4n@census.gov,Senior Quality Engineer,9904,1718,11622
43696,Constance,Valente,cvalente4o@newyorker.com,Compensation Analyst,9882,1389,11271
43104,Jsandye,Di Carlo,jdicarlo4p@quantcast.com,Electrical Engineer,2109,1271,3380
43605,Simonette,Tabourier,stabourier4q@mozilla.org,Electrical Engineer,5975,1803,7778
43535,Carrol,Lampke,clampke4r@hatena.ne.jp,Nuclear Power Engineer,8278,276,8554
43654,Jany,Brandel,jbrandel4s@cbsnews.com,Junior Executive,2394,1204,3598
43060,Tyrone,Sowle,tsowle4t@prnewswire.com,Quality Engineer,8040,702,8742
43542,Caz,Marney,cmarney4u@quantcast.com,Food Chemist,2666,1779,4445
43905,Weber,Fould,wfould4v@newsvine.com,Operator,1613,1801,3414
43379,Wayne,Howard,whoward4w@sciencedirect.com,Automation Specialist II,7708,487,8195
43229,Grover,Plumb,gplumb4x@wordpress.org,Senior Financial Analyst,1396,879,2275
43911,Max,Dodswell,mdodswell4y@aboutads.info,Automation Specialist II,9221,1646,10867
43508,Golda,Greenacre,ggreenacre4z@whitehouse.gov,Business Systems Development Analyst,8385,864,9249
43182,Dina,Cutmare,dcutmare50@guardian.co.uk,Marketing Manager,3697,545,4242
43794,Roch,Alsford,ralsford51@gnu.org,Senior Sales Associate,8706,816,9522
43136,Gib,Janodet,gjanodet54@ed.gov,Structural Analysis Engineer,5630,1658,7288
43989,Jeramey,Rebbeck,jrebbeck56@arizona.edu,VP Quality Control,6850,1160,8010
43341,Ariela,Wykey,awykey57@tripod.com,Speech Pathologist,4704,1300,6004
43764,Jephthah,Bonny,jbonny59@mozilla.org,Senior Quality Engineer,2213,1555,3768
43114,Cameron,Gracey,cgracey5a@youku.com,Marketing Assistant,4841,1472,6313
43779,Keri,Heino,kheino5b@moonfruit.com,Senior Cost Accountant,7544,739,8283
43859,Port,Lyttle,plyttle5c@army.mil,Assistant Media Planner,6723,988,7711
43647,Anastasie,Lamartine,alamartine5d@oracle.com,Chief Design Engineer,6871,522,7393
43671,Dillon,Meredith,dmeredith5e@vistaprint.com,Assistant Professor,2247,1500,3747
43461,Margarethe,Gravenall,mgravenall5g@4shared.com,Food Chemist,3240,1465,4705
43725,Shannen,Jantzen,sjantzen5h@unblog.fr,Physical Therapy Assistant,1566,1279,2845
43691,Grover,Evison,gevison5i@oracle.com,Editor,7827,1620,9447
43908,Andriette,Filipczynski,afilipczynski5j@yandex.ru,Product Engineer,1399,1044,2443
43001,Cherrita,Gasnell,cgasnell5k@de.vu,Compensation Analyst,8137,759,8896
43513,Ara,Strangeways,astrangeways5l@wordpress.org,Financial Advisor,7779,453,8232
43643,Alessandro,Cubbino,acubbino5m@furl.net,General Manager,4675,1422,6097
43690,Westbrook,Willett,wwillett5o@kickstarter.com,Payment Adjustment Coordinator,7548,1474,9022
43511,Emlynn,Lambrechts,elambrechts5p@harvard.edu,Speech Pathologist,9944,1579,11523
43831,Gusta,Anetts,ganetts5q@sakura.ne.jp,Quality Engineer,1922,864,2786
43663,Madelaine,Turville,mturville5r@technorati.com,Account Executive,7667,409,8076
43429,Colleen,Larmett,clarmett5s@wiley.com,Human Resources Assistant II,3760,440,4200
43572,Rozella,Burehill,rburehill5u@joomla.org,Statistician I,7966,1290,9256
43638,Kalila,Kinane,kkinane5v@soup.io,Software Consultant,2043,1530,3573
43478,Stevy,Howett,showett5w@mit.edu,Database Administrator IV,4259,735,4994
43204,Trumann,Ivetts,tivetts5y@house.gov,Programmer I,5832,750,6582
43993,Rosene,Petyanin,rpetyanin60@admin.ch,Administrative Officer,9827,1165,10992
43505,Augie,Lief,alief61@nbcnews.com,Account Executive,1427,1409,2836
43326,Garrett,Joreau,gjoreau63@reddit.com,Internal Auditor,9817,1081,10898
43407,Kandace,Orman,korman64@discovery.com,Payment Adjustment Coordinator,9472,215,9687
43202,Elsworth,Stilliard,estilliard65@miitbeian.gov.cn,Speech Pathologist,7815,1752,9567
43658,Huntington,Bleasdille,hbleasdille67@wired.com,Chief Design Engineer,5884,1961,7845
43423,Torey,Bosward,tbosward68@tamu.edu,Analyst Programmer,7830,1000,8830
43750,Lark,Bertenshaw,lbertenshaw6a@noaa.gov,Administrative Officer,6564,1309,7873
43787,Boycie,Lardez,blardez6b@myspace.com,Nurse Practicioner,1579,1074,2653
43260,Carmelle,Zanioletti,czanioletti6c@amazon.co.uk,Software Test Engineer I,8454,994,9448
43180,Lemmie,Jarlmann,ljarlmann6d@theguardian.com,Nurse Practicioner,2404,465,2869
43240,Annissa,Chown,achown6f@google.com.br,Recruiting Manager,5114,1461,6575
43318,Lesley,Bernuzzi,lbernuzzi6g@cbc.ca,Nuclear Power Engineer,9363,1006,10369
43434,Izak,Doul,idoul6h@umn.edu,Engineer II,7509,869,8378
43366,Randell,Coonan,rcoonan6i@dell.com,Senior Quality Engineer,5437,1102,6539
43496,Xylina,Oherlihy,xoherlihy6l@ca.gov,Electrical Engineer,8153,1810,9963
43611,Micky,Walsham,mwalsham6m@auda.org.au,Design Engineer,1824,1484,3308
43757,Dunc,Sommer,dsommer6n@telegraph.co.uk,Electrical Engineer,2220,1716,3936
43017,Clementius,Woodcroft,cwoodcroft6o@cbslocal.com,Senior Financial Analyst,9055,651,9706
43089,Fidel,Withers,fwithers6p@walmart.com,Operator,3810,1738,5548
43575,Joela,Portman,jportman6q@about.me,Information Systems Manager,7070,319,7389
43490,Reiko,Ingle,ringle6r@4shared.com,Automation Specialist II,6386,1776,8162
43497,Frasier,Crosier,fcrosier6s@deviantart.com,Occupational Therapist,8014,700,8714
43119,Bonnie,Savege,bsavege6t@usnews.com,Chief Design Engineer,4408,731,5139
43840,Drucy,Hewins,dhewins6w@chronoengine.com,Mechanical Systems Engineer,1249,1379,2628
43285,Morgan,Wilfinger,mwilfinger6x@virginia.edu,Nuclear Power Engineer,7675,1638,9313
43236,Bale,Ordemann,bordemann6y@cargocollective.com,Programmer I,2003,1391,3394
43256,Bronson,Tayloe,btayloe6z@bravesites.com,Project Manager,4519,1256,5775
43196,Ainslie,Miquelet,amiquelet70@networksolutions.com,Marketing Assistant,3596,383,3979
43198,Douglass,Sampson,dsampson71@xinhuanet.com,Programmer I,6960,1229,8189
43822,Brod,Fronks,bfronks73@4shared.com,Professor,6757,1985,8742
43024,Arliene,Josefer,ajosefer74@bizjournals.com,Environmental Tech,8887,1158,10045
43807,Harlen,Willsmore,hwillsmore75@bluehost.com,Environmental Specialist,8929,727,9656
43033,Tina,Wakeley,twakeley77@goodreads.com,Computer Systems Analyst III,2849,353,3202
43798,Dre,Dowd,ddowd78@cafepress.com,Technical Writer,4556,636,5192
43521,Philis,Khristoforov,pkhristoforov79@simplemachines.org,Web Developer I,7101,1548,8649
43210,Nicolais,Elliot,nelliot7b@rediff.com,Environmental Specialist,1615,1343,2958
43661,Leshia,Arlott,larlott7c@phpbb.com,Desktop Support Technician,4033,635,4668
43649,Twyla,Brockett,tbrockett7d@edublogs.org,Developer II,2128,1308,3436
43910,Julee,Baggarley,jbaggarley7e@webmd.com,Health Coach IV,2852,1721,4573
43986,Randell,Nasi,rnasi7f@chicagotribune.com,Software Engineer III,4426,633,5059
43026,Neilla,Romei,nromei7g@nymag.com,Biostatistician IV,9881,1172,11053
43568,Hadleigh,Cordier,hcordier7h@bloglovin.com,Office Assistant III,1720,238,1958
43687,Vita,Loughlan,vloughlan7j@abc.net.au,Environmental Tech,1909,388,2297
43090,Joice,Rospars,jrospars7k@hatena.ne.jp,VP Marketing,6548,928,7476
43068,Sharyl,Stoke,sstoke7l@sfgate.com,Account Coordinator,1653,1404,3057
43810,Udall,Glenwright,uglenwright7m@w3.org,Occupational Therapist,5491,1507,6998
43719,Iris,Arcase,iarcase7o@issuu.com,Environmental Tech,5687,602,6289
43352,Celestina,De Mitris,cdemitris7p@prnewswire.com,Software Consultant,2396,419,2815
43344,Lorinda,Merrell,lmerrell7q@wordpress.org,Safety Technician III,2966,281,3247
43147,Alonzo,Lindenstrauss,alindenstrauss7s@chron.com,VP Marketing,7120,1331,8451
43045,Felice,Attoe,fattoe7t@lulu.com,Staff Scientist,8685,778,9463
43744,Virgie,Benning,vbenning7u@theatlantic.com,Environmental Tech,9957,1894,11851
43805,Cassi,Brave,cbrave7v@nymag.com,Nurse Practicioner,8097,337,8434
43976,Archibald,Baudains,abaudains7w@amazon.de,Account Coordinator,2691,830,3521
43148,Mary,Breed,mbreed7y@auda.org.au,VP Marketing,7465,1639,9104
43531,Griff,Veel,gveel7z@sourceforge.net,Internal Auditor,5016,938,5954
43902,Rena,D'Hooghe,rdhooghe80@de.vu,Recruiting Manager,8379,1573,9952
43641,Deana,Verey,dverey82@illinois.edu,Senior Developer,3210,658,3868
43921,Shaylynn,Torrent,storrent84@disqus.com,Teacher,9748,1283,11031
43785,Anne-marie,Millom,amillom85@stanford.edu,Occupational Therapist,1886,1363,3249
43674,Rhodia,Notley,rnotley86@cocolog-nifty.com,Human Resources Manager,7171,600,7771
43984,Tuckie,Jendas,tjendas87@mysql.com,VP Accounting,3944,1621,5565
43874,Glori,Brizell,gbrizell89@linkedin.com,Sales Associate,7580,1029,8609
43926,Ilise,Postill,ipostill8b@linkedin.com,Chief Design Engineer,3361,1666,5027
43152,Genni,Verdun,gverdun8e@amazonaws.com,Community Outreach Specialist,6010,553,6563
43083,Pincus,Tomalin,ptomalin8f@xinhuanet.com,Paralegal,4262,1948,6210
43552,Brandais,Cardno,bcardno8h@state.tx.us,Legal Assistant,5834,645,6479
43375,Cody,Petrello,cpetrello8i@wiley.com,Librarian,9161,1774,10935
43127,Rube,Stollwerk,rstollwerk8j@cbslocal.com,Database Administrator II,5002,1713,6715
43881,Benson,Yitzhok,byitzhok8l@hud.gov,Senior Quality Engineer,2696,1430,4126
43109,Alfred,Ballin,aballin8m@usatoday.com,Registered Nurse,7440,445,7885
43093,Krishna,Kimbury,kkimbury8n@biglobe.ne.jp,Quality Control Specialist,2371,1104,3475
43547,Cornela,Faichney,cfaichney8o@yolasite.com,Software Consultant,6648,734,7382
43298,Shaughn,Mapledoore,smapledoore8p@phoca.cz,Desktop Support Technician,3074,894,3968
43320,Dorelle,Riccardelli,driccardelli8q@freewebs.com,Office Assistant III,4853,1640,6493
43223,Courtney,Barron,cbarron8s@noaa.gov,Accountant III,7969,1703,9672
43855,Henry,Braunstein,hbraunstein8t@nps.gov,Staff Scientist,8462,430,8892
43866,Welby,Semaine,wsemaine8u@sakura.ne.jp,VP Quality Control,4877,1058,5935
43636,Ameline,Skullet,askullet8x@goo.ne.jp,Sales Associate,5408,1898,7306
43517,Stephannie,Parton,sparton8z@sakura.ne.jp,Media Manager II,4521,1372,5893
43299,Kalle,Mcmanaman,kmcmanaman91@studiopress.com,Desktop Support Technician,1295,1650,2945
43625,Emmy,Seville,eseville93@exblog.jp,Junior Executive,5716,1188,6904
43530,Cherlyn,Griffitts,cgriffitts94@bigcartel.com,Staff Accountant II,7945,755,8700
43362,Wernher,Gethyn,wgethyn95@jalbum.net,Director of Sales,2053,567,2620
43590,Rory,Coggan,rcoggan98@discuz.net,GIS Technical Architect,2884,1258,4142
43712,Wilburt,Dives,wdives9a@dmoz.org,Assistant Professor,3521,1709,5230
43942,Roarke,Lace,rlace9c@accuweather.com,Senior Developer,9063,1621,10684
43682,Conroy,Cottesford,ccottesford9d@chicagotribune.com,Desktop Support Technician,8331,1445,9776
43231,Shurlocke,Foukx,sfoukx9f@kickstarter.com,VP Marketing,8341,884,9225
43560,Bradford,Malkin,bmalkin9g@cloudflare.com,VP Product Management,7432,398,7830
43239,Mahmud,Grote,mgrote9i@google.com.au,Sales Associate,3090,719,3809
43458,Nanine,Marzelle,nmarzelle9j@berkeley.edu,Research Associate,3687,595,4282
43384,Umeko,Brooking,ubrooking9k@google.de,Programmer I,9989,503,10492
43350,Joachim,Clever,jclever9l@ycombinator.com,Occupational Therapist,3376,592,3968
43077,Osbourn,O' Cuolahan,oocuolahan9m@reddit.com,Data Coordiator,5124,1304,6428
43652,Fowler,Yerill,fyerill9n@pcworld.com,Associate Professor,2628,1077,3705
43979,Lilith,Duckers,lduckers9o@upenn.edu,Administrative Officer,3050,933,3983
43612,Mycah,Wyllcock,mwyllcock9q@about.me,Actuary,6566,400,6966
43071,Madelina,Craighall,mcraighall9r@4shared.com,Research Associate,1555,301,1856
43694,Daisy,Mulliner,dmulliner9s@topsy.com,Recruiter,4281,838,5119
43705,Filmer,Pullan,fpullan9t@1688.com,Programmer III,9899,1367,11266
43065,Brandyn,Secrett,bsecrett9u@pbs.org,Human Resources Manager,4684,1545,6229
43297,Rainer,McDade,rmcdade9v@google.co.jp,Physical Therapy Assistant,4295,1669,5964
43679,Elnore,Challenor,echallenor9w@prweb.com,Engineer I,8410,1486,9896
43576,Cherri,Ridett,cridett9x@oakley.com,GIS Technical Architect,4063,825,4888
43588,Maddi,Senior,msenior9y@example.com,Clinical Specialist,5396,1060,6456
43015,Zerk,Brewers,zbrewers9z@livejournal.com,Database Administrator I,2156,1534,3690
43020,Carine,Kristiansen,ckristiansena0@tripod.com,Engineer II,5004,673,5677
43546,Bendick,Menhci,bmenhcia1@nyu.edu,Environmental Tech,5237,281,5518
43702,Skipp,Kitchingman,skitchingmana2@typepad.com,Actuary,4924,890,5814
43472,Cassandry,Bovingdon,cbovingdona3@1und1.de,Automation Specialist III,3138,1348,4486
43051,Caressa,Petren,cpetrena5@sbwire.com,Nurse,3791,1991,5782
43751,Estella,Pryce,eprycea6@ibm.com,Senior Editor,9200,1722,10922
43867,Melly,Whyatt,mwhyatta9@simplemachines.org,Software Test Engineer IV,8719,603,9322
43967,Laureen,Howsley,lhowsleyaa@uiuc.edu,VP Sales,9325,1308,10633
43485,Woody,O'Haire,wohaireab@unblog.fr,Director of Sales,6134,1424,7558
43394,Devinne,Linskey,dlinskeyac@technorati.com,Senior Editor,6820,665,7485
43454,Carolin,Truman,ctrumanad@nymag.com,Quality Control Specialist,1116,1376,2492
43078,Winthrop,Purton,wpurtonae@cbsnews.com,VP Quality Control,5629,344,5973
43706,Morissa,Zoane,mzoaneah@nationalgeographic.com,Budget/Accounting Analyst III,5731,665,6396
43087,Richy,Lambillion,rlambillionaj@sohu.com,Civil Engineer,1315,288,1603
43082,Robyn,Andrat,randratak@skyrock.com,Human Resources Assistant I,2934,496,3430
43996,Jeniffer,Karslake,jkarslakeam@wunderground.com,Programmer Analyst I,6405,337,6742
43177,Carver,Daniaud,cdaniaudan@zimbio.com,Actuary,2374,255,2629
43437,Wendel,Leonards,wleonardsar@aol.com,Human Resources Assistant I,7820,1640,9460
43151,Donal,Di Baudi,ddibaudiat@godaddy.com,Cost Accountant,7621,307,7928
43703,Dacey,Swanton,dswantonau@xrea.com,Structural Analysis Engineer,7027,794,7821
43139,Galen,Meneer,gmeneerav@usa.gov,Senior Quality Engineer,7667,1333,9000
43589,Clayborn,Bengtsson,cbengtssonaw@rakuten.co.jp,Sales Associate,8279,1433,9712
43154,Norma,Wittering,nwitteringax@theatlantic.com,Administrative Assistant IV,9687,633,10320
43526,Blythe,O'Criane,bocrianeay@miitbeian.gov.cn,VP Accounting,9328,1838,11166
43351,Ema,Fosdike,efosdikeaz@hibu.com,Assistant Media Planner,6158,1353,7511
43852,Edik,Melland,emellandb0@so-net.ne.jp,Help Desk Technician,9027,927,9954
43306,Wynn,Thews,wthewsb1@ca.gov,Software Engineer I,3866,1862,5728
43092,Malia,Sutliff,msutliffb2@globo.com,Sales Representative,1805,953,2758
43788,Eugen,Domoni,edomonib5@psu.edu,Research Assistant III,4789,904,5693
43304,Corette,Foltin,cfoltinb6@facebook.com,Analog Circuit Design manager,1826,231,2057
43808,Alyda,Mowat,amowatb7@earthlink.net,Dental Hygienist,6651,319,6970
43436,Winston,Ezzy,wezzyb8@cnbc.com,Geological Engineer,9009,837,9846
43666,Gabbi,Duley,gduleyb9@ovh.net,GIS Technical Architect,9685,528,10213
43769,Haywood,Maybey,hmaybeyba@abc.net.au,Software Engineer I,1726,522,2248
43396,Padraic,Blackden,pblackdenbb@bing.com,Senior Sales Associate,9184,1128,10312
43634,Aldon,Reader,areaderbc@tripadvisor.com,Product Engineer,6654,1311,7965
43898,Francyne,Tuckwell,ftuckwellbd@naver.com,Computer Systems Analyst II,8061,625,8686
43122,Eberhard,Cockman,ecockmanbe@amazon.co.uk,Web Developer III,4817,886,5703
43380,Lambert,Findley,lfindleybf@pagesperso-orange.fr,Food Chemist,9165,1271,10436
43489,Dalenna,Navarijo,dnavarijobg@so-net.ne.jp,Marketing Assistant,6613,365,6978
43504,Farlie,Trenbay,ftrenbaybi@nyu.edu,Product Engineer,3989,795,4784
43770,Noam,Prydie,nprydiebk@cargocollective.com,Account Coordinator,5638,423,6061
43175,Gunther,Lympany,glympanybl@yandex.ru,VP Sales,5645,789,6434
43525,Maisie,Clapston,mclapstonbn@chicagotribune.com,Project Manager,3592,544,4136
43564,Noellyn,Suerz,nsuerzbq@ihg.com,Information Systems Manager,8831,572,9403
43586,Carson,Callister,ccallisterbu@biglobe.ne.jp,Internal Auditor,6796,589,7385
43914,Jo-anne,McComish,jmccomishbw@upenn.edu,Sales Associate,8160,675,8835
43408,Pauletta,Middler,pmiddlerby@theguardian.com,Pharmacist,5593,1187,6780
43889,Zora,Reef,zreefbz@sourceforge.net,Nurse,9491,1537,11028
43890,Giselle,Colls,gcollsc2@ezinearticles.com,Librarian,6006,454,6460
43962,Agnese,Danahar,adanaharc3@domainmarket.com,Senior Cost Accountant,2098,1202,3300
43534,Eduard,Mallam,emallamc4@wunderground.com,General Manager,6120,217,6337
43479,Selestina,Pacitti,spacittic6@last.fm,Analog Circuit Design manager,7636,1701,9337
43960,Karlyn,Berick,kberickc7@creativecommons.org,VP Product Management,6004,910,6914
43510,Torey,Greser,tgreserc8@jimdo.com,Staff Accountant II,8345,869,9214
43961,Lyn,Tomek,ltomekc9@godaddy.com,Budget/Accounting Analyst I,8990,747,9737
43620,Sherye,Kieff,skieffca@vinaora.com,Environmental Tech,4703,507,5210
43994,Cindy,Cameli,ccamelicc@bloglines.com,Software Engineer III,2533,533,3066
43602,Salomi,Primmer,sprimmercd@usgs.gov,Electrical Engineer,4950,1689,6639
43491,Stavros,Geach,sgeachce@irs.gov,Systems Administrator I,4419,730,5149
43097,Kahaleel,Wellen,kwellencf@ca.gov,Human Resources Manager,9155,1847,11002
43274,Nicola,Redier,nredierch@amazon.co.jp,Database Administrator IV,1765,1112,2877
43205,Tandie,Titchard,ttitchardck@unc.edu,Database Administrator IV,7440,1745,9185
43809,Juline,Greenrde,jgreenrdecl@wikia.com,Staff Scientist,4633,571,5204
43818,Sheila-kathryn,Billison,sbillisoncn@netvibes.com,Analog Circuit Design manager,2847,1643,4490
43633,Deny,Joppich,djoppichco@e-recht24.de,GIS Technical Architect,9903,492,10395
43047,Carena,Attarge,cattargecp@yelp.com,Engineer I,6684,1564,8248
43753,Clemens,Carlet,ccarletcq@meetup.com,Quality Engineer,7458,289,7747
43708,Winna,Lanegran,wlanegrancs@weibo.com,Account Representative I,4077,493,4570
43882,Lemmie,Storch,lstorchct@umn.edu,Design Engineer,9520,497,10017
43594,Verna,Boatswain,vboatswaincu@netscape.com,Product Engineer,7472,371,7843
43425,Mariele,Bonehill,mbonehillcv@facebook.com,Technical Writer,8283,1864,10147
43714,Orson,McIndrew,omcindrewcw@unc.edu,Programmer IV,9453,1254,10707
43363,Fidelio,Grzegorzewicz,fgrzegorzewiczcx@mapy.cz,Automation Specialist IV,3392,985,4377
43553,Cherice,Littlepage,clittlepagecy@usa.gov,Structural Analysis Engineer,6185,1949,8134
43583,Mayor,Gittose,mgittosecz@huffingtonpost.com,Actuary,2701,1096,3797
43715,Melany,Fyldes,mfyldesd0@howstuffworks.com,Quality Control Specialist,7313,207,7520
43238,Ailee,Soame,asoamed1@webmd.com,Dental Hygienist,7832,267,8099
43783,Emmey,Loakes,eloakesd2@bloomberg.com,Engineer I,1943,950,2893
43749,Bertrand,Loving,blovingd3@unesco.org,Recruiter,3342,841,4183
43021,Margaretha,Magrane,mmagraned5@intel.com,Accountant I,2430,659,3089
43968,Elayne,Blinckhorne,eblinckhorned6@discuz.net,Operator,3466,750,4216
43023,Westley,Ort,wortd7@elpais.com,Help Desk Operator,5898,942,6840
43812,Dorrie,Padson,dpadsonda@dot.gov,Legal Assistant,5004,1115,6119
43681,Daisie,Gradon,dgradondb@redcross.org,Desktop Support Technician,9711,1354,11065
43270,Carmelia,Skillern,cskillerndc@yandex.ru,VP Product Management,7362,852,8214
43058,Caldwell,Gonsalvo,cgonsalvodf@parallels.com,Paralegal,5847,1447,7294
43173,Emilee,MacGee,emacgeedg@php.net,Quality Engineer,9764,479,10243
43904,Cindy,Bilverstone,cbilverstonedi@1und1.de,Administrative Officer,3788,1398,5186
43949,Rebeka,O'Sculley,rosculleydk@wordpress.com,Technical Writer,7679,649,8328
43361,Rolf,Renton,rrentondm@hhs.gov,Statistician II,1568,1458,3026
43793,Orran,Pitson,opitsondn@wordpress.com,Actuary,1010,1054,2064
43841,Catherina,Budik,cbudikdo@biglobe.ne.jp,Nurse Practicioner,7320,1567,8887
43917,Dale,Seccombe,dseccombedq@opera.com,Web Designer III,2561,1422,3983
43226,Ilsa,Sivorn,isivorndr@usa.gov,VP Quality Control,8892,1992,10884
43944,Brit,Singleton,bsingletondt@ftc.gov,VP Quality Control,8545,1228,9773
43693,Tiffy,Scholfield,tscholfielddu@sciencedirect.com,Software Consultant,2339,1624,3963
43688,Noel,Grassot,ngrassotdv@soup.io,Speech Pathologist,5943,1206,7149
43338,Darbee,Basini-Gazzi,dbasinigazzidw@cnet.com,Environmental Specialist,2916,1075,3991
43878,Frederick,Boddy,fboddydx@walmart.com,Software Consultant,8932,1019,9951
43126,Noland,McGahern,nmcgaherndz@oakley.com,Marketing Manager,3952,1111,5063
43269,Viviene,Kopmann,vkopmanne0@cloudflare.com,Marketing Assistant,5009,1697,6706
43265,Joella,Messruther,jmessruthere1@japanpost.jp,Mechanical Systems Engineer,1987,1541,3528
43483,Padgett,Gandey,pgandeye3@japanpost.jp,Account Coordinator,7280,991,8271
43709,Brade,Pidgen,bpidgene5@mapquest.com,Nurse,9676,648,10324
43063,Opaline,Meneer,omeneere6@blogspot.com,Web Developer IV,6792,1709,8501
43312,Arlin,Doman,adomane7@w3.org,Technical Writer,6168,1892,8060
43347,Bliss,Huckin,bhuckine9@chron.com,VP Sales,3056,1977,5033
43222,Stefano,Simco,ssimcoed@privacy.gov.au,Data Coordiator,2454,1330,3784
43333,Mauricio,Chaman,mchamanee@craigslist.org,Engineer I,9670,1458,11128
43892,Meara,Bartozzi,mbartozzief@instagram.com,Health Coach I,6887,1178,8065
43165,Den,Giovannardi,dgiovannardieg@hibu.com,Internal Auditor,7378,990,8368
43456,Calli,Blight,cblighteh@shinystat.com,Data Coordiator,6311,867,7178
43888,Nady,Schulze,nschulzeei@goo.ne.jp,Registered Nurse,1902,1274,3176
43069,Midge,Gore,mgoreek@google.nl,Business Systems Development Analyst,9724,825,10549
43291,Prentice,Vennart,pvennartel@imageshack.us,Safety Technician I,8615,1062,9677
43741,Lauretta,Glasscott,lglasscottem@dropbox.com,Legal Assistant,9139,720,9859
43569,Asa,Addinall,aaddinallen@netscape.com,Assistant Professor,7342,900,8242
43113,Zerk,Titmarsh,ztitmarsheo@nature.com,Marketing Manager,4759,1183,5942
43279,Maddi,Lere,mlereep@mtv.com,Research Assistant IV,9943,695,10638
43958,Ulick,Laxon,ulaxones@cafepress.com,Desktop Support Technician,6254,347,6601
43860,Rollin,Willson,rwillsonet@answers.com,Project Manager,5456,1538,6994
43419,Alverta,Wheeler,awheelerev@oaic.gov.au,Senior Financial Analyst,4112,1931,6043
43243,Olivie,MacFaell,omacfaellew@github.io,Occupational Therapist,9930,726,10656
43746,Dell,Gimeno,dgimenoex@twitpic.com,Nuclear Power Engineer,6059,1122,7181
43879,Niko,Vanlint,nvanlintf0@paypal.com,Environmental Tech,6957,882,7839
43507,Danita,Groocock,dgroocockf1@harvard.edu,Tax Accountant,6398,454,6852
43132,Ernst,Hovington,ehovingtonf3@ucla.edu,Programmer IV,8642,1521,10163
43476,Norbert,Iiannone,niiannonef5@reuters.com,Sales Associate,9050,806,9856
43814,Martica,Hounsom,mhounsomf9@wordpress.com,Budget/Accounting Analyst II,1129,1976,3105
43963,Gisele,Laphorn,glaphornfa@behance.net,Statistician IV,8902,1216,10118
43149,Gale,Lemonby,glemonbyfh@census.gov,Design Engineer,3769,1667,5436
43009,Orran,Braun,obraunfi@nyu.edu,Analyst Programmer,5242,594,5836
43107,Jessika,Wooster,jwoosterfk@goodreads.com,Marketing Manager,5838,980,6818
43100,Jareb,Hansill,jhansillfm@artisteer.com,Associate Professor,1886,607,2493
43571,Davin,Ambrogi,dambrogifn@mozilla.com,Research Assistant III,7152,1106,8258
43563,Randal,Soigoux,rsoigouxfq@amazonaws.com,Budget/Accounting Analyst III,5181,1237,6418
43111,Phillipp,Pearson,ppearsonfs@devhub.com,Software Engineer I,7122,1309,8431
43639,Roseanne,Willas,rwillasfu@google.com.hk,Financial Advisor,2242,1599,3841
43970,Christie,Lago,clagofv@wsj.com,Web Designer III,5731,620,6351
43619,Kathleen,Pennycock,kpennycockfw@sfgate.com,Budget/Accounting Analyst IV,7231,1966,9197
43545,Viki,Swift,vswiftfx@alexa.com,Recruiter,8282,540,8822
43054,Vanni,Tryme,vtrymefy@noaa.gov,Registered Nurse,3481,1810,5291
43613,Milly,Tidbury,mtidburyg0@wunderground.com,Budget/Accounting Analyst IV,3487,1589,5076
43346,Mei,Mabley,mmableyg1@accuweather.com,Research Nurse,4689,1383,6072
43512,Allissa,O'Haire,aohaireg2@tiny.cc,Sales Representative,7806,1819,9625
43218,Hewet,Dibb,hdibbg4@chicagotribune.com,Accounting Assistant I,5945,1403,7348
43971,Honor,Dorie,hdorieg7@smh.com.au,GIS Technical Architect,8624,1226,9850
43672,Shelden,Marklin,smarkling9@csmonitor.com,Financial Analyst,8979,1270,10249
43050,Pooh,Meredith,pmeredithga@uiuc.edu,Accountant IV,6562,597,7159
43031,Maggy,Baldoni,mbaldonigc@w3.org,Speech Pathologist,8606,473,9079
43735,Phineas,Domenichini,pdomenichinige@scribd.com,Software Engineer III,9616,1351,10967
43894,Leora,Tireman,ltiremangf@vinaora.com,Desktop Support Technician,4781,282,5063
43830,Mayer,Lytell,mlytellgg@miitbeian.gov.cn,Actuary,7990,1139,9129
43566,Whittaker,Gallety,wgalletygh@hc360.com,Safety Technician I,6220,1804,8024
43431,Bobbie,Gradley,bgradleygi@imageshack.us,Chemical Engineer,7342,1614,8956
43699,Niels,Rockingham,nrockinghamgk@privacy.gov.au,Nurse,3211,1181,4392
43466,Leighton,Ingyon,lingyongl@technorati.com,Structural Engineer,9212,453,9665
43016,Briggs,Artiss,bartissgm@fema.gov,Associate Professor,9092,1705,10797
43864,Rance,Wordesworth,rwordesworthgn@phoca.cz,Senior Developer,3395,1437,4832
43041,Beltran,Jacobi,bjacobigo@newyorker.com,Chemical Engineer,8097,933,9030
43364,Jacqui,Kopf,jkopfgq@dmoz.org,Sales Associate,9665,214,9879
43055,Faun,Shrubb,fshrubbgr@columbia.edu,Social Worker,3014,1020,4034
43459,Jaquith,Redler,jredlergt@prnewswire.com,Clinical Specialist,1737,1455,3192
43835,Allyson,Whitton,awhittongu@fc2.com,Geologist I,7931,1045,8976
43710,Rosene,Buard,rbuardgv@friendfeed.com,Research Associate,8392,1477,9869
43209,Janet,Earp,jearpgw@telegraph.co.uk,Graphic Designer,8164,211,8375
43430,Meryl,Waldera,mwalderah0@devhub.com,Junior Executive,9967,1970,11937
43022,Gris,de Chastelain,gdechastelainh2@gmpg.org,Assistant Media Planner,2297,1224,3521
43296,Brnaba,Cressingham,bcressinghamh3@shareasale.com,Analyst Programmer,7322,1647,8969
43067,Dur,Rapsey,drapseyh8@bloomberg.com,Software Test Engineer I,2424,661,3085
43872,Geralda,Pottery,gpotteryh9@digg.com,Executive Secretary,3845,1585,5430
43943,Kally,Melbourn,kmelbournha@ow.ly,Director of Sales,2326,253,2579
43252,Olivia,Harnell,oharnellhc@nbcnews.com,Structural Engineer,1486,1185,2671
43713,Justino,Beany,jbeanyhd@drupal.org,Tax Accountant,2261,1772,4033
43677,Onida,Neaverson,oneaversonhg@lulu.com,Internal Auditor,9306,369,9675
43208,Conroy,Goody,cgoodyhh@blogtalkradio.com,Software Test Engineer II,4379,1254,5633
43939,Camala,Alam,calamhk@squidoo.com,Teacher,4452,939,5391
43255,Kristy,Berndsen,kberndsenhm@independent.co.uk,Librarian,7547,1980,9527
43159,Angelo,Finnick,afinnickho@disqus.com,Help Desk Operator,6491,1512,8003
43066,Hadrian,Foulcher,hfoulcherhp@seesaa.net,Geologist II,8169,224,8393
43920,Jeanne,Scare,jscarehq@ucsd.edu,VP Accounting,9307,713,10020
43303,Melva,Pasby,mpasbyhr@artisteer.com,Assistant Media Planner,6045,1376,7421
43823,Duncan,Mardee,dmardeehs@furl.net,Marketing Assistant,4795,945,5740
43004,Bendix,De Andisie,bdeandisiehu@utexas.edu,Junior Executive,9982,1214,11196
43273,Tremain,Clunan,tclunanhv@mtv.com,VP Product Management,6248,352,6600
43701,Charline,Costello,ccostellohw@google.ca,Sales Associate,1729,487,2216
43775,Moises,Polkinhorn,mpolkinhornhx@t.co,Software Engineer II,4540,309,4849
43925,Karissa,Bellchamber,kbellchamberhz@nhs.uk,Staff Scientist,5207,1087,6294
43626,Henrie,Sainsbury-Brown,hsainsburybrowni0@privacy.gov.au,Chief Design Engineer,3296,1384,4680
43448,Alejandro,Stonhouse,astonhousei2@army.mil,Internal Auditor,5650,1694,7344
43844,Constantina,Dyster,cdysteri4@psu.edu,Administrative Assistant I,7112,1503,8615
43843,Mirabel,Stean,msteani7@craigslist.org,Compensation Analyst,9298,658,9956
43440,Dasie,McInnes,dmcinnesia@tinypic.com,Assistant Manager,9981,639,10620
43667,Bord,Gjerde,bgjerdeic@storify.com,Web Designer II,2089,935,3024
43972,Ottilie,Dyneley,odyneleyif@vinaora.com,Senior Financial Analyst,1298,1918,3216
43475,Silvana,Duckerin,sduckerinih@archive.org,VP Marketing,4252,1031,5283
43838,Leah,Loveredge,lloveredgeij@google.it,Business Systems Development Analyst,4578,1225,5803
43801,Almeta,Monksfield,amonksfieldik@upenn.edu,Senior Quality Engineer,8897,429,9326
43948,Lindy,Curwen,lcurwenil@tumblr.com,Analog Circuit Design manager,3565,1798,5363
43316,Josee,Burdett,jburdettim@alexa.com,Pharmacist,5552,200,5752
43398,Uriel,Grzegorecki,ugrzegoreckiin@mozilla.org,Recruiter,3317,1863,5180
43324,Levi,Beaman,lbeamanip@photobucket.com,Senior Sales Associate,6840,820,7660
43765,Windham,Biddles,wbiddlesiq@a8.net,Professor,6024,1808,7832
43781,Garvy,Chittie,gchittieiu@alexa.com,Electrical Engineer,3371,1277,4648
43659,Shae,Douty,sdoutyix@mediafire.com,Electrical Engineer,2980,563,3543
43406,Delbert,Inott,dinottiz@patch.com,Human Resources Assistant I,5579,1388,6967
43629,Barr,Toffolini,btoffolinij0@mozilla.org,Recruiter,4991,1124,6115
43935,Riva,Berthelet,rbertheletj3@sun.com,Director of Sales,2463,1433,3896
43064,Amery,Liebrecht,aliebrechtj6@go.com,Structural Analysis Engineer,3083,1949,5032
43203,Germain,Easom,geasomj8@reuters.com,Community Outreach Specialist,5791,666,6457
43178,Annadiane,O' Hanvey,aohanveyjd@amazon.com,Engineer II,6698,1338,8036
43336,Courtnay,Deniseau,cdeniseaujf@walmart.com,Librarian,6664,1562,8226
43044,Corliss,Gergher,cgergherjg@nhs.uk,Research Assistant IV,4953,680,5633
43946,Anatollo,Paslow,apaslowji@bbc.co.uk,Web Designer I,1742,1272,3014
43253,Judah,Kegan,jkeganjj@geocities.jp,Software Test Engineer II,8378,696,9074
43211,Zelig,Cashley,zcashleyjm@usda.gov,Engineer I,6081,1898,7979
43771,Benyamin,Sherlaw,bsherlawjn@youku.com,Desktop Support Technician,5569,1737,7306
43138,Murielle,Moreing,mmoreingjo@hibu.com,Sales Associate,1963,1055,3018
43120,Casper,Linney,clinneyjq@china.com.cn,Staff Scientist,3895,1943,5838
43415,Ruperta,Basketter,rbasketterjr@usgs.gov,Business Systems Development Analyst,4999,1082,6081
43290,Northrup,Stoakes,nstoakesju@trellian.com,Community Outreach Specialist,5453,1364,6817
43609,Hettie,Damp,hdampjv@cocolog-nifty.com,Research Assistant I,9218,1843,11061
43550,Noby,Buessen,nbuessenjw@cloudflare.com,Cost Accountant,4268,1171,5439
43561,Benito,Pidgeon,bpidgeonjx@reverbnation.com,Professor,5977,771,6748
43990,Traver,Esilmon,tesilmonjz@wix.com,Senior Editor,8681,209,8890
43985,Kary,Burgwyn,kburgwynk0@issuu.com,Safety Technician I,8593,1862,10455
43442,Ellyn,Sein,eseink2@godaddy.com,Junior Executive,1734,1044,2778
43125,Lian,Piercey,lpierceyk3@independent.co.uk,Marketing Assistant,1693,201,1894
43167,Forbes,Reuther,freutherk4@scientificamerican.com,Physical Therapy Assistant,5142,1692,6834
43293,Sasha,Dowell,sdowellk6@unicef.org,Civil Engineer,9396,728,10124
43059,Maurita,Brook,mbrookkc@kickstarter.com,Speech Pathologist,9863,223,10086
43607,Barbette,Kerby,bkerbykd@163.com,Accountant IV,6662,206,6868
43420,Clare,Tincombe,ctincombekh@godaddy.com,Payment Adjustment Coordinator,8520,717,9237
43084,Hermina,Ovett,hovettkk@google.de,Chemical Engineer,5216,1520,6736
43897,Zaccaria,Veart,zveartkm@si.edu,Human Resources Assistant II,6700,603,7303
43664,Cheslie,Jeans,cjeanskn@slideshare.net,Automation Specialist III,9872,1275,11147
43540,Muffin,Orrin,morrinkp@vkontakte.ru,Operator,1413,789,2202
43692,Stillmann,Barns,sbarnsks@squidoo.com,Biostatistician II,1442,924,2366
43254,Devin,Gorriessen,dgorriessenkt@studiopress.com,Account Executive,1358,1573,2931
43439,Fredric,Whitwood,fwhitwoodl1@java.com,Payment Adjustment Coordinator,8606,1631,10237
43271,Nanci,Pavese,npavesel2@whitehouse.gov,Mechanical Systems Engineer,1976,257,2233
43374,Roby,Duchart,rduchartl6@jugem.jp,Paralegal,5847,651,6498
43105,Shana,Seer,sseerl8@ed.gov,Paralegal,1187,714,1901
43110,Kala,Soppeth,ksoppethl9@istockphoto.com,Editor,3868,813,4681
43738,Shayna,Greystock,sgreystockla@mlb.com,Senior Financial Analyst,5402,1731,7133
43057,Leandra,Syvret,lsyvretle@princeton.edu,Computer Systems Analyst II,9576,747,10323
43826,Fancie,Cocozza,fcocozzalo@delicious.com,Assistant Manager,4180,1694,5874
43573,Haydon,Outlaw,houtlawlu@jiathis.com,Developer I,7649,1778,9427
43206,Maris,Boyce,mboycelx@jigsy.com,VP Product Management,7417,1057,8474
43722,Vicki,Georgiades,vgeorgiadesly@umn.edu,Senior Editor,5134,288,5422
43995,Ruggiero,Lardnar,rlardnarlz@google.com.au,Systems Administrator I,7607,1187,8794
43551,Friedrich,Berzon,fberzonm0@virginia.edu,Statistician IV,9551,363,9914
43372,Alvin,Herculeson,aherculesonm1@netlog.com,Teacher,1151,770,1921
43499,Neville,Elix,nelixm5@si.edu,Financial Analyst,8693,1332,10025
43450,Dosi,Tocqueville,dtocquevillem6@marriott.com,Data Coordiator,9692,689,10381
43800,Zsa zsa,Carlo,zcarlom8@infoseek.co.jp,Social Worker,8448,1241,9689
43181,Licha,Bale,lbalem9@howstuffworks.com,Geological Engineer,1958,359,2317
43056,Barbaraanne,Walters,bwaltersmh@ocn.ne.jp,Editor,3997,792,4789
43144,Rudy,Layne,rlaynemj@aboutads.info,Sales Associate,9882,1550,11432
43603,Mohammed,Massenhove,mmassenhovemk@biglobe.ne.jp,Health Coach III,5162,1179,6341
43767,Lexis,Couth,lcouthmp@wordpress.org,Nuclear Power Engineer,5257,1050,6307
43574,Costanza,Heijnen,cheijnenmq@redcross.org,Assistant Professor,7553,1474,9027
43933,Shaughn,Zylbermann,szylbermannmr@merriam-webster.com,Mechanical Systems Engineer,8463,1039,9502
43235,Antonina,Kase,akasems@yahoo.co.jp,Account Representative III,4171,860,5031
43777,Celle,Goding,cgodingmu@home.pl,Analog Circuit Design manager,1148,1630,2778
43369,Augusta,Honeyghan,ahoneyghanmv@sphinn.com,Developer I,8299,975,9274
43656,Zorah,De Antoni,zdeantonimy@loc.gov,Account Representative II,5083,1062,6145
43145,Lara,Esh,leshn1@cornell.edu,General Manager,3324,320,3644
43857,Marney,Ferbrache,mferbrachen3@noaa.gov,Help Desk Operator,9940,958,10898
43258,Brewster,McLeman,bmclemann7@phpbb.com,Analyst Programmer,4569,1942,6511
43354,Georgeta,Hegdonne,ghegdonnen8@flavors.me,Staff Scientist,1417,1339,2756
43095,Cordie,Castanone,ccastanonena@google.it,Research Nurse,4060,1188,5248
43264,Alfie,Stickens,astickensng@dailymail.co.uk,Physical Therapy Assistant,7887,1788,9675
43520,Nanci,Whistance,nwhistanceni@joomla.org,Teacher,3981,241,4222
43896,Darren,Calladine,dcalladinenk@newsvine.com,Recruiter,5800,1788,7588
43460,Andonis,Genike,agenikenm@wordpress.org,Recruiting Manager,9682,1945,11627
43495,Ashia,Abson,aabsonnn@wix.com,Administrative Officer,7945,918,8863
43400,Gabriel,Edginton,gedgintonno@discuz.net,Help Desk Operator,9630,851,10481
43030,Sherlock,Dy,sdynp@illinois.edu,Account Coordinator,9923,1123,11046
43740,Luz,McRobert,lmcrobertnu@goo.gl,Statistician III,5684,378,6062
43421,Rodge,Yezafovich,ryezafovichnw@goo.gl,Health Coach II,5100,1614,6714
43662,Cortney,Botte,cbottenx@mapquest.com,Systems Administrator IV,2143,973,3116
43519,Alaric,Saleway,asalewayny@qq.com,Compensation Analyst,6006,1850,7856
43053,Burg,Ilbert,bilbertnz@freewebs.com,Environmental Tech,1841,427,2268
43598,Gerladina,McIlriach,gmcilriacho5@oaic.gov.au,Software Engineer II,3530,1437,4967
43275,Konstantin,Pemble,kpembleo7@ameblo.jp,Mechanical Systems Engineer,1865,435,2300
43062,Daffie,Ferryn,dferrynoa@ameblo.jp,Financial Analyst,2046,1345,3391
43922,Loise,Tesmond,ltesmondob@state.tx.us,Health Coach III,1385,1523,2908
43227,Morgana,Ambrosi,mambrosioe@usa.gov,Engineer I,7574,1982,9556
43079,Jolee,Baccus,jbaccusoj@twitter.com,Senior Sales Associate,6727,1498,8225
43413,Hercules,Spleving,hsplevingop@theguardian.com,Quality Control Specialist,5523,297,5820
43013,Madelyn,Matthai,mmatthaior@pcworld.com,Director of Sales,3918,767,4685
43637,Brock,Ramelot,bramelotow@ning.com,Programmer IV,9999,521,10520
43101,Marta,Pridgeon,mpridgeonox@google.nl,Graphic Designer,1715,1105,2820
43387,Thor,Rubinchik,trubinchikp0@noaa.gov,Marketing Assistant,4717,749,5466
43194,Karine,Mapham,kmaphamp3@youtu.be,Recruiter,5233,380,5613
43606,Nicko,Gladbeck,ngladbeckp4@free.fr,Safety Technician II,1557,1867,3424
43845,Stavros,Heersma,sheersmap5@pcworld.com,Dental Hygienist,3472,955,4427
43169,Robers,Joannidi,rjoannidipa@independent.co.uk,Director of Sales,6562,811,7373
43403,Richard,Liddiard,rliddiardpd@samsung.com,Engineer I,7521,1961,9482
43283,Eddy,Nuttall,enuttallpg@ucoz.ru,Health Coach II,5893,439,6332
43002,Ettie,Hain,ehainpi@bloglines.com,Marketing Assistant,6514,867,7381
43307,Nixie,Nekrews,nnekrewspk@comsenz.com,Programmer Analyst I,7870,241,8111
43728,Joella,Domaschke,jdomaschkepl@symantec.com,Chief Design Engineer,2020,1135,3155
43806,Christian,Ferenc,cferencpn@mlb.com,Clinical Specialist,1612,1993,3605
43734,Findlay,Berling,fberlingpr@angelfire.com,GIS Technical Architect,9053,616,9669
43900,Nanice,Freke,nfrekept@usa.gov,Geological Engineer,7780,1885,9665
43141,Ford,Castell,fcastellpv@exblog.jp,Editor,7072,1989,9061
43447,Simona,Risdale,srisdalepx@etsy.com,Statistician II,7552,1393,8945
43906,Murray,Casaletto,mcasalettopy@vinaora.com,Office Assistant II,4356,1214,5570
43172,Maxine,Peachman,mpeachmanq0@woothemes.com,Registered Nurse,5566,1051,6617
43003,Arlinda,Habin,ahabinq1@hatena.ne.jp,Assistant Media Planner,3444,368,3812
43924,Jilly,Vallance,jvallanceq6@g.co,Research Nurse,7753,721,8474
43072,Portie,Cordie,pcordieq7@prnewswire.com,Assistant Professor,6365,934,7299
43343,Chantal,Emms,cemmsq9@hatena.ne.jp,Senior Financial Analyst,5936,1301,7237
43964,Berget,Valiant,bvaliantqa@uiuc.edu,Automation Specialist IV,5354,619,5973
43875,Garik,Guiett,gguiettqd@chicagotribune.com,Automation Specialist IV,8550,1697,10247
43533,Denis,Buse,dbuseqe@blinklist.com,Research Assistant III,6980,715,7695
43277,Bond,Bernath,bbernathqh@buzzfeed.com,Registered Nurse,8507,1234,9741
43135,Barny,Belcham,bbelchamqj@marketwatch.com,Programmer Analyst IV,6209,1756,7965
43876,Sully,Pien,spienqq@disqus.com,Recruiter,2288,402,2690
43887,Findlay,Meegin,fmeeginqs@lulu.com,Nuclear Power Engineer,3023,641,3664
43360,Ivonne,Sturrock,isturrockqt@4shared.com,Mechanical Systems Engineer,5476,948,6424
43228,Giulietta,Hassett,ghassettqy@webmd.com,Health Coach I,2083,1980,4063
43869,Corly,Kingh,ckinghr0@adobe.com,Speech Pathologist,7283,1711,8994
43680,Sibeal,Keep,skeepr1@stumbleupon.com,Account Coordinator,3940,525,4465
43916,Natalina,D'Ambrogio,ndambrogior4@utexas.edu,Environmental Specialist,4114,1282,5396
43676,Cilka,Camfield,ccamfieldr5@ameblo.jp,Senior Financial Analyst,2144,715,2859
43883,Sada,Paxman,spaxmanr6@diigo.com,Senior Quality Engineer,9729,1473,11202
43786,Adrian,Devine,adeviner7@columbia.edu,Statistician III,1077,427,1504
43657,Lucio,Rodrig,lrodrigr8@adobe.com,Community Outreach Specialist,4165,875,5040
43624,Eimile,Twells,etwellsr9@skype.com,Senior Cost Accountant,3332,1953,5285
43391,Maxim,Vampouille,mvampouillera@whitehouse.gov,Occupational Therapist,8171,1285,9456
43163,Dita,Franken,dfrankenrb@theglobeandmail.com,Food Chemist,8534,1911,10445
43885,Nicolle,Stirtle,nstirtlere@reverbnation.com,Recruiter,4273,1145,5418
43796,Hart,Rottcher,hrottcherrg@ezinearticles.com,Programmer IV,2617,959,3576
43358,Randie,Mostin,rmostinrh@1und1.de,VP Quality Control,9092,1318,10410
43833,Benedikt,Alsobrook,balsobrookrk@comsenz.com,Biostatistician II,5263,1470,6733
43444,Yoko,Castanares,ycastanaresrl@census.gov,Community Outreach Specialist,1336,1208,2544
43802,Jacquie,Klimas,jklimasrn@printfriendly.com,Sales Representative,7081,1048,8129
44225,Napoleon,Dannett,ndannett0@adobe.com,Database Administrator I,2767,788,3555
44501,Astrid,Crossdale,acrossdale1@typepad.com,Marketing Manager,6798,323,7121
44317,Robinet,Baynes,rbaynes2@csmonitor.com,Editor,9034,996,10030
44819,Cornelia,Kleinsmuntz,ckleinsmuntz3@weather.com,Operator,1027,1045,2072
44308,Vicki,McComish,vmccomish4@parallels.com,Graphic Designer,2304,437,2741
44629,Agnella,Underhill,aunderhill6@spiegel.de,Assistant Manager,9765,1979,11744
44264,Dasie,Dray,ddray7@home.pl,Help Desk Technician,6649,1539,8188
44300,Mattie,Muston,mmuston8@instagram.com,Sales Representative,8756,424,9180
44668,Demott,Billyeald,dbillyeald9@vimeo.com,Geological Engineer,8887,1109,9996
44881,Cristy,Chatin,cchatina@tamu.edu,Nuclear Power Engineer,5637,1644,7281
44693,Garv,Aldins,galdinsb@dagondesign.com,Mechanical Systems Engineer,1629,379,2008
44008,Leontyne,Kretschmer,lkretschmerc@ning.com,Librarian,7733,1468,9201
44643,Ruperto,Dilger,rdilgerd@cbc.ca,Recruiting Manager,2673,1358,4031
44874,Valentine,Yate,vyatee@china.com.cn,Nurse Practicioner,8757,617,9374
44912,Mickie,Kellogg,mkelloggf@bluehost.com,Business Systems Development Analyst,7406,895,8301
44889,Heriberto,Appleton,happletong@abc.net.au,Analyst Programmer,4098,709,4807
44094,Belle,Scrivens,bscrivensh@stumbleupon.com,VP Accounting,8326,1642,9968
44903,Phillie,Rowat,prowati@parallels.com,Food Chemist,4507,528,5035
44272,Donelle,Whellams,dwhellamsj@mozilla.com,Mechanical Systems Engineer,6937,830,7767
44712,Job,Gabitis,jgabitisk@deviantart.com,Accountant I,2837,748,3585
44323,Renault,Forton,rfortonl@google.fr,Research Assistant III,3744,1992,5736
44829,Herman,Janosevic,hjanosevicm@netscape.com,Mechanical Systems Engineer,3262,707,3969
44108,Keene,Chyuerton,kchyuertonn@sfgate.com,Professor,5760,534,6294
44029,Carmen,Easdon,ceasdono@intel.com,Marketing Manager,2756,1649,4405
44140,Lucilia,Blitzer,lblitzerp@vistaprint.com,Developer II,6391,903,7294
44537,Charlton,Castellanos,ccastellanosq@columbia.edu,Food Chemist,5412,992,6404
44762,Lars,Pardon,lpardonr@shop-pro.jp,Systems Administrator II,4558,1583,6141
44445,Camille,Mathevon,cmathevons@google.es,Office Assistant IV,3031,1764,4795
44208,Garrott,Jeynes,gjeynest@intel.com,Web Designer II,4586,1480,6066
44605,Anthiathia,Hardiman,ahardimanu@bbb.org,Systems Administrator I,9885,1080,10965
44687,Valentino,Gillani,vgillaniv@lulu.com,Administrative Assistant III,4560,1612,6172
44968,Rosina,Camble,rcamblew@cafepress.com,Associate Professor,1490,287,1777
44239,Dorie,Shrigley,dshrigleyx@weebly.com,Database Administrator I,4584,775,5359
44608,Werner,Gildersleeve,wgildersleevey@w3.org,Web Developer III,5540,507,6047
44118,Gabey,Toffoletto,gtoffolettoz@themeforest.net,Marketing Manager,8457,1157,9614
44166,Mathilde,Aldiss,maldiss10@hud.gov,Business Systems Development Analyst,5467,1503,6970
44979,Brunhilde,Louys,blouys11@godaddy.com,Account Executive,7378,968,8346
44297,Hale,Yellowlees,hyellowlees12@jugem.jp,Paralegal,3750,286,4036
44882,Even,Agirre,eagirre13@gov.uk,Sales Associate,5447,835,6282
44460,Ceciley,Caro,ccaro14@weather.com,Environmental Specialist,4833,1731,6564
44778,Sallie,McGinn,smcginn15@chicagotribune.com,Sales Associate,8573,1311,9884
44816,Reynard,Maypother,rmaypother17@lulu.com,General Manager,1020,1800,2820
44417,Jarret,Chinnery,jchinnery18@diigo.com,Recruiter,1917,1991,3908
44577,Mortimer,Espine,mespine19@yellowbook.com,Cost Accountant,6343,1949,8292
44366,Giacinta,Craigmyle,gcraigmyle1a@t.co,Computer Systems Analyst I,8160,1756,9916
44352,Ravi,Boxhill,rboxhill1b@businessinsider.com,Food Chemist,5710,1249,6959
44345,Danie,Dow,ddow1c@creativecommons.org,Biostatistician I,4198,236,4434
44533,Thatcher,Fulloway,tfulloway1d@goo.ne.jp,Help Desk Operator,4235,264,4499
44361,Araldo,Claypool,aclaypool1e@ihg.com,Account Representative IV,5134,1490,6624
44388,Merridie,Fagence,mfagence1f@yellowbook.com,Speech Pathologist,5103,386,5489
44376,Tandy,Copping,tcopping1g@buzzfeed.com,Developer II,5469,565,6034
44535,Cherie,Lawfull,clawfull1h@imdb.com,Chief Design Engineer,5662,1559,7221
44155,Kelvin,Runchman,krunchman1i@imdb.com,Human Resources Assistant I,4014,1742,5756
44801,Suki,Garbutt,sgarbutt1j@fotki.com,Software Engineer III,1337,1060,2397
44843,Tobi,Bidwell,tbidwell1l@nydailynews.com,Programmer II,8544,1538,10082
44360,Zea,Bloxsom,zbloxsom1m@i2i.jp,Biostatistician IV,7912,608,8520
44554,Giovanna,Nelle,gnelle1n@ycombinator.com,Food Chemist,6034,1878,7912
44295,Nikoletta,Hardan,nhardan1o@senate.gov,VP Sales,7535,882,8417
44599,Cordelia,Tremoille,ctremoille1p@imgur.com,Junior Executive,5955,1564,7519
44644,Raffaello,Morville,rmorville1q@boston.com,Registered Nurse,4216,1976,6192
44420,Melissa,Peever,mpeever1r@loc.gov,Product Engineer,9472,1984,11456
44721,Renard,Cork,rcork1s@spiegel.de,Electrical Engineer,4584,388,4972
44281,Emory,Attrey,eattrey1t@163.com,Food Chemist,4611,597,5208
44723,Ilka,Birckmann,ibirckmann1u@amazonaws.com,Systems Administrator III,4351,1242,5593
44151,Adrienne,Rupke,arupke1v@soundcloud.com,Teacher,2511,1632,4143
44469,Lorant,Bakhrushkin,lbakhrushkin1w@constantcontact.com,Desktop Support Technician,8946,1688,10634
44246,Manon,Andrasch,mandrasch1x@w3.org,Nurse,6182,1582,7764
44111,Eric,Bunch,ebunch1y@wsj.com,Pharmacist,1674,832,2506
44074,Burl,Albasini,balbasini1z@soundcloud.com,Payment Adjustment Coordinator,4391,509,4900
44450,Holli,Jordanson,hjordanson20@fotki.com,Staff Scientist,7959,1008,8967
44698,Benedick,Markus,bmarkus22@blogger.com,Developer IV,1122,878,2000
44517,Lorne,Borzone,lborzone23@kickstarter.com,Senior Cost Accountant,6725,1256,7981
44641,Kiersten,De Cleyne,kdecleyne24@tumblr.com,Staff Accountant III,5820,973,6793
44121,Krissie,Grubb,kgrubb25@arizona.edu,Accountant III,4776,1177,5953
44941,Alfreda,Nayshe,anayshe26@slashdot.org,Information Systems Manager,7362,1833,9195
44216,Claudina,Ollet,collet27@un.org,Structural Analysis Engineer,3104,514,3618
44249,Kelsy,Dumblton,kdumblton28@sciencedirect.com,Safety Technician IV,5009,569,5578
44970,Lucian,McAneny,lmcaneny29@simplemachines.org,Assistant Media Planner,5041,1030,6071
44544,Bamby,Hinkley,bhinkley2a@omniture.com,Executive Secretary,4257,895,5152
44431,Pauly,Dickson,pdickson2b@liveinternet.ru,Chief Design Engineer,3442,216,3658
44685,Aleen,Walshaw,awalshaw2c@blogtalkradio.com,Assistant Media Planner,4432,1619,6051
44017,Loreen,Stanworth,lstanworth2d@google.nl,Senior Sales Associate,4608,1232,5840
44132,Gale,Winckle,gwinckle2e@behance.net,Help Desk Operator,9042,1106,10148
44210,Meg,Ivashkov,mivashkov2f@merriam-webster.com,Geologist II,7431,1757,9188
44413,Vin,Burl,vburl2g@unicef.org,Assistant Professor,8234,445,8679
44906,Jeralee,Pescott,jpescott2h@sohu.com,Senior Financial Analyst,7932,1302,9234
44836,Tamara,Lode,tlode2i@techcrunch.com,Assistant Manager,4230,1797,6027
44548,Shannen,MacGinley,smacginley2j@narod.ru,Nuclear Power Engineer,7329,314,7643
44064,Rici,Lanigan,rlanigan2l@360.cn,Software Engineer IV,3756,1710,5466
44770,Jacob,Terron,jterron2m@ifeng.com,Executive Secretary,1417,1545,2962
44402,Viola,Shoute,vshoute2o@trellian.com,Analog Circuit Design manager,2987,1569,4556
44441,Elissa,Davenhill,edavenhill2p@gravatar.com,Social Worker,3767,1485,5252
44825,Alexi,Myrick,amyrick2q@mashable.com,Executive Secretary,2033,1681,3714
44744,Lilas,Sheivels,lsheivels2r@ezinearticles.com,Budget/Accounting Analyst I,6079,975,7054
44319,Rudolf,Terrey,rterrey2s@wordpress.org,Account Coordinator,5386,656,6042
44230,Slade,Janusik,sjanusik2t@studiopress.com,Senior Quality Engineer,1084,1484,2568
44783,Vida,De la Feld,vdelafeld2u@rakuten.co.jp,Design Engineer,4788,483,5271
44543,Bartie,Warden,bwarden2v@google.pl,Operator,5328,1893,7221
44815,Merle,Beagley,mbeagley2w@google.cn,Developer II,8815,1594,10409
44321,Alaric,McDuffy,amcduffy2x@virginia.edu,Statistician I,4002,406,4408
44866,Willis,Gilloran,wgilloran2y@sun.com,Environmental Specialist,8020,1512,9532
44861,Obed,Haimes,ohaimes2z@go.com,Help Desk Operator,4863,1475,6338
44730,Elyn,Rycroft,erycroft30@istockphoto.com,Physical Therapy Assistant,2183,1679,3862
44287,Dennie,Krahl,dkrahl31@rediff.com,Administrative Officer,2753,1587,4340
44972,Melany,Geggus,mgeggus32@bigcartel.com,Payment Adjustment Coordinator,8357,745,9102
44586,Gaston,Pietraszek,gpietraszek33@chronoengine.com,Computer Systems Analyst II,1423,1015,2438
44065,Dulcine,Hamilton,dhamilton35@scientificamerican.com,Librarian,2814,1950,4764
44159,Fawnia,Munford,fmunford36@istockphoto.com,Research Assistant III,7163,1678,8841
44104,Wynny,Trewman,wtrewman37@livejournal.com,Structural Analysis Engineer,2650,1575,4225
44604,Karel,Handes,khandes38@tamu.edu,Account Executive,7219,1403,8622
44691,Masha,Hansberry,mhansberry39@dmoz.org,Food Chemist,8850,1331,10181
44415,Joy,MacCulloch,jmacculloch3a@meetup.com,Data Coordiator,4354,563,4917
44346,Shay,Bugdell,sbugdell3b@cpanel.net,Help Desk Operator,4076,1896,5972
44593,Garwood,Noton,gnoton3c@ameblo.jp,Quality Engineer,2921,1619,4540
44672,Sella,Yurshev,syurshev3d@g.co,Senior Editor,4234,908,5142
44838,Justin,Frigout,jfrigout3e@mapquest.com,Senior Editor,7589,1316,8905
44667,Rianon,Sancias,rsancias3f@networkadvertising.org,Quality Engineer,6362,284,6646
44461,Bary,Storton,bstorton3g@macromedia.com,Systems Administrator I,2885,1142,4027
44347,Reiko,Keyworth,rkeyworth3h@blogger.com,VP Quality Control,9389,1555,10944
44263,Emilio,Gamble,egamble3i@123-reg.co.uk,Analog Circuit Design manager,4240,369,4609
44635,Gaultiero,Ewart,gewart3j@tinyurl.com,Accountant II,6600,899,7499
44764,Gav,Gilvear,ggilvear3k@apache.org,Operator,9281,1326,10607
44028,Hall,Camus,hcamus3l@hao123.com,Compensation Analyst,1709,825,2534
44394,Vanda,Breazeall,vbreazeall3m@reference.com,Assistant Media Planner,4997,1927,6924
44993,Ignace,Glyssanne,iglyssanne3n@walmart.com,Nuclear Power Engineer,8636,1484,10120
44645,Bartlett,Owenson,bowenson3p@linkedin.com,Clinical Specialist,8268,1649,9917
44741,Ofella,Freeth,ofreeth3q@imgur.com,Senior Editor,9641,1549,11190
44131,Rufus,Wille,rwille3r@upenn.edu,Junior Executive,6826,743,7569
44282,Lanita,Armfirld,larmfirld3s@mediafire.com,Engineer II,7752,382,8134
44617,Collin,Esmond,cesmond3t@huffingtonpost.com,Chemical Engineer,7538,333,7871
44266,Ethelin,Wellsman,ewellsman3u@illinois.edu,Biostatistician III,8950,798,9748
44689,Gamaliel,Pratte,gpratte3v@acquirethisname.com,Registered Nurse,4248,1481,5729
44302,Ranna,Russam,rrussam3w@cyberchimps.com,Structural Analysis Engineer,5515,256,5771
44440,Lucho,Sigart,lsigart3x@gravatar.com,Safety Technician IV,5035,287,5322
44844,Sidoney,Resdale,sresdale3y@yale.edu,General Manager,9579,1047,10626
44969,Carolee,Jacobsen,cjacobsen3z@hc360.com,Research Nurse,2279,619,2898
44087,Worth,Bringloe,wbringloe40@springer.com,Civil Engineer,4177,299,4476
44137,Ninnette,Rigglesford,nrigglesford42@acquirethisname.com,Electrical Engineer,1520,1515,3035
44195,Hailey,Haye,hhaye43@stanford.edu,Registered Nurse,6661,1162,7823
44913,Tonya,Soigne,tsoigne44@parallels.com,Payment Adjustment Coordinator,3397,1865,5262
44251,Vinson,Doughartie,vdoughartie45@dailymail.co.uk,Desktop Support Technician,5349,1343,6692
44711,Susanetta,Bysshe,sbysshe46@tmall.com,Account Executive,1773,532,2305
44696,Kinny,George,kgeorge47@ft.com,Technical Writer,6962,1692,8654
44562,Crawford,Norkutt,cnorkutt48@pinterest.com,Research Associate,6091,1211,7302
44196,Connie,Hayford,chayford49@nyu.edu,Operator,3705,441,4146
44309,Roxi,Pietron,rpietron4b@csmonitor.com,Actuary,3305,1511,4816
44020,Kahlil,Mallia,kmallia4c@apple.com,Administrative Assistant III,3681,304,3985
44994,Loren,Ducastel,lducastel4d@disqus.com,Physical Therapy Assistant,8092,558,8650
44804,Doralin,Leblanc,dleblanc4e@mlb.com,Web Designer III,7942,1299,9241
44470,Melloney,Briars,mbriars4f@columbia.edu,Database Administrator III,9779,1619,11398
44018,Rockie,Martland,rmartland4h@wired.com,Developer IV,9649,278,9927
44449,Leigh,Solomonides,lsolomonides4i@studiopress.com,Junior Executive,5033,827,5860
44582,Thaxter,Di Bernardo,tdibernardo4j@aboutads.info,Nuclear Power Engineer,4000,1874,5874
44733,Philipa,Adkins,padkins4k@accuweather.com,Legal Assistant,4996,256,5252
44429,Dudley,Curado,dcurado4l@usgs.gov,Desktop Support Technician,9805,1533,11338
44284,Arturo,Giacubo,agiacubo4m@deliciousdays.com,Editor,4523,315,4838
44794,Corri,Dummigan,cdummigan4n@shinystat.com,Systems Administrator III,2295,599,2894
44761,Brittan,Creavan,bcreavan4o@odnoklassniki.ru,Community Outreach Specialist,6649,1187,7836
44749,Sabina,Whooley,swhooley4p@constantcontact.com,Quality Engineer,2222,1137,3359
44959,Pate,De Cleyne,pdecleyne4q@nih.gov,Operator,1638,1867,3505
44428,Everett,Depka,edepka4r@cbc.ca,Human Resources Assistant II,7944,1842,9786
44871,Paxton,Vella,pvella4s@rediff.com,Assistant Media Planner,7296,819,8115
44630,Elihu,Michelotti,emichelotti4t@google.com,VP Quality Control,3234,800,4034
44278,Corenda,Scamal,cscamal4u@unesco.org,Product Engineer,9984,1355,11339
44342,Tiphany,Butters,tbutters4v@shutterfly.com,Teacher,8082,1534,9616
44052,Tawnya,McIlroy,tmcilroy4w@npr.org,Registered Nurse,4448,753,5201
44454,Theodore,Ivanchenkov,tivanchenkov4x@earthlink.net,Accounting Assistant II,1394,1408,2802
44609,Jereme,Mawford,jmawford4y@chron.com,Computer Systems Analyst III,9234,995,10229
44662,Arabelle,Cousins,acousins4z@bbc.co.uk,Paralegal,4313,1958,6271
44671,Christin,Tunnah,ctunnah50@rediff.com,Administrative Assistant I,5244,358,5602
44400,Devora,Noton,dnoton51@w3.org,Environmental Specialist,8946,1992,10938
44444,Grethel,Scneider,gscneider52@tuttocitta.it,Administrative Assistant II,9512,450,9962
44875,Vaughn,Burden,vburden53@yelp.com,Sales Associate,4506,1767,6273
44040,Ed,Wegener,ewegener54@bing.com,Project Manager,3488,1900,5388
44653,Mitchel,Ollive,mollive55@github.io,Editor,3874,1296,5170
44364,Milli,Tellwright,mtellwright56@google.cn,VP Accounting,2950,1086,4036
44109,Will,Tudgay,wtudgay57@shutterfly.com,General Manager,5934,1607,7541
44153,Zaccaria,Popworth,zpopworth58@techcrunch.com,VP Sales,1603,699,2302
44768,Kerrie,Minget,kminget5a@dedecms.com,Assistant Professor,9517,496,10013
44202,Bobette,Beed,bbeed5b@jugem.jp,Nurse Practicioner,9286,804,10090
44663,Gratiana,Layson,glayson5c@gov.uk,Developer III,4234,328,4562
44091,Nicol,Lanham,nlanham5d@dagondesign.com,Senior Editor,6191,728,6919
44714,Dana,Lamborn,dlamborn5e@sciencedirect.com,Help Desk Technician,5747,703,6450
44884,Flo,Godlee,fgodlee5f@technorati.com,Junior Executive,2948,365,3313
44822,Carrissa,Nettle,cnettle5h@columbia.edu,Social Worker,2460,1952,4412
44256,Liam,Birkin,lbirkin5j@wufoo.com,Business Systems Development Analyst,5231,722,5953
44523,Willette,Daugherty,wdaugherty5k@hostgator.com,Staff Scientist,1526,1398,2924
44043,Nerissa,Lanphier,nlanphier5l@japanpost.jp,Environmental Specialist,3362,722,4084
44327,Zoe,Tunnick,ztunnick5m@facebook.com,Business Systems Development Analyst,1726,1696,3422
44350,Fergus,Lavielle,flavielle5n@google.com.hk,Editor,7528,259,7787
44918,Jordain,Stitcher,jstitcher5q@plala.or.jp,Database Administrator III,7226,666,7892
44557,Trista,Urion,turion5r@howstuffworks.com,Information Systems Manager,8767,1375,10142
44226,Wood,Saines,wsaines5s@adobe.com,Help Desk Technician,7087,1692,8779
44976,Eleni,Holleworth,eholleworth5t@reference.com,Electrical Engineer,6244,1581,7825
44296,Bartie,Leney,bleney5u@wiley.com,Software Test Engineer III,8065,897,8962
44901,Kermit,Dorey,kdorey5v@freewebs.com,Account Executive,1821,729,2550
44242,Jeno,Cothey,jcothey5w@wikipedia.org,Geological Engineer,2501,625,3126
44937,Janeta,Bartolomeoni,jbartolomeoni5x@shop-pro.jp,Chemical Engineer,4991,1269,6260
44699,Hephzibah,Akess,hakess5y@un.org,Pharmacist,5518,406,5924
44006,Stanwood,Siaskowski,ssiaskowski60@psu.edu,Sales Representative,8692,899,9591
44119,Noemi,Wrightham,nwrightham61@bizjournals.com,Sales Representative,7388,1833,9221
44403,Tadio,Angrock,tangrock62@dell.com,Compensation Analyst,6559,1518,8077
44818,Lefty,Harpham,lharpham63@virginia.edu,Assistant Professor,1504,847,2351
44788,Kassie,Basnett,kbasnett64@ucsd.edu,Nuclear Power Engineer,9691,1740,11431
44682,Dalis,Skeleton,dskeleton65@blogtalkradio.com,Human Resources Manager,3333,1959,5292
44640,Louisette,Drife,ldrife66@mlb.com,Data Coordiator,5385,1005,6390
44678,Nonnah,Piper,npiper68@mayoclinic.com,Systems Administrator III,5725,1832,7557
44055,Tilly,Leedal,tleedal69@slideshare.net,Recruiting Manager,6029,1732,7761
44405,Nevins,Sprankling,nsprankling6b@spotify.com,Administrative Assistant III,3861,1875,5736
44157,Christoph,Elsmore,celsmore6d@elpais.com,Structural Analysis Engineer,9187,1432,10619
44389,Dennet,Pietrzyk,dpietrzyk6e@t.co,Paralegal,5044,1498,6542
44700,Norene,Otterwell,notterwell6f@slashdot.org,Engineer II,8784,872,9656
44500,Jacqui,Illing,jilling6g@scribd.com,Senior Editor,9514,1367,10881
44621,Filbert,Lerner,flerner6h@oracle.com,Graphic Designer,2462,556,3018
44411,Woodman,Vatcher,wvatcher6i@t-online.de,Internal Auditor,3819,1598,5417
44375,Charlean,Malkinson,cmalkinson6j@harvard.edu,VP Product Management,6236,1722,7958
44885,Corene,Hartburn,chartburn6k@dedecms.com,Senior Editor,3501,742,4243
44305,Estevan,Corringham,ecorringham6l@army.mil,Civil Engineer,8603,814,9417
44078,Johnna,Berkery,jberkery6m@indiatimes.com,Accountant III,3154,731,3885
44827,Starr,Algeo,salgeo6o@cam.ac.uk,Assistant Media Planner,2342,1803,4145
44681,Salvador,Ducastel,sducastel6p@hexun.com,Nurse,9285,1654,10939
44869,Gerianna,Kohnemann,gkohnemann6q@ted.com,Senior Financial Analyst,6602,678,7280
44625,Ludovika,Gainseford,lgainseford6u@tmall.com,Speech Pathologist,6480,549,7029
44257,Melessa,Goldis,mgoldis6v@biglobe.ne.jp,Senior Quality Engineer,9150,997,10147
44611,Corby,Graben,cgraben6w@gizmodo.com,Information Systems Manager,1216,319,1535
44732,Binni,Roswarne,broswarne6x@berkeley.edu,Internal Auditor,5714,1336,7050
44207,Alberta,Kitcat,akitcat6y@so-net.ne.jp,Account Coordinator,4506,861,5367
44542,Annabela,McCarle,amccarle6z@harvard.edu,Systems Administrator IV,6029,1873,7902
44911,Jourdan,Blower,jblower70@hugedomains.com,Technical Writer,4256,255,4511
44915,Myra,Joselevitch,mjoselevitch71@i2i.jp,Statistician II,5517,640,6157
44552,Milicent,Carradice,mcarradice72@fotki.com,Dental Hygienist,9427,667,10094
44740,Keene,Werlock,kwerlock73@webmd.com,Programmer IV,1785,483,2268
44075,Kienan,Pearcehouse,kpearcehouse74@ebay.co.uk,Information Systems Manager,5319,1914,7233
44033,Feliza,Conningham,fconningham75@hibu.com,Geologist IV,9124,1747,10871
44180,Tomasina,Sylett,tsylett76@nationalgeographic.com,Civil Engineer,5767,1131,6898
44053,Benedikta,Nalder,bnalder78@barnesandnoble.com,Automation Specialist II,5247,489,5736
44105,Betti,Dallender,bdallender79@cornell.edu,Human Resources Assistant II,6378,1391,7769
44186,Jehu,Poulett,jpoulett7b@examiner.com,Marketing Assistant,4604,1063,5667
44556,Rosemonde,Broseman,rbroseman7c@homestead.com,Research Nurse,6928,843,7771
44066,Jarrad,Woolmore,jwoolmore7d@virginia.edu,Teacher,8552,1881,10433
44755,Monte,Cartmael,mcartmael7e@oracle.com,Biostatistician IV,2579,1445,4024
44890,Trumann,Whye,twhye7f@is.gd,Help Desk Operator,1038,893,1931
44158,Helena,Kohring,hkohring7g@utexas.edu,Executive Secretary,9288,700,9988
44709,Korrie,Gornall,kgornall7h@ycombinator.com,Executive Secretary,7388,1770,9158
44984,Buddy,Labon,blabon7i@zimbio.com,Developer III,2678,1135,3813
44320,Caroline,De Bernardi,cdebernardi7j@businessinsider.com,Paralegal,1854,689,2543
44169,Ingmar,Batten,ibatten7k@deliciousdays.com,Research Assistant IV,7687,1611,9298
44392,Joane,McNeilly,jmcneilly7l@sphinn.com,Analyst Programmer,4532,284,4816
44306,Perle,Benting,pbenting7n@networkadvertising.org,Technical Writer,1997,1129,3126
44814,Nester,Scotson,nscotson7o@seattletimes.com,Financial Analyst,6168,1240,7408
44850,Ashlen,Tidcombe,atidcombe7p@ask.com,Systems Administrator III,4155,1021,5176
44414,Genni,Poveleye,gpoveleye7q@google.com.au,Assistant Media Planner,8883,580,9463
44217,Carlie,Dellar,cdellar7r@youtu.be,Financial Advisor,2984,516,3500
44872,Maura,Schaumaker,mschaumaker7u@about.me,Research Nurse,6157,1201,7358
44265,Gare,Mertgen,gmertgen7v@redcross.org,Geologist IV,9616,1771,11387
44423,Coraline,Moneti,cmoneti7w@people.com.cn,Staff Scientist,4982,715,5697
44848,Farlie,Shevill,fshevill7x@cnn.com,Administrative Officer,9755,1042,10797
44737,Justina,Frail,jfrail7y@reference.com,Account Coordinator,2377,517,2894
44736,Feliks,Lehrahan,flehrahan7z@imgur.com,VP Product Management,1237,454,1691
44117,Port,Kleingrub,pkleingrub80@wordpress.com,Nurse,7990,1706,9696
44580,Garfield,Hollindale,ghollindale82@wired.com,Environmental Tech,7328,1697,9025
44923,Mireille,Cocke,mcocke83@harvard.edu,Social Worker,6044,1972,8016
44626,Ramsey,Longcaster,rlongcaster84@jiathis.com,Graphic Designer,2733,838,3571
45000,Beatrix,Risson,brisson85@yahoo.co.jp,Electrical Engineer,9515,1975,11490
44034,Gertrud,Childerhouse,gchilderhouse86@infoseek.co.jp,Staff Accountant IV,1954,1280,3234
44674,Johnath,Wapol,jwapol87@tinyurl.com,General Manager,7226,1270,8496
44607,Arlie,Cumine,acumine88@msu.edu,Safety Technician III,5661,1339,7000
44600,Ravi,Sliman,rsliman89@mozilla.com,Developer IV,4481,1952,6433
44425,Joyous,Lincke,jlincke8b@miibeian.gov.cn,Information Systems Manager,2301,492,2793
44780,Vasili,Sabine,vsabine8d@columbia.edu,Structural Analysis Engineer,2873,1554,4427
44902,Delmore,Basley,dbasley8f@usatoday.com,Software Consultant,8487,1647,10134
44606,Ephraim,Selvester,eselvester8h@163.com,Account Representative I,8874,576,9450
44935,George,McCallum,gmccallum8i@oakley.com,Analog Circuit Design manager,3775,985,4760
44926,Irina,Fenemore,ifenemore8j@harvard.edu,Operator,2859,627,3486
44160,Eddy,Praundlin,epraundlin8k@oakley.com,Graphic Designer,4806,1517,6323
44280,Lani,Boltwood,lboltwood8l@over-blog.com,Senior Editor,1510,1395,2905
44126,Linnie,Andover,landover8m@a8.net,Recruiting Manager,7077,1437,8514
44615,Stephannie,Hatchard,shatchard8o@paypal.com,Structural Analysis Engineer,3578,1158,4736
44409,Gian,Grolmann,ggrolmann8q@so-net.ne.jp,Safety Technician I,8443,731,9174
44610,Eba,Renak,erenak8r@reverbnation.com,Information Systems Manager,3787,874,4661
44336,Normy,Syme,nsyme8s@rediff.com,Geological Engineer,1395,1379,2774
44966,Selia,MacEntee,smacentee8t@cpanel.net,Assistant Manager,2797,606,3403
44920,Pepillo,Royan,proyan8v@rediff.com,Environmental Tech,8252,1502,9754
44855,Andrew,Turville,aturville8w@pen.io,Help Desk Technician,2308,615,2923
44383,Natal,Kaine,nkaine8x@pinterest.com,Analyst Programmer,2213,945,3158
44127,Gilda,Shortell,gshortell90@google.com.br,Tax Accountant,6219,1874,8093
44019,Estell,Babington,ebabington94@google.es,Software Test Engineer IV,9591,381,9972
44758,Denni,Tresise,dtresise95@merriam-webster.com,Actuary,4831,407,5238
44036,Alberik,Feighney,afeighney96@adobe.com,Analog Circuit Design manager,3109,858,3967
44813,Felecia,Leverson,fleverson97@weather.com,Product Engineer,3242,1718,4960
44283,Roxanne,Giottoi,rgiottoi98@ted.com,Nuclear Power Engineer,7639,1532,9171
44093,Free,Burfitt,fburfitt99@un.org,Analyst Programmer,2670,1819,4489
44776,Loralyn,Potes,lpotes9a@cnbc.com,Health Coach I,8757,1987,10744
44856,Kimberley,Sherwyn,ksherwyn9c@mlb.com,Associate Professor,4969,1379,6348
44849,Roberta,Leamon,rleamon9d@ning.com,Payment Adjustment Coordinator,1529,984,2513
44649,Park,Whylie,pwhylie9e@pbs.org,Research Assistant IV,2086,1995,4081
44059,Cheston,Pic,cpic9f@blogtalkradio.com,Account Coordinator,5483,471,5954
44807,Daria,Barthod,dbarthod9g@i2i.jp,Structural Engineer,3218,1839,5057
44267,Julee,Beaglehole,jbeaglehole9h@microsoft.com,Software Engineer IV,8929,1635,10564
44177,Louisette,Grieves,lgrieves9i@jalbum.net,Staff Accountant IV,5969,1933,7902
44618,Marie,Hazelton,mhazelton9j@answers.com,Staff Accountant IV,8295,1105,9400
44189,Trumann,Florence,tflorence9k@cornell.edu,Programmer II,4583,697,5280
44011,Dee dee,McCreedy,dmccreedy9l@cdbaby.com,Staff Scientist,1675,1937,3612
44536,Nichol,Stiven,nstiven9m@twitpic.com,Electrical Engineer,3432,829,4261
44240,Scarlett,Fortin,sfortin9o@nydailynews.com,Human Resources Manager,6247,1327,7574
44161,Hynda,Clitherow,hclitherow9p@ox.ac.uk,Account Executive,1038,1596,2634
44178,Bengt,Tolfrey,btolfrey9q@delicious.com,Office Assistant II,5807,1647,7454
44784,Derk,Helkin,dhelkin9r@businesswire.com,Dental Hygienist,4719,420,5139
44766,Jilli,Bloxland,jbloxland9t@hud.gov,Technical Writer,7917,1340,9257
44076,Cullie,Frarey,cfrarey9w@ovh.net,Staff Scientist,3226,1751,4977
44341,Jayme,Brickell,jbrickell9y@mashable.com,Accounting Assistant I,5840,1701,7541
44978,Salvidor,Sanday,ssanday9z@guardian.co.uk,Junior Executive,3144,1610,4754
44179,Darsie,Goatcher,dgoatchera0@senate.gov,Business Systems Development Analyst,8928,819,9747
44974,Adoree,Jefferies,ajefferiesa1@dedecms.com,Chemical Engineer,6619,1818,8437
44503,Elyn,Ganning,eganninga5@yellowbook.com,Technical Writer,5702,238,5940
44939,Garrek,Pfiffer,gpfiffera6@spotify.com,Occupational Therapist,7057,1400,8457
44735,Cedric,Milington,cmilingtona9@alibaba.com,Programmer Analyst II,3161,660,3821
44519,Sharia,Spall,sspallac@geocities.com,Marketing Manager,6402,1810,8212
44514,Stanwood,Gierok,sgierokad@delicious.com,Recruiter,4583,969,5552
44054,Doy,Newitt,dnewittaf@sun.com,Clinical Specialist,4594,1388,5982
44003,Cinnamon,Driffe,cdriffeah@alibaba.com,Librarian,5981,299,6280
44089,Afton,Kettlesting,akettlestingai@dropbox.com,General Manager,4229,1658,5887
44860,Pia,Carles,pcarlesaj@skyrock.com,Librarian,1308,975,2283
44506,Micki,Bardwell,mbardwellak@guardian.co.uk,Clinical Specialist,2886,1283,4169
44828,Renae,Spellessy,rspellessyal@phoca.cz,Nuclear Power Engineer,1630,1598,3228
44938,Torrie,Deshon,tdeshonan@nyu.edu,Payment Adjustment Coordinator,4881,1789,6670
44708,Angelika,Callacher,acallacherao@omniture.com,Product Engineer,4893,1733,6626
44276,Maitilde,Olwen,molwenap@dagondesign.com,Senior Quality Engineer,9333,901,10234
44193,Shana,Huitt,shuittat@seattletimes.com,VP Sales,1695,1525,3220
44373,Dilly,Taleworth,dtaleworthav@eepurl.com,Developer II,6113,1223,7336
44522,Merry,Olsen,molsenaw@stumbleupon.com,Design Engineer,5095,1376,6471
44185,Rubin,Merrill,rmerrillax@dot.gov,Biostatistician IV,3626,886,4512
44123,Gracie,Jukubczak,gjukubczakaz@nps.gov,Internal Auditor,8775,1492,10267
44174,Marlane,Redwing,mredwingb0@npr.org,Paralegal,8526,1500,10026
44453,Abram,Boord,aboordb1@who.int,Technical Writer,9050,322,9372
44067,Lorine,Atkinson,latkinsonb6@tinypic.com,Administrative Assistant IV,3251,255,3506
44565,Sidonnie,Gittens,sgittensb8@google.ru,Quality Control Specialist,9278,1180,10458
44569,Mari,Brunetti,mbrunettiba@boston.com,Human Resources Assistant II,9863,491,10354
44870,Corrie,Drohun,cdrohunbb@mozilla.com,Web Designer I,2836,632,3468
44570,Joanie,Longmuir,jlongmuirbd@pagesperso-orange.fr,Paralegal,8540,1056,9596
44636,Luigi,Fowden,lfowdenbe@upenn.edu,Clinical Specialist,8635,333,8968
44980,Duke,Woodyer,dwoodyerbf@tmall.com,Senior Sales Associate,3851,1747,5598
44102,Jacky,Swadon,jswadonbh@mapquest.com,Engineer II,4186,1044,5230
44568,Stephan,Secretan,ssecretanbi@ucoz.com,Office Assistant I,8121,1020,9141
44419,Edee,Long,elongbj@scribd.com,Occupational Therapist,4615,1118,5733
44763,Michail,Barlow,mbarlowbk@list-manage.com,Nurse,1808,961,2769
44002,Gustavo,Esposito,gespositobl@comsenz.com,Analog Circuit Design manager,4587,1006,5593
44252,Ruy,Aimer,raimerbp@mediafire.com,Registered Nurse,6561,241,6802
44069,Godfry,Avo,gavobq@wired.com,Quality Control Specialist,1477,1734,3211
44212,Aileen,Basilotta,abasilottabs@cdc.gov,Speech Pathologist,1803,1163,2966
44752,Bernadene,Etchingham,betchinghambu@hao123.com,Marketing Manager,8778,1887,10665
44005,Davidde,Tripony,dtriponybw@chronoengine.com,VP Accounting,1384,1933,3317
44031,Liza,Speed,lspeedby@gnu.org,Structural Engineer,2584,1208,3792
44271,Kimball,Tertre,ktertrec1@blogtalkradio.com,Help Desk Technician,2883,1916,4799
44595,Tracey,Horrod,thorrodc2@berkeley.edu,Nuclear Power Engineer,6153,1786,7939
44135,Gay,Gogerty,ggogertyc4@engadget.com,Project Manager,1905,1651,3556
44199,Giffie,Fulstow,gfulstowc5@globo.com,VP Quality Control,8778,1381,10159
44795,Lissa,Dawe,ldawec6@clickbank.net,Administrative Officer,9542,1152,10694
44841,Velvet,Harlock,vharlockc7@jalbum.net,Recruiter,6533,1682,8215
44895,Winni,Colnett,wcolnettc8@marketwatch.com,Actuary,4811,1100,5911
44097,Prentiss,Wallis,pwallisc9@newsvine.com,Statistician I,2682,933,3615
44103,Ryon,Fairleigh,rfairleighca@twitter.com,Registered Nurse,8075,503,8578
44921,Roxanna,Hackett,rhackettcb@boston.com,Cost Accountant,6976,1890,8866
44748,Erhart,Naismith,enaismithcc@pen.io,Recruiter,4339,708,5047
44932,Tomasine,Blumsom,tblumsomcd@mozilla.com,Research Associate,6166,870,7036
44332,Kelsi,Vedyashkin,kvedyashkincf@bloglines.com,Junior Executive,4949,1164,6113
44914,Goddard,Pauley,gpauleycg@nytimes.com,Recruiter,8791,1592,10383
44335,Claybourne,Schachter,cschachterch@intel.com,Developer IV,4235,842,5077
44944,Gil,Robotham,grobothamci@fc2.com,Senior Cost Accountant,1544,1082,2626
44358,Symon,Deny,sdenyck@berkeley.edu,Programmer Analyst III,1410,1375,2785
44713,Hebert,Fulks,hfulkscl@prnewswire.com,Nurse,8796,1712,10508
44896,Shannen,Petrowsky,spetrowskycm@ocn.ne.jp,Director of Sales,5848,1489,7337
44223,Franciska,Kondratovich,fkondratovichco@nytimes.com,Civil Engineer,4052,1219,5271
44391,Richardo,Bottom,rbottomcp@berkeley.edu,Nurse,2726,421,3147
44148,Goraud,Ondra,gondracq@jugem.jp,Editor,3117,1284,4401
44049,Krissie,Napper,knappercr@weather.com,Assistant Media Planner,8606,1783,10389
44237,Avril,Vinnick,avinnickcs@twitter.com,GIS Technical Architect,1235,472,1707
44114,Karleen,Dran,kdranct@t.co,Database Administrator II,3049,751,3800
44021,Maximilian,Veregan,mveregancu@wikispaces.com,Analyst Programmer,6910,1421,8331
44525,Darren,Biddlestone,dbiddlestonecv@amazon.com,Financial Analyst,6415,1985,8400
44777,Eadmund,Smalls,esmallscy@squarespace.com,Quality Control Specialist,5342,1869,7211
44298,Gunilla,Gilmore,ggilmored1@soup.io,Chief Design Engineer,7572,998,8570
44381,Phillipp,Camerana,pcameranad2@t.co,Account Coordinator,6939,1671,8610
44917,Towny,Ginner,tginnerd3@reuters.com,Assistant Manager,9523,1379,10902
44475,Zena,Gow,zgowd5@unesco.org,Health Coach I,3242,469,3711
44149,Isa,Andrichak,iandrichakd7@creativecommons.org,Junior Executive,3397,969,4366
44771,Caryl,Dailey,cdaileyd8@gov.uk,Editor,7803,1783,9586
44803,Haven,Skellern,hskellernd9@reuters.com,Professor,2449,612,3061
44292,Etta,Bullin,ebullindd@princeton.edu,Paralegal,5881,1016,6897
44563,Dorthea,Minget,dmingetde@lulu.com,Marketing Assistant,3276,1455,4731
44623,Micky,Gaskell,mgaskelldg@gizmodo.com,Internal Auditor,7201,1360,8561
44110,Dame,Saunders,dsaundersdh@bbb.org,Technical Writer,4126,410,4536
44378,Kelci,Yoseloff,kyoseloffdi@jugem.jp,Accounting Assistant I,1961,1750,3711
44241,Andros,Whittle,awhittledl@thetimes.co.uk,Business Systems Development Analyst,1718,741,2459
44385,Gabriell,Bourdas,gbourdasdm@mac.com,Account Coordinator,7949,211,8160
44688,Jimmy,Pennicard,jpennicarddn@guardian.co.uk,Staff Scientist,1857,1976,3833
44026,Faye,Humbey,fhumbeydp@shutterfly.com,Research Nurse,7971,1940,9911
44891,Keeley,Spolton,kspoltondr@taobao.com,Senior Quality Engineer,1484,935,2419
44406,Hill,Harnett,hharnettds@canalblog.com,Operator,7372,1793,9165
44900,Oby,Mundford,omundforddt@opera.com,Help Desk Operator,5222,971,6193
44261,Benny,Aggott,baggottdv@webs.com,Operator,4872,645,5517
44971,Mark,Crepin,mcrepindx@topsy.com,Desktop Support Technician,8830,1917,10747
44666,Helenelizabeth,Sherman,hshermandy@dailymotion.com,Internal Auditor,1008,458,1466
44107,Abbey,O'Sharkey,aosharkeye0@tumblr.com,Technical Writer,6852,1299,8151
44083,Ximenes,Pennigar,xpennigare2@networkadvertising.org,Budget/Accounting Analyst IV,3191,831,4022
44443,Riordan,Putt,rputte6@sbwire.com,Nurse Practicioner,9633,1804,11437
44362,Lorelle,Murdie,lmurdiee7@usgs.gov,Staff Accountant I,4136,1369,5505
44597,Arlee,Sterndale,asterndalee8@yellowpages.com,Social Worker,2238,955,3193
44312,Ringo,Finch,rfinchea@sphinn.com,Junior Executive,4501,1987,6488
44182,Brandi,Thomson,bthomsoneb@gnu.org,Database Administrator IV,6441,783,7224
44873,Shalom,Royans,sroyansec@skyrock.com,Environmental Tech,4123,332,4455
44016,Marisa,MacCarter,mmaccarteree@icio.us,Internal Auditor,9086,906,9992
44894,Beatrix,Marcussen,bmarcussenef@flickr.com,Assistant Media Planner,2900,1149,4049
44756,Korney,Mines,kmineseg@posterous.com,Staff Scientist,7993,1851,9844
44702,Ceil,Loughlin,cloughlineh@springer.com,Nurse,9961,738,10699
44956,Tori,Skynner,tskynnerej@theatlantic.com,Administrative Assistant IV,6084,1379,7463
44194,Marci,Syrad,msyradek@amazon.co.uk,VP Product Management,4342,875,5217
44481,Gayelord,Magowan,gmagowanem@hibu.com,Computer Systems Analyst IV,8469,1987,10456
44422,Odell,Scolts,oscoltseo@printfriendly.com,Payment Adjustment Coordinator,5574,741,6315
44407,Siffre,Giddons,sgiddonseq@angelfire.com,Technical Writer,6170,1037,7207
44243,Arvin,Sallery,asalleryes@fda.gov,Statistician II,9342,1706,11048
44579,Lynsey,Petrov,lpetroveu@ebay.co.uk,Administrative Officer,4334,1549,5883
44787,Lauren,Woodwind,lwoodwindev@imageshack.us,Geological Engineer,5116,228,5344
44285,Rodge,Allcoat,rallcoatf1@php.net,Librarian,6745,1092,7837
44359,Alaric,Di Claudio,adiclaudiof4@de.vu,Speech Pathologist,7374,1276,8650
44416,Barbe,Tubritt,btubrittf6@dyndns.org,Human Resources Assistant IV,3558,705,4263
44483,Moina,Cominetti,mcominettif9@reference.com,Analyst Programmer,9007,549,9556
44642,Myron,Peppin,mpeppinfb@squidoo.com,Senior Cost Accountant,6302,1708,8010
44883,Devan,Antoney,dantoneyfc@oakley.com,Recruiting Manager,3047,685,3732
44751,Alisander,Roalfe,aroalfefe@a8.net,Mechanical Systems Engineer,1277,1570,2847
44532,Fidelio,Station,fstationff@so-net.ne.jp,Software Test Engineer I,5016,1107,6123
44847,Federico,Kissock,fkissockfg@csmonitor.com,Occupational Therapist,4632,1442,6074
44589,Pia,Pither,ppitherfi@vistaprint.com,Graphic Designer,7120,1553,8673
44401,Gerhardine,Apple,gapplefj@t-online.de,Electrical Engineer,6791,292,7083
44986,Katheryn,Mangin,kmanginfk@parallels.com,Senior Cost Accountant,8689,1633,10322
44602,Shelagh,Ronan,sronanfl@hao123.com,Accounting Assistant III,8341,708,9049
44793,Madelina,Arch,marchfm@oakley.com,Programmer Analyst I,1793,730,2523
44587,Debi,Hallagan,dhallaganfp@economist.com,Senior Cost Accountant,2674,1526,4200
44192,Kelci,Baldacco,kbaldaccofw@blinklist.com,Senior Editor,3179,1263,4442
44907,Chaddy,Avrahamian,cavrahamianfx@addtoany.com,Associate Professor,2840,212,3052
44004,Gianni,Jorck,gjorckfz@pcworld.com,Financial Advisor,5969,906,6875
44096,Brandice,Matysik,bmatysikg0@com.com,Environmental Tech,5734,1121,6855
44975,Evy,Grandison,egrandisong1@mysql.com,Business Systems Development Analyst,2712,609,3321
44214,Dorette,Suart,dsuartg2@scientificamerican.com,Engineer II,4164,535,4699
44473,Claudianus,Willingam,cwillingamg3@senate.gov,Help Desk Technician,1804,1827,3631
44051,Aarika,Copner,acopnerg4@wired.com,Geologist II,5145,528,5673
44395,Zarah,Butt Gow,zbuttgowg7@latimes.com,Human Resources Assistant III,1696,209,1905
44293,Rubi,McCobb,rmccobbg8@pen.io,Tax Accountant,7231,1729,8960
44277,Katrine,Blueman,kbluemang9@baidu.com,Quality Engineer,9835,1782,11617
44219,Ingmar,Nore,inoregd@liveinternet.ru,Systems Administrator III,3996,1829,5825
44622,Hurleigh,Norbury,hnorburygf@t-online.de,Senior Editor,1467,587,2054
44333,Jewell,Valentin,jvalentingg@t-online.de,VP Accounting,9643,374,10017
44726,Minnaminnie,Heaven,mheavengh@youku.com,Help Desk Technician,9510,270,9780
44451,Raddie,Achurch,rachurchgj@wsj.com,Analog Circuit Design manager,2282,1226,3508
44204,Stanleigh,Dandy,sdandygm@printfriendly.com,Human Resources Manager,3165,1241,4406
44867,Rafe,Guys,rguysgo@jiathis.com,Nurse Practicioner,8283,548,8831
44079,Valli,Print,vprintgr@wikipedia.org,Assistant Manager,4755,469,5224
44200,Vanna,Seger,vsegergs@technorati.com,Professor,5212,918,6130
44558,Pauline,Trustrie,ptrustriegu@hibu.com,Research Nurse,5347,1373,6720
44904,Valentijn,Huckstepp,vhucksteppgw@weebly.com,Community Outreach Specialist,4710,1650,6360
44435,Alissa,Rhoddie,arhoddiegy@paginegialle.it,Director of Sales,9029,298,9327
44023,Kellen,Batalle,kbatalleh0@princeton.edu,Computer Systems Analyst II,3522,1441,4963
44220,Amity,Rallin,arallinh3@theatlantic.com,Quality Control Specialist,2208,318,2526
44513,Aldis,Edel,aedelh4@rambler.ru,Nurse Practicioner,7676,1289,8965
44082,Netti,Hoppner,nhoppnerh6@behance.net,Quality Control Specialist,4872,1000,5872
44260,Sibbie,Mattheis,smattheish7@nydailynews.com,Automation Specialist IV,1891,1997,3888
44887,Lauren,Hurrell,lhurrellh8@nasa.gov,Payment Adjustment Coordinator,8153,741,8894
44613,Rosanna,Scurrey,rscurreyh9@youtube.com,Actuary,4706,1971,6677
44620,Lennie,Osanne,losannehf@hud.gov,Pharmacist,9335,306,9641
44840,Katha,Pideon,kpideonhg@tmall.com,Financial Analyst,8580,382,8962
44612,Trude,Crotty,tcrottyhh@gizmodo.com,Junior Executive,7082,822,7904
44313,Bradly,Filoniere,bfilonierehk@techcrunch.com,Nurse,9376,1170,10546
44572,Rolland,Roskell,rroskellhm@ehow.com,Financial Advisor,9586,922,10508
44701,Luz,Trussell,ltrussellhp@hp.com,Director of Sales,9997,1159,11156
44229,Therine,Fosbraey,tfosbraeyhq@trellian.com,Environmental Specialist,5244,203,5447
44859,Petr,Brighty,pbrightyhs@yahoo.co.jp,Administrative Assistant II,1382,509,1891
44627,Jody,Glanders,jglandersht@is.gd,Environmental Specialist,2219,1618,3837
44704,Heall,Consterdine,hconsterdinehu@usgs.gov,Senior Quality Engineer,9073,1905,10978
44808,Randie,Machon,rmachonhv@zimbio.com,Account Executive,6377,1940,8317
44368,Levey,Henkens,lhenkenshw@amazon.de,Mechanical Systems Engineer,2226,1457,3683
44112,Rabbi,Devil,rdevilhx@alexa.com,VP Quality Control,6109,1254,7363
44198,Kendricks,Fullick,kfullicki5@whitehouse.gov,Desktop Support Technician,6534,1462,7996
44129,Ashla,Lakenton,alakentoni6@mit.edu,Pharmacist,5362,672,6034
44128,Terence,McGeneay,tmcgeneayi8@sitemeter.com,Community Outreach Specialist,8404,1472,9876
44262,George,Kemm,gkemmic@hibu.com,Assistant Professor,4816,1595,6411
44527,Phillipe,Dorber,pdorberif@comcast.net,Help Desk Technician,1363,546,1909
44964,Catharina,Najera,cnajeraig@ucsd.edu,Nurse Practicioner,8134,1735,9869
44289,Frederico,Perle,fperleii@printfriendly.com,Assistant Professor,1821,1448,3269
44965,Merrel,Daymont,mdaymontik@chicagotribune.com,Systems Administrator I,9414,1791,11205
44134,Rice,Dummer,rdummerim@cpanel.net,Tax Accountant,9156,743,9899
44232,Salaidh,Chanson,schansonip@bigcartel.com,Recruiter,2977,366,3343
44826,Emili,Petters,epettersiq@loc.gov,Quality Engineer,9428,607,10035
44684,Pepe,Hast,phastir@ucoz.com,Research Associate,7462,1283,8745
44377,Sissy,Redsell,sredsellis@hubpages.com,Senior Cost Accountant,4003,227,4230
44951,Sid,Lampens,slampensit@phoca.cz,Product Engineer,7535,267,7802
44062,Sterne,Leyshon,sleyshoniv@gizmodo.com,Occupational Therapist,8436,1895,10331
44494,Lennard,Louth,llouthix@paypal.com,Media Manager III,5876,1747,7623
44294,Padgett,Parnall,pparnalliy@creativecommons.org,Director of Sales,7682,1015,8697
44686,Hedy,Hounsham,hhounshamiz@huffingtonpost.com,Safety Technician IV,7508,503,8011
44459,Tara,Balnaves,tbalnavesj2@gizmodo.com,Account Representative II,3310,1105,4415
44864,Wallis,Abley,wableyj3@php.net,Administrative Assistant III,3036,887,3923
44936,Hanson,Heatlie,hheatliej6@qq.com,Programmer Analyst I,3138,1247,4385
44474,Cal,Danelutti,cdaneluttij7@nyu.edu,Budget/Accounting Analyst IV,9285,610,9895
44037,Francene,Rollo,frolloj8@bbb.org,Senior Financial Analyst,8717,1577,10294
44307,Bailey,Fike,bfikeja@sbwire.com,Geologist II,8764,453,9217
44316,Ingram,Loveredge,iloveredgejc@ed.gov,Administrative Officer,4794,858,5652
44598,Aldon,Drillingcourt,adrillingcourtjd@phoca.cz,Accountant III,9126,1523,10649
44661,Sadie,Vondrak,svondrakjg@disqus.com,Mechanical Systems Engineer,9737,1207,10944
44601,Tommie,Joinson,tjoinsonjk@reuters.com,Software Test Engineer II,9180,727,9907
44399,Kettie,Burdikin,kburdikinjm@noaa.gov,GIS Technical Architect,7897,1186,9083
44458,Hilde,Divine,hdivinejn@ezinearticles.com,Operator,1580,1353,2933
44588,Garfield,Vaun,gvaunjv@ehow.com,Help Desk Technician,4468,261,4729
44967,Alexandra,Zanneli,azannelijx@homestead.com,Account Executive,9759,1708,11467
44509,Thebault,Buchan,tbuchanjy@freewebs.com,Senior Sales Associate,7364,1458,8822
44655,Barbi,Floweth,bflowethjz@homestead.com,Pharmacist,6074,660,6734
44564,Gypsy,Grenshields,ggrenshieldsk2@cnbc.com,Help Desk Technician,6464,862,7326
44985,Maurice,Berryann,mberryannk3@cdc.gov,Structural Engineer,4444,638,5082
44541,Willi,Cuel,wcuelk4@biblegateway.com,Research Assistant I,8781,1184,9965
44760,Trever,Ridoutt,tridouttk5@creativecommons.org,GIS Technical Architect,8593,1971,10564
44227,Massimiliano,Totterdill,mtotterdillk7@wiley.com,Sales Associate,7935,375,8310
44301,Godfry,Johnstone,gjohnstonek8@devhub.com,Executive Secretary,9358,461,9819
44916,Trudey,Pahler,tpahlerk9@seattletimes.com,Community Outreach Specialist,4817,1155,5972
44779,Pamela,Josefs,pjosefskb@printfriendly.com,Design Engineer,4285,1832,6117
44888,Pammy,Danilovitch,pdanilovitchkc@fema.gov,Research Nurse,2801,1779,4580
44811,Hollie,Cettell,hcettellkd@dailymail.co.uk,Tax Accountant,8837,1483,10320
44852,Denice,Langcastle,dlangcastleke@wikimedia.org,Mechanical Systems Engineer,2537,1814,4351
44442,Georgiana,Keyser,gkeyserki@addtoany.com,Civil Engineer,1749,902,2651
44191,Malissa,Layborn,mlaybornkj@ed.gov,Senior Editor,5640,363,6003
44650,Barb,Reilingen,breilingenkk@cisco.com,Web Designer III,1017,362,1379
44665,Giusto,Hughill,ghughillkl@hexun.com,Community Outreach Specialist,2936,1137,4073
44404,Bambie,Tattersall,btattersallkp@jiathis.com,Business Systems Development Analyst,8182,677,8859
44654,Mufi,Lowton,mlowtonkq@newyorker.com,Paralegal,2244,1119,3363
44472,Adeline,O'Gready,aogreadyks@xinhuanet.com,Tax Accountant,4433,1037,5470
44058,Celinda,Callaway,ccallawaykv@devhub.com,Structural Analysis Engineer,4770,1176,5946
44484,Freeman,Flahive,fflahivekx@psu.edu,Recruiter,6581,1616,8197
44831,Dacy,Kiebes,dkiebesky@marketwatch.com,Recruiter,1262,591,1853
44138,Marena,Castel,mcastell2@webnode.com,Director of Sales,9356,1958,11314
44924,Maddie,Oganian,moganianla@ucla.edu,Chief Design Engineer,8882,1152,10034
44009,Yurik,Skelhorne,yskelhornelf@prlog.org,Sales Associate,2863,1548,4411
44270,Trey,Wilds,twildsli@lulu.com,Budget/Accounting Analyst IV,1625,640,2265
44710,Elmore,Pruvost,epruvostlj@wikispaces.com,Design Engineer,6364,686,7050
44529,Antony,Baddam,abaddamln@npr.org,Health Coach III,9660,1898,11558
44291,Kimmie,Dodwell,kdodwelllp@jugem.jp,Registered Nurse,8934,1032,9966
44566,Cobb,Raiston,craistonm0@printfriendly.com,Senior Cost Accountant,8111,215,8326
44480,Roddy,Burth,rburthm2@msu.edu,Quality Engineer,3393,1036,4429
44211,Gerta,Dalli,gdallim3@illinois.edu,Marketing Manager,5870,1850,7720
44553,Nedi,Fitzgerald,nfitzgeraldm4@i2i.jp,Software Consultant,9131,1657,10788
44846,Ericka,Chillistone,echillistonem6@drupal.org,Physical Therapy Assistant,1789,855,2644
44539,Carree,Arbuckle,carbucklem8@reddit.com,Chief Design Engineer,4859,1499,6358
44001,Wilone,Pinfold,wpinfoldme@mediafire.com,Senior Quality Engineer,1723,805,2528
44591,Berrie,Medendorp,bmedendorpmf@thetimes.co.uk,Office Assistant IV,4069,1399,5468
44507,Laurens,Curtain,lcurtainmk@cnbc.com,Technical Writer,2572,1058,3630
44960,Arline,Chrstine,achrstinemm@fastcompany.com,Information Systems Manager,8401,1928,10329
44652,Kirstin,Battelle,kbattellemn@bbc.co.uk,Data Coordiator,2245,1168,3413
44268,Gus,Sent,gsentmo@upenn.edu,Senior Developer,1230,1867,3097
44496,Winfred,Murford,wmurfordmp@linkedin.com,Occupational Therapist,9508,1430,10938
44382,Janeva,Jirasek,jjirasekmq@cdbaby.com,Recruiting Manager,1617,425,2042
44288,Lesley,Gonthier,lgonthiermr@intel.com,Human Resources Assistant I,9992,1110,11102
44156,Morgan,Scranny,mscrannymt@baidu.com,Electrical Engineer,8941,544,9485
44201,Dominga,Russell,drussellmu@netvibes.com,Sales Representative,6915,1695,8610
44209,Morse,Rosenstiel,mrosenstielmv@arstechnica.com,Developer I,3746,357,4103
44789,Florinda,Bragge,fbraggemw@studiopress.com,Technical Writer,7195,1777,8972
44410,Delphinia,Tetley,dtetleyn3@github.com,Marketing Assistant,2257,269,2526
44963,Marie,Sutch,msutchn6@kickstarter.com,Electrical Engineer,2609,520,3129
44466,Batholomew,Fleg,bflegn7@twitpic.com,Help Desk Operator,9678,1116,10794
44706,Trevar,Pierse,tpiersen9@quantcast.com,Web Developer I,1363,1955,3318
44658,Calvin,Cheeld,ccheeldna@elpais.com,Actuary,3835,1252,5087
44150,Antonia,MacKeeg,amackeegnb@hostgator.com,Director of Sales,8712,598,9310
44510,Staci,MacCaughey,smaccaugheynd@t.co,Social Worker,5781,1535,7316
44488,Carlina,Winterton,cwintertonng@webs.com,Database Administrator II,1369,1028,2397
44348,Craig,Hanscombe,chanscombeni@tripod.com,Web Developer IV,6394,1721,8115
44878,Claudine,Pereira,cpereiranj@ihg.com,VP Sales,4549,1040,5589
44168,Kimble,Duddy,kduddynm@theguardian.com,Executive Secretary,9927,1344,11271
44520,Larina,Gillfillan,lgillfillannp@tripod.com,Chief Design Engineer,8955,1112,10067
44068,Mattheus,Dresche,mdreschenr@weibo.com,Analog Circuit Design manager,3568,1616,5184
44908,Reyna,McPaik,rmcpaikns@goodreads.com,Analyst Programmer,8776,1606,10382
44344,Verile,Milam,vmilamnt@surveymonkey.com,Environmental Tech,4386,1552,5938
44487,Lorry,Roskell,lroskellnu@mozilla.com,Mechanical Systems Engineer,1676,1191,2867
44380,Ninon,Castilljo,ncastilljonv@vinaora.com,Staff Accountant III,8365,431,8796
44863,Pauletta,Smith,psmithnw@nbcnews.com,Assistant Professor,8100,1703,9803
44800,Kellen,Cranch,kcranchny@csmonitor.com,Automation Specialist IV,2556,1562,4118
44505,Arlana,Kail,akailnz@over-blog.com,Senior Quality Engineer,3927,333,4260
44471,Nolan,Bartlomieczak,nbartlomieczako1@123-reg.co.uk,Developer I,2927,1875,4802
44581,Carlina,Moral,cmoralo2@usgs.gov,Database Administrator I,1854,597,2451
44675,Gerri,O'Bradane,gobradaneo3@sina.com.cn,Payment Adjustment Coordinator,7062,1131,8193
44934,Kacie,McKernan,kmckernano5@umn.edu,Computer Systems Analyst II,7814,1633,9447
44790,Venus,Ducham,vduchamo7@squarespace.com,Web Designer IV,8873,428,9301
44647,Gavan,Hodges,ghodgesod@cdc.gov,Physical Therapy Assistant,2418,1624,4042
44042,Dorice,Joules,djoulesoe@about.com,Speech Pathologist,4225,1299,5524
44705,Sydney,Seabert,sseabertof@biblegateway.com,Account Executive,5267,1024,6291
44338,Raul,Knappen,rknappenon@wix.com,Financial Analyst,6640,1997,8637
44990,Dale,Teale,dtealeoo@ucoz.ru,Programmer II,6018,1768,7786
44781,Daffie,Aberkirdo,daberkirdoou@webs.com,Help Desk Operator,6579,944,7523
44098,Ado,Ferruzzi,aferruzziov@so-net.ne.jp,Graphic Designer,6706,625,7331
44707,Carie,Durdy,cdurdyow@nationalgeographic.com,Internal Auditor,8406,684,9090
44942,Gretel,Kinsey,gkinseyp3@comsenz.com,Research Associate,5111,630,5741
44853,Hilarius,Cearley,hcearleyp6@bluehost.com,Tax Accountant,9656,892,10548
44546,Mort,Forrington,mforringtonp7@csmonitor.com,Occupational Therapist,2841,1371,4212
44250,Pierre,Champley,pchampleypa@si.edu,GIS Technical Architect,7891,1487,9378
44559,Erda,Torri,etorripc@bing.com,Statistician I,4964,724,5688
44086,Jacki,Bengle,jbenglepd@ucoz.com,Staff Scientist,9900,1965,11865
44998,Laney,Messer,lmesserpe@twitter.com,Software Test Engineer II,3952,1799,5751
44943,Ceil,Cordery,ccorderypf@imgur.com,Food Chemist,4533,282,4815
44765,Arden,Bradlaugh,abradlaughpg@craigslist.org,Financial Advisor,9844,1647,11491
44354,Chrysler,Cucuzza,ccucuzzaph@technorati.com,Quality Engineer,1196,1152,2348
44183,Ardra,Garrow,agarrowpk@stumbleupon.com,Staff Accountant I,8933,1920,10853
44259,Eamon,Sandeson,esandesonpn@google.com.hk,Help Desk Operator,1920,1153,3073
44785,Terri,Clist,tclistpp@so-net.ne.jp,Structural Engineer,5293,419,5712
44324,Biddie,Bentsen,bbentsenpq@yandex.ru,Pharmacist,8237,486,8723
44172,Berky,Blowfield,bblowfieldps@narod.ru,Engineer III,7169,603,7772
44367,Harbert,Biddleston,hbiddlestonpv@un.org,Software Test Engineer II,9838,1383,11221
44664,Amby,Juschka,ajuschkapw@globo.com,Structural Analysis Engineer,6955,382,7337
44255,Shelly,Mattevi,smatteviq1@clickbank.net,Social Worker,8379,1006,9385
44190,Stephanie,Fogden,sfogdenq3@taobao.com,Mechanical Systems Engineer,3136,1434,4570
44774,Sig,Cansdell,scansdellq6@bbb.org,VP Accounting,1681,1908,3589
44221,Cacilie,Rops,cropsq9@sourceforge.net,Professor,7910,237,8147
44063,Velma,Deedes,vdeedesqb@nationalgeographic.com,Biostatistician I,1617,369,1986
44677,Shelden,Caff,scaffqh@imageshack.us,Systems Administrator I,2489,839,3328
44862,Evey,Djekic,edjekicqv@un.org,Engineer IV,8197,1780,9977
44072,Karissa,Sisey,ksiseyqx@smugmug.com,Sales Associate,9579,807,10386
44809,Robbert,Purbrick,rpurbrickr0@mlb.com,Human Resources Assistant IV,6314,1229,7543
44328,Shayna,Pendall,spendallr1@unc.edu,Internal Auditor,2807,1528,4335
44637,Sile,Trineman,strinemanr2@guardian.co.uk,Technical Writer,2908,505,3413
44143,Penni,Gritten,pgrittenr3@census.gov,Speech Pathologist,4388,1696,6084
44775,Linn,Yantsurev,lyantsurevr4@hc360.com,Financial Advisor,7929,1661,9590
44683,Lydie,Gyrgorwicx,lgyrgorwicxr6@nifty.com,Web Developer IV,7772,1401,9173
44660,Terrie,Rolin,trolinr9@blogtalkradio.com,Computer Systems Analyst I,8672,1589,10261
44258,Carma,Glenfield,cglenfieldra@aol.com,Teacher,2205,738,2943
44670,Nikolaus,Goncaves,ngoncavesrf@spotify.com,Assistant Professor,6798,943,7741
44387,Roxi,Eassom,reassomro@feedburner.com,GIS Technical Architect,2034,1414,3448
45530,Claire,Hasser,chasser0@archive.org,Business Systems Development Analyst,1788,1128,2916
45767,Rollie,Couser,rcouser1@imgur.com,Assistant Professor,9315,1283,10598
45664,Ned,Cremen,ncremen2@unc.edu,Programmer Analyst I,9786,1783,11569
45064,Chariot,Buttfield,cbuttfield3@who.int,VP Quality Control,5508,1571,7079
45382,Tobi,Bond,tbond4@1und1.de,Geologist II,8215,392,8607
45923,Jobyna,Brownfield,jbrownfield5@ycombinator.com,Sales Representative,2355,684,3039
45784,Isaac,Brikner,ibrikner6@booking.com,GIS Technical Architect,9269,779,10048
45579,Dolly,Gehricke,dgehricke7@com.com,Structural Analysis Engineer,5582,1477,7059
45482,Adiana,Fearenside,afearenside8@facebook.com,Computer Systems Analyst IV,9274,1572,10846
45471,Jacintha,Van De Cappelle,jvandecappelle9@techcrunch.com,Recruiting Manager,4428,609,5037
45389,Leora,Dougherty,ldoughertya@archive.org,Community Outreach Specialist,1684,1600,3284
45490,Catha,Balden,cbaldenb@chronoengine.com,Compensation Analyst,3401,451,3852
45146,Oralle,Jagiela,ojagielac@surveymonkey.com,Legal Assistant,2808,345,3153
45717,Skipton,Arnefield,sarnefieldd@goodreads.com,Assistant Manager,5144,1022,6166
45177,Gae,Havock,ghavocke@mapquest.com,General Manager,4029,862,4891
45564,Perrine,Roskelly,proskellyf@4shared.com,Account Representative II,8333,1122,9455
45595,Cassandra,Brimming,cbrimmingg@timesonline.co.uk,Librarian,7753,1358,9111
45642,Julissa,Tovey,jtoveyh@posterous.com,Help Desk Technician,7575,1914,9489
45112,Aurelie,Chilcotte,achilcottei@princeton.edu,Marketing Manager,8217,1955,10172
45539,Jose,Ringham,jringhamj@bluehost.com,Analyst Programmer,7238,1441,8679
45088,Arman,Hardiker,ahardikerk@gmpg.org,Community Outreach Specialist,8384,1011,9395
45235,Dillon,O'Howbane,dohowbanel@angelfire.com,Electrical Engineer,5303,774,6077
45215,Emmey,Blaksland,eblakslandm@washingtonpost.com,Executive Secretary,3484,1892,5376
45219,Denise,Bonallick,dbonallicko@columbia.edu,Software Engineer III,1662,1050,2712
45689,Tina,Knoble,tknoblep@zimbio.com,Physical Therapy Assistant,9687,948,10635
45039,Karlan,Barron,kbarronq@gravatar.com,Developer II,7218,1763,8981
45589,Klara,Michal,kmichalr@csmonitor.com,Business Systems Development Analyst,4457,1155,5612
45266,Evan,Lowndes,elowndess@1688.com,Environmental Tech,5846,1483,7329
45007,Vito,Bawcock,vbawcockt@mlb.com,Programmer I,5563,843,6406
45903,Beryle,Waberer,bwabereru@dell.com,Desktop Support Technician,3943,1217,5160
45013,Berget,Elverston,belverstonv@soundcloud.com,Physical Therapy Assistant,6284,1136,7420
45841,Tova,Trenear,ttrenearw@google.com.au,Desktop Support Technician,8369,738,9107
45565,Odey,Diter,oditerx@vimeo.com,Tax Accountant,6900,1051,7951
45037,Vittoria,Haigh,vhaighy@amazon.com,Payment Adjustment Coordinator,8917,737,9654
45176,Cal,Tirrey,ctirreyz@topsy.com,VP Sales,3660,1053,4713
45882,Missie,Kuscha,mkuscha10@paypal.com,Legal Assistant,8926,927,9853
45094,Jenni,Thirwell,jthirwell11@godaddy.com,Media Manager I,4801,708,5509
45036,Jacquie,Quirk,jquirk12@scribd.com,Speech Pathologist,4405,1441,5846
45762,Mora,Robbins,mrobbins13@usda.gov,Systems Administrator IV,9417,1336,10753
45295,Gordan,Prettejohns,gprettejohns14@sitemeter.com,Product Engineer,6258,625,6883
45629,Ezekiel,Snassell,esnassell15@vk.com,VP Marketing,5347,223,5570
45386,Lindsay,Ricards,lricards16@unblog.fr,Business Systems Development Analyst,3183,695,3878
45993,Ingeborg,Raymen,iraymen17@theguardian.com,Senior Editor,7686,1429,9115
45635,Danya,Heinzler,dheinzler18@tiny.cc,Account Coordinator,2159,1935,4094
45261,Oswell,Wyper,owyper19@google.com.hk,Software Consultant,3253,883,4136
45270,Deena,Barstowk,dbarstowk1a@freewebs.com,Health Coach II,7480,275,7755
45578,Jae,Glencross,jglencross1b@tumblr.com,Nurse Practicioner,1959,721,2680
45982,Mathe,Hymer,mhymer1d@utexas.edu,Clinical Specialist,2262,1755,4017
45108,Ogden,Beckinsale,obeckinsale1e@nymag.com,Information Systems Manager,9376,973,10349
45411,Marylin,Dax,mdax1f@cnet.com,Software Consultant,3209,857,4066
45625,Hasheem,Swabey,hswabey1g@stanford.edu,Editor,7321,203,7524
45756,Arlena,Tomicki,atomicki1h@homestead.com,Marketing Manager,5624,882,6506
45465,Jake,Akaster,jakaster1i@latimes.com,Media Manager IV,1709,338,2047
45567,Misty,Kenworthy,mkenworthy1j@cdc.gov,Payment Adjustment Coordinator,8201,1255,9456
45524,Consuela,Tuberfield,ctuberfield1k@mapy.cz,Design Engineer,1552,493,2045
45206,Terrill,Freeborne,tfreeborne1l@foxnews.com,Occupational Therapist,9696,228,9924
45488,Trace,Bromidge,tbromidge1m@nba.com,GIS Technical Architect,7098,954,8052
45133,Elbertina,Bosma,ebosma1n@gmpg.org,GIS Technical Architect,6483,1125,7608
45955,Mathe,Bikker,mbikker1o@slate.com,Financial Analyst,3019,1617,4636
45054,Joellyn,Biesterfeld,jbiesterfeld1p@loc.gov,Clinical Specialist,7144,1433,8577
45941,Rowney,Raubenheimer,rraubenheimer1q@spotify.com,Administrative Officer,3401,1207,4608
45540,Bax,Riteley,briteley1r@sbwire.com,Legal Assistant,3864,1734,5598
45790,Willyt,Mutton,wmutton1s@shinystat.com,Database Administrator II,2622,377,2999
45593,Kiah,Day,kday1t@dell.com,Civil Engineer,7332,639,7971
45292,Aryn,Hannaway,ahannaway1u@walmart.com,VP Accounting,6321,1795,8116
45142,Tonya,Sail,tsail1v@deliciousdays.com,Paralegal,1828,1582,3410
45823,Abby,Raffan,araffan1w@baidu.com,Automation Specialist III,6966,570,7536
45429,Blanche,Iffe,biffe1x@google.it,Senior Quality Engineer,2340,1887,4227
45301,Alleen,Hibbart,ahibbart1y@odnoklassniki.ru,Programmer III,4578,1954,6532
45230,Lyndy,Cicconettii,lcicconettii1z@unblog.fr,Product Engineer,5737,1279,7016
45718,Dolley,Venney,dvenney20@artisteer.com,Legal Assistant,7621,274,7895
45878,Marwin,Chardin,mchardin21@usa.gov,Business Systems Development Analyst,6765,1655,8420
45081,Lauraine,Skipperbottom,lskipperbottom22@hud.gov,Help Desk Technician,8213,1281,9494
45470,Fernande,Pearmain,fpearmain23@mit.edu,Librarian,6528,315,6843
45609,Curtice,Rissen,crissen24@nature.com,Sales Associate,7791,1102,8893
45391,Weber,Rosborough,wrosborough25@liveinternet.ru,Account Representative I,7965,1615,9580
45510,Loralie,Shellshear,lshellshear26@mozilla.com,VP Product Management,7639,685,8324
45455,Gavin,Bartosinski,gbartosinski27@amazon.com,Account Representative III,7865,1241,9106
45393,Danya,Gathwaite,dgathwaite29@ycombinator.com,Junior Executive,1500,288,1788
45378,Andree,Gobourn,agobourn2a@infoseek.co.jp,Operator,9382,765,10147
45992,Kevyn,Tippin,ktippin2c@abc.net.au,Professor,8675,1958,10633
45618,Nisse,Bysh,nbysh2d@elegantthemes.com,Product Engineer,3042,1558,4600
45457,Hillary,Vater,hvater2e@pinterest.com,Systems Administrator II,5099,638,5737
45862,Larine,Aburrow,laburrow2f@wunderground.com,Research Nurse,6903,1182,8085
45554,Marianne,Bernadzki,mbernadzki2g@youtube.com,Graphic Designer,1531,1792,3323
45154,Konstanze,Snellman,ksnellman2h@cnet.com,Quality Engineer,8589,924,9513
45963,Cosimo,Grafton-Herbert,cgraftonherbert2i@sogou.com,Chief Design Engineer,1962,371,2333
45426,Robina,Tincknell,rtincknell2j@indiatimes.com,Sales Representative,5485,1709,7194
45636,Archambault,Baynon,abaynon2k@toplist.cz,Director of Sales,4961,307,5268
45307,Catlin,Himsworth,chimsworth2l@google.com.au,Dental Hygienist,8694,263,8957
45607,Marline,Trussler,mtrussler2m@squarespace.com,Database Administrator III,3504,1563,5067
45574,Bertram,Noen,bnoen2n@shinystat.com,Safety Technician II,9624,632,10256
45250,Glyn,Pamment,gpamment2o@godaddy.com,Data Coordiator,3261,855,4116
45003,Bridie,Kilmartin,bkilmartin2p@cisco.com,Graphic Designer,2145,1695,3840
45404,Nathalie,Chapelhow,nchapelhow2r@japanpost.jp,Help Desk Technician,6177,551,6728
45431,Adriana,Oret,aoret2s@pcworld.com,Software Consultant,9284,978,10262
45638,Karalynn,Primrose,kprimrose2u@free.fr,Community Outreach Specialist,2253,1720,3973
45720,Orv,Kunzel,okunzel2v@mapy.cz,Assistant Professor,9566,217,9783
45240,Bernie,Willder,bwillder2w@independent.co.uk,Account Executive,9267,494,9761
45538,Berny,Van De Cappelle,bvandecappelle2x@mapquest.com,Financial Advisor,2348,1651,3999
45897,Yoshiko,Beauchamp,ybeauchamp2y@wikispaces.com,Chief Design Engineer,9067,253,9320
45302,Madella,Christophers,mchristophers2z@amazon.co.jp,Nuclear Power Engineer,1998,337,2335
45626,Sidney,Cutmore,scutmore30@cargocollective.com,Electrical Engineer,2996,1648,4644
45655,Godfree,Awcoate,gawcoate31@washingtonpost.com,Staff Scientist,5751,1458,7209
45364,Gavin,Candlish,gcandlish32@livejournal.com,VP Accounting,8481,991,9472
45519,Katerine,Stitwell,kstitwell33@friendfeed.com,Compensation Analyst,2192,841,3033
45257,Josie,Hubbis,jhubbis34@behance.net,Sales Associate,8922,648,9570
45581,Lester,Cansdale,lcansdale35@tinyurl.com,Assistant Manager,2745,1106,3851
45447,Katheryn,Hudspith,khudspith36@va.gov,Research Assistant III,8328,1767,10095
45773,Millisent,Sotham,msotham38@amazon.com,Community Outreach Specialist,6576,205,6781
45169,Tracy,Mardy,tmardy39@ibm.com,Electrical Engineer,3379,1871,5250
45617,Conny,Merdew,cmerdew3a@huffingtonpost.com,Marketing Manager,7816,274,8090
45329,Gerry,Kowalik,gkowalik3b@wikispaces.com,GIS Technical Architect,4581,1003,5584
45060,Roland,Noyce,rnoyce3c@liveinternet.ru,Senior Developer,2041,918,2959
45249,Thea,Blackey,tblackey3d@slideshare.net,Developer III,3577,918,4495
45259,Garner,Daniel,gdaniel3e@wiley.com,Mechanical Systems Engineer,8566,1874,10440
45398,Hart,Steagall,hsteagall3f@spotify.com,Paralegal,5425,1478,6903
45650,Gearalt,Lound,glound3g@barnesandnoble.com,Geological Engineer,7441,409,7850
45871,Eirena,Bantock,ebantock3h@sun.com,Actuary,8296,1623,9919
45692,Asher,Pigot,apigot3i@loc.gov,VP Marketing,4305,1244,5549
45463,Tabb,Horbath,thorbath3j@vinaora.com,General Manager,5154,1394,6548
45743,Saidee,Mathely,smathely3k@intel.com,Occupational Therapist,5245,614,5859
45812,Cheslie,Luetkemeyer,cluetkemeyer3l@rambler.ru,Statistician III,9414,1230,10644
45521,Kiele,Boden,kboden3m@buzzfeed.com,Dental Hygienist,2059,813,2872
45161,Christian,Poetz,cpoetz3o@dagondesign.com,Software Consultant,2898,1656,4554
45661,Aili,Layborn,alayborn3p@mapquest.com,Research Nurse,8582,805,9387
45273,Clayborne,Matchett,cmatchett3q@forbes.com,Staff Accountant III,3639,1259,4898
45252,Margit,Brandolini,mbrandolini3r@sitemeter.com,Technical Writer,3031,1663,4694
45403,Pietro,O'Deoran,podeoran3t@kickstarter.com,Editor,8647,1070,9717
45931,Philomena,Scripture,pscripture3u@icio.us,Web Developer II,5058,826,5884
45139,Erv,Stranahan,estranahan3v@unblog.fr,Human Resources Manager,2977,984,3961
45076,Enoch,Thorsby,ethorsby3x@dot.gov,Technical Writer,1804,1623,3427
45186,Tamera,Chatelet,tchatelet3z@dailymail.co.uk,Senior Developer,8747,317,9064
45299,Fanya,Hanbury-Brown,fhanburybrown40@youtube.com,Programmer IV,4543,596,5139
45951,Davie,Blackley,dblackley41@paginegialle.it,Pharmacist,3832,1348,5180
45840,Blithe,Legges,blegges43@vk.com,Help Desk Technician,8344,1593,9937
45065,Dona,Jerdein,djerdein44@acquirethisname.com,VP Marketing,5014,1824,6838
45014,Kori,Nelthorpe,knelthorpe48@wunderground.com,Data Coordiator,8575,588,9163
45458,Anders,Harrop,aharrop49@blogspot.com,Civil Engineer,7199,472,7671
45466,Astrix,Zapata,azapata4a@narod.ru,Marketing Manager,3205,1195,4400
45427,Dona,Piccop,dpiccop4b@ycombinator.com,Pharmacist,9808,1526,11334
45614,Bruno,Giordano,bgiordano4c@rediff.com,Payment Adjustment Coordinator,8149,602,8751
45895,Melony,Wraighte,mwraighte4e@harvard.edu,Administrative Officer,4488,1343,5831
45049,Henrietta,Kennet,hkennet4f@issuu.com,Environmental Tech,5990,1000,6990
45071,Perry,Measor,pmeasor4h@senate.gov,Developer III,9358,1941,11299
45074,Ottilie,Hackey,ohackey4i@1und1.de,Mechanical Systems Engineer,2683,1766,4449
45958,Dunstan,Scruton,dscruton4j@columbia.edu,Mechanical Systems Engineer,5793,870,6663
45504,Midge,Durrad,mdurrad4k@go.com,Analog Circuit Design manager,2084,1573,3657
45758,Zsa zsa,Catto,zcatto4l@mlb.com,Research Nurse,3322,1578,4900
45125,Conn,Westmarland,cwestmarland4m@dailymotion.com,Director of Sales,8536,343,8879
45549,Dorie,Keddle,dkeddle4n@wunderground.com,Quality Engineer,6248,224,6472
45583,Monika,Madden,mmadden4o@dot.gov,Programmer Analyst II,9373,1562,10935
45889,Kalie,Rudolfer,krudolfer4p@shareasale.com,Legal Assistant,8143,967,9110
45966,Sharl,Stent,sstent4r@netvibes.com,Senior Quality Engineer,4244,670,4914
45494,Ursala,Oke,uoke4s@time.com,Software Engineer IV,9113,242,9355
45884,Tobe,Billingham,tbillingham4v@mlb.com,Analog Circuit Design manager,7663,1686,9349
45628,Rolfe,Groundwator,rgroundwator4w@weather.com,Assistant Media Planner,2981,1484,4465
45532,Dunstan,Demanche,ddemanche4x@miibeian.gov.cn,Executive Secretary,5733,1866,7599
45155,Lilian,Annandale,lannandale4y@statcounter.com,Product Engineer,5018,668,5686
45315,Gustavo,Sivier,gsivier50@cbslocal.com,Human Resources Assistant I,9373,821,10194
45874,Marjory,Du Barry,mdubarry52@biblegateway.com,Speech Pathologist,4430,713,5143
45040,Penny,Gawkroge,pgawkroge53@plala.or.jp,Biostatistician II,2803,352,3155
45357,Reggie,Bromage,rbromage54@angelfire.com,Senior Cost Accountant,2137,1068,3205
45221,Myrna,Carbonell,mcarbonell55@posterous.com,Project Manager,7092,1980,9072
45243,Ailey,Janiszewski,ajaniszewski57@simplemachines.org,Marketing Manager,7770,1891,9661
45468,Josephina,Belasco,jbelasco58@51.la,Occupational Therapist,3082,1026,4108
45753,Lyda,Bootman,lbootman59@wordpress.com,Data Coordiator,9496,961,10457
45881,Vivianna,Vanichkov,vvanichkov5b@japanpost.jp,Staff Accountant II,5443,495,5938
45741,Richmond,Annice,rannice5c@tripadvisor.com,General Manager,6359,1104,7463
45900,Manya,Winsper,mwinsper5d@senate.gov,Registered Nurse,8291,994,9285
45127,Sutherland,McOwen,smcowen5e@moonfruit.com,Executive Secretary,9561,1717,11278
45533,Annabela,Pinyon,apinyon5f@gmpg.org,Nurse,9611,732,10343
45224,Delmar,Gamblin,dgamblin5g@netvibes.com,Senior Developer,9384,1789,11173
45906,Astra,Grose,agrose5h@yelp.com,Clinical Specialist,1785,1783,3568
45448,Jerrie,Keddey,jkeddey5j@cafepress.com,Chemical Engineer,8724,341,9065
45199,Egbert,Goodwell,egoodwell5m@histats.com,Senior Financial Analyst,8083,1974,10057
45264,Sigrid,Marzelli,smarzelli5n@godaddy.com,Technical Writer,5079,1791,6870
45184,Marcus,Cuthbert,mcuthbert5o@plala.or.jp,Accounting Assistant I,7601,1182,8783
45449,Erl,Capnor,ecapnor5p@google.fr,Structural Analysis Engineer,7972,1732,9704
45886,Beverly,Beesey,bbeesey5q@booking.com,Junior Executive,9016,362,9378
45352,Diego,Eye,deye5r@bbc.co.uk,Recruiting Manager,2968,1288,4256
45091,Trina,Breukelman,tbreukelman5s@gravatar.com,Senior Financial Analyst,7562,1058,8620
45834,Candace,Welband,cwelband5t@soundcloud.com,Data Coordiator,2030,1665,3695
45057,Gabi,Cadany,gcadany5u@123-reg.co.uk,Senior Financial Analyst,5540,1406,6946
45128,Hedvig,Elsmor,helsmor5v@cmu.edu,Internal Auditor,9831,1397,11228
45950,Ede,Harmour,eharmour5w@dell.com,Structural Engineer,4215,1875,6090
45813,Ally,Sowley,asowley5x@liveinternet.ru,Web Developer IV,3727,1700,5427
45608,Whit,Garbar,wgarbar60@foxnews.com,Human Resources Manager,8745,441,9186
45284,Amanda,Pound,apound61@admin.ch,Associate Professor,5967,404,6371
45481,Elwira,Gasnell,egasnell62@joomla.org,Executive Secretary,9619,820,10439
45723,Clemens,Caillou,ccaillou63@lycos.com,Senior Quality Engineer,5692,319,6011
45528,Joellen,Larrett,jlarrett65@ask.com,Health Coach II,4980,1418,6398
45902,Bernice,Tackle,btackle66@intel.com,Legal Assistant,2188,1070,3258
45749,Maurie,Bus,mbus68@umn.edu,Nurse,8811,446,9257
45164,Kimberli,Sillito,ksillito69@shop-pro.jp,General Manager,6082,839,6921
45728,Lari,Pache,lpache6a@godaddy.com,Recruiting Manager,6155,1539,7694
45338,Annamarie,Demare,ademare6b@cbslocal.com,GIS Technical Architect,5002,1766,6768
45703,Creighton,Cino,ccino6c@gmpg.org,Paralegal,3612,1647,5259
45682,Yoko,Schrei,yschrei6d@merriam-webster.com,Librarian,7356,494,7850
45327,Lanni,McCaughran,lmccaughran6e@tamu.edu,Quality Control Specialist,8503,1096,9599
45205,Lesly,Proby,lproby6g@dedecms.com,Actuary,2055,1989,4044
45500,Blancha,Hazlehurst,bhazlehurst6h@webs.com,Accountant II,6436,1098,7534
45192,Pandora,Cunradi,pcunradi6i@zimbio.com,Data Coordiator,4500,859,5359
45843,Gerta,Conklin,gconklin6j@pagesperso-orange.fr,Senior Sales Associate,7835,1880,9715
45967,Angy,Whittles,awhittles6k@google.com.br,Office Assistant I,5802,653,6455
45509,Alikee,Kearn,akearn6m@moonfruit.com,Budget/Accounting Analyst III,3382,832,4214
45779,Blakeley,Bonhan,bbonhan6n@sun.com,Legal Assistant,3598,1690,5288
45807,Laurens,McLorinan,lmclorinan6o@icq.com,Pharmacist,7473,1809,9282
45780,Eleonora,Styles,estyles6q@wisc.edu,Nurse Practicioner,1010,673,1683
45819,Gradeigh,Winspear,gwinspear6r@discovery.com,Chemical Engineer,5536,1796,7332
45090,Lilith,Prosser,lprosser6s@sogou.com,Accounting Assistant II,1716,1353,3069
45204,Dene,Josskoviz,djosskoviz6t@bing.com,Product Engineer,7237,1582,8819
45294,Craggy,Clogg,cclogg6u@photobucket.com,Paralegal,1996,1711,3707
45789,Krispin,Mapother,kmapother6w@tripadvisor.com,Director of Sales,4232,795,5027
45213,Tracie,Abramof,tabramof6y@salon.com,Teacher,6794,269,7063
45977,Meridith,Mawd,mmawd70@msn.com,Environmental Specialist,6820,1052,7872
45714,Gaby,Scade,gscade71@fotki.com,Civil Engineer,7849,797,8646
45435,Shela,Dabbes,sdabbes72@hatena.ne.jp,Research Associate,5496,582,6078
45527,Vivie,Klos,vklos74@google.fr,Engineer III,8426,1991,10417
45188,Patrice,Doughill,pdoughill76@dedecms.com,Web Designer I,9837,898,10735
45359,Chico,Thewless,cthewless77@vimeo.com,Human Resources Assistant III,5654,1779,7433
45590,Mag,Jakaway,mjakaway78@plala.or.jp,Financial Advisor,1037,948,1985
45606,Milo,Labitt,mlabitt79@sitemeter.com,Occupational Therapist,5027,1174,6201
45421,Othella,Lishman,olishman7a@senate.gov,Media Manager III,4528,673,5201
45280,Veda,Corker,vcorker7b@uiuc.edu,Business Systems Development Analyst,9046,522,9568
45824,Bernete,Skehens,bskehens7c@gmpg.org,Budget/Accounting Analyst III,1828,1034,2862
45742,Candra,Braham,cbraham7f@shutterfly.com,Nuclear Power Engineer,6070,1022,7092
45185,Stinky,Strathdee,sstrathdee7h@wikispaces.com,Administrative Assistant IV,8453,973,9426
45246,Heinrik,Winks,hwinks7i@sphinn.com,Software Test Engineer IV,8964,796,9760
45598,Audy,Dudenie,adudenie7j@yahoo.com,Safety Technician I,7993,428,8421
45855,Raine,Boshere,rboshere7k@uiuc.edu,Data Coordiator,1504,991,2495
45271,Linus,Leger,lleger7l@cocolog-nifty.com,Teacher,7809,917,8726
45195,Way,Arthars,warthars7m@prnewswire.com,Tax Accountant,3249,980,4229
45113,Enrichetta,Akester,eakester7o@telegraph.co.uk,VP Quality Control,3620,664,4284
45368,Lawrence,Kelwick,lkelwick7q@bbc.co.uk,Professor,1407,1483,2890
45237,Florentia,Van Leijs,fvanleijs7s@spiegel.de,Assistant Media Planner,8771,1139,9910
45737,Rosalynd,Hasloch,rhasloch7t@alexa.com,Operator,2751,1834,4585
45062,Cristina,Carlo,ccarlo7u@liveinternet.ru,Electrical Engineer,7922,1812,9734
45498,Kristin,Casaccia,kcasaccia7v@ed.gov,Media Manager II,4348,1673,6021
45656,Mariellen,Ellaman,mellaman7w@reverbnation.com,Recruiter,4261,311,4572
45383,Sandy,Showt,sshowt7x@istockphoto.com,Recruiter,4300,1668,5968
45343,Janenna,Vispo,jvispo7z@godaddy.com,Assistant Manager,2749,1276,4025
45811,Amy,Horsfield,ahorsfield80@google.fr,Engineer II,5022,1009,6031
45940,Travis,Bartoszewicz,tbartoszewicz81@twitpic.com,Administrative Officer,6426,493,6919
45676,La verne,Watford,lwatford82@discuz.net,Financial Advisor,8609,1108,9717
45759,Dawn,Studholme,dstudholme83@noaa.gov,Compensation Analyst,5748,1711,7459
45632,Ranee,Blaxter,rblaxter85@google.com.au,Staff Scientist,7060,1816,8876
45936,Barr,Salazar,bsalazar86@woothemes.com,Assistant Media Planner,6222,1848,8070
45442,Stafford,Swarbrigg,sswarbrigg87@twitter.com,Editor,5851,1814,7665
45026,Ashlee,Wooller,awooller8a@sohu.com,Software Engineer II,6539,441,6980
45124,Hurley,Bowstead,hbowstead8b@unblog.fr,Compensation Analyst,1566,898,2464
45621,Lambert,Pauly,lpauly8c@rakuten.co.jp,Senior Cost Accountant,3814,1552,5366
45648,Marthena,Borwick,mborwick8d@geocities.com,Senior Financial Analyst,1387,1163,2550
45002,Chantal,Michiel,cmichiel8e@hc360.com,Marketing Manager,2426,693,3119
45666,Sasha,Vanini,svanini8f@themeforest.net,Software Consultant,4981,1130,6111
45987,Daffi,Worrell,dworrell8h@nbcnews.com,Programmer I,1158,864,2022
45408,Bertina,Gautrey,bgautrey8i@vkontakte.ru,Tax Accountant,9960,418,10378
45588,Lamar,Harsant,lharsant8k@elpais.com,Librarian,5040,396,5436
45798,Erika,Gomez,egomez8l@theguardian.com,Speech Pathologist,3933,678,4611
45985,Emelita,Sapsford,esapsford8m@weebly.com,Developer III,9026,959,9985
45716,Georgia,Lifsey,glifsey8n@exblog.jp,Sales Representative,4844,576,5420
45869,Weider,Mowat,wmowat8o@artisteer.com,Clinical Specialist,2278,1155,3433
45126,Eolanda,Marriot,emarriot8q@hc360.com,Product Engineer,4749,868,5617
45484,Queenie,Sessuns,qsessuns8s@histats.com,Engineer I,3787,1365,5152
45791,Jada,Hamlin,jhamlin8t@cloudflare.com,Senior Financial Analyst,4498,1029,5527
45852,Thoma,Dryden,tdryden8x@ehow.com,Assistant Manager,9485,770,10255
45118,Sallie,MacNeely,smacneely8y@alibaba.com,Senior Editor,8532,300,8832
45141,Gillie,Chard,gchard8z@simplemachines.org,VP Marketing,7764,987,8751
45697,Nathanil,Lawles,nlawles90@oracle.com,Database Administrator III,2419,257,2676
45915,Law,Vogelein,lvogelein91@studiopress.com,Librarian,1514,377,1891
45658,Chip,de Keep,cdekeep92@home.pl,Geologist III,4400,1348,5748
45679,Leshia,Ohms,lohms93@fema.gov,Staff Scientist,8329,1702,10031
45405,Daren,Bowskill,dbowskill94@craigslist.org,Cost Accountant,6757,1139,7896
45265,Cornelia,Bosden,cbosden95@ibm.com,Sales Representative,4409,485,4894
45585,Kerwin,Boak,kboak97@fema.gov,Health Coach IV,6171,1563,7734
45021,Tim,Duke,tduke98@noaa.gov,Sales Associate,1067,1260,2327
45103,Nanine,Baldack,nbaldack99@wufoo.com,Sales Associate,5596,978,6574
45289,Letisha,Frain,lfrain9a@uiuc.edu,Analog Circuit Design manager,5053,1089,6142
45043,Emelia,McLarens,emclarens9b@hud.gov,Graphic Designer,2162,1692,3854
45120,Micky,Geraldo,mgeraldo9c@dmoz.org,Staff Scientist,1893,1398,3291
45573,Roderick,Gandrich,rgandrich9d@shutterfly.com,Operator,9748,370,10118
45450,Vevay,Salvidge,vsalvidge9e@eepurl.com,Senior Editor,7095,1198,8293
45492,Parke,Ritchard,pritchard9f@joomla.org,Sales Representative,1631,1572,3203
45799,Casie,Alleyn,calleyn9i@smh.com.au,Geologist II,6406,1717,8123
45555,Marilyn,Cromie,mcromie9k@go.com,Internal Auditor,1364,1613,2977
45415,Mil,Letch,mletch9l@ucoz.ru,Media Manager III,8025,581,8606
45693,Miles,Godmer,mgodmer9m@google.de,Dental Hygienist,2984,1491,4475
45149,Karlik,Bresner,kbresner9n@domainmarket.com,Senior Cost Accountant,1162,1407,2569
45400,Dean,Jamison,djamison9o@sourceforge.net,Senior Developer,5684,249,5933
45962,Rene,Ranahan,rranahan9p@icio.us,Media Manager III,4457,434,4891
45324,Meara,Bogges,mbogges9r@ucoz.ru,Nuclear Power Engineer,4720,1086,5806
45657,Aurora,Southerden,asoutherden9s@redcross.org,Account Executive,1734,1455,3189
45577,Missie,Fuchs,mfuchs9t@ehow.com,Health Coach II,8151,1986,10137
45805,Berkeley,Ralphs,bralphs9u@domainmarket.com,Technical Writer,9551,1967,11518
45547,Wanids,Mulvin,wmulvin9v@telegraph.co.uk,Assistant Media Planner,1618,1185,2803
45495,Damita,Stilling,dstilling9w@ustream.tv,Help Desk Technician,1220,927,2147
45456,Ruggiero,Axleby,raxleby9x@dion.ne.jp,Occupational Therapist,5958,1050,7008
45562,Caesar,Pascho,cpascho9y@instagram.com,Administrative Assistant III,6087,1082,7169
45925,Carlota,McLorinan,cmclorinan9z@auda.org.au,Editor,1492,1920,3412
45362,Penelopa,Dahlman,pdahlmana0@go.com,Environmental Tech,6413,1503,7916
45722,Carlos,Gatley,cgatleya1@stanford.edu,Developer II,1496,957,2453
45379,Raynor,Caws,rcawsa2@scribd.com,Senior Sales Associate,1957,519,2476
45503,Xaviera,Lazar,xlazara3@blog.com,Help Desk Technician,6857,869,7726
45952,Burgess,Cowhig,bcowhiga4@mac.com,Assistant Media Planner,4503,1155,5658
45319,Conway,Troppmann,ctroppmanna6@prnewswire.com,Accounting Assistant II,3929,911,4840
45830,Inez,Beaven,ibeavena7@uiuc.edu,Senior Developer,4532,1385,5917
45042,Skipp,Nickerson,snickersona8@vistaprint.com,Human Resources Assistant II,7263,1867,9130
45797,Donovan,Atherton,dathertona9@google.co.jp,Desktop Support Technician,9305,1894,11199
45675,Leicester,Tiron,ltironab@1688.com,Biostatistician III,4068,1089,5157
45474,Annadiane,Beddis,abeddisac@army.mil,Social Worker,2573,1880,4453
45101,Addy,Peake,apeakead@w3.org,Computer Systems Analyst III,9868,327,10195
45735,Engelbert,Gobbett,egobbettae@g.co,Software Consultant,6348,781,7129
45880,Waite,Vedyashkin,wvedyashkinaf@state.gov,Accountant II,4910,1440,6350
45706,Arley,Summerfield,asummerfieldag@reference.com,Speech Pathologist,4214,278,4492
45238,Shellie,Gratrix,sgratrixai@webeden.co.uk,Teacher,1464,700,2164
45068,Rhody,Thorius,rthoriusal@discovery.com,Senior Editor,5757,1462,7219
45939,Isador,Fairn,ifairnam@freewebs.com,Civil Engineer,8528,1221,9749
45278,Nancee,Malshinger,nmalshingerao@vk.com,VP Accounting,7208,1615,8823
45957,Stepha,Sherebrooke,ssherebrookeaq@mail.ru,Developer III,1575,1522,3097
45911,Patrica,Dominetti,pdominettiat@ehow.com,Clinical Specialist,8901,1805,10706
45473,Norene,Eble,nebleav@cdbaby.com,Research Assistant II,2380,334,2714
45253,Kirbie,Fears,kfearsay@microsoft.com,Research Nurse,7947,1795,9742
45627,Annora,Coad,acoadaz@si.edu,Quality Control Specialist,9409,1421,10830
45673,Tabor,Saulter,tsaulterb0@time.com,Biostatistician I,1179,550,1729
45887,Aubrey,Lycett,alycettb1@oracle.com,Compensation Analyst,5457,1740,7197
45646,Marlowe,Kalinsky,mkalinskyb2@facebook.com,Media Manager IV,5279,1105,6384
45093,Kimmi,Mahy,kmahyb3@vinaora.com,Human Resources Assistant II,5513,970,6483
45814,Alwin,Lundy,alundyb4@sitemeter.com,Financial Advisor,8252,483,8735
45461,Boycie,Baily,bbailyb5@cafepress.com,Librarian,7758,715,8473
45995,Lolita,Jeynes,ljeynesb6@sciencedaily.com,Pharmacist,4825,1148,5973
45668,Harvey,Kennedy,hkennedyb7@t-online.de,Programmer Analyst I,1661,1332,2993
45312,Hasty,Gothrup,hgothrupb8@washington.edu,Mechanical Systems Engineer,8970,1405,10375
45005,Maritsa,Ohms,mohmsba@indiatimes.com,Food Chemist,4527,1064,5591
45857,Deidre,Staten,dstatenbb@dell.com,Account Representative IV,8327,810,9137
45690,Deloria,Lohden,dlohdenbd@123-reg.co.uk,Programmer Analyst IV,2332,1434,3766
45122,Mela,Scarlett,mscarlettbe@shop-pro.jp,Programmer Analyst IV,9247,725,9972
45927,Kyrstin,Pietruszka,kpietruszkabh@squarespace.com,Senior Quality Engineer,7763,1416,9179
45469,Grantham,Purselowe,gpurselowebi@accuweather.com,Professor,9006,1696,10702
45631,Rutherford,Cambell,rcambellbk@163.com,Pharmacist,2855,904,3759
45483,Gaylene,Gumley,ggumleybl@bravesites.com,Senior Developer,4417,553,4970
45444,Torey,Aspy,taspybp@cnet.com,Financial Advisor,1596,408,2004
45247,Celinda,Janek,cjanekbr@webmd.com,VP Accounting,5707,2000,7707
45816,Cyndy,Lakeland,clakelandbs@ca.gov,Chemical Engineer,3589,1841,5430
45167,Giselle,Hansel,ghanselbw@desdev.cn,Statistician III,8272,501,8773
45499,Haven,Wansbury,hwansburybx@cdbaby.com,Editor,4073,1147,5220
45334,Willetta,Kesten,wkestenby@dailymail.co.uk,GIS Technical Architect,4059,1325,5384
45866,Rebe,Huton,rhutonbz@cdbaby.com,Geological Engineer,3613,1672,5285
45179,Juliann,Speed,jspeedc0@ifeng.com,Accountant III,4544,1894,6438
45390,Pearline,Vale,pvalec2@aol.com,Paralegal,8625,875,9500
45173,Brook,Widdall,bwiddallc4@nps.gov,Web Designer III,2390,1639,4029
45698,Kathye,Labat,klabatc5@springer.com,Food Chemist,8358,1529,9887
45116,Lynnette,Veal,lvealc6@oakley.com,Accounting Assistant I,2613,1769,4382
45321,Sarine,Fehely,sfehelyc7@imdb.com,Chemical Engineer,4624,1139,5763
45729,Monica,Hothersall,mhothersallc8@seattletimes.com,Health Coach II,1848,1859,3707
45052,Rayshell,Storrock,rstorrockc9@loc.gov,Structural Analysis Engineer,2496,494,2990
45460,Neile,Meakes,nmeakesca@mapy.cz,Analyst Programmer,3013,1125,4138
45864,Felipa,Outright,foutrightcb@seesaa.net,Accounting Assistant II,1388,858,2246
45045,Shay,Priestner,spriestnercc@sina.com.cn,VP Sales,4697,1406,6103
45792,Bobbe,McLellan,bmclellancd@fema.gov,Food Chemist,3097,1210,4307
45105,Maximilianus,Mairs,mmairsce@bloglovin.com,Analyst Programmer,2314,1285,3599
45158,Dal,Abrahamoff,dabrahamoffcg@hao123.com,Nurse Practicioner,3601,1911,5512
45067,Tobe,Richmont,trichmontch@mozilla.org,Nurse,9473,1845,11318
45851,Damon,Goodby,dgoodbyci@cyberchimps.com,Assistant Manager,8233,1697,9930
45913,Claybourne,Rawsthorne,crawsthornecj@freewebs.com,Community Outreach Specialist,2224,1024,3248
45764,Simonette,Waterdrinker,swaterdrinkerck@studiopress.com,Nurse Practicioner,9038,749,9787
45440,Warden,Belch,wbelchcl@netvibes.com,Administrative Assistant I,7981,1346,9327
45223,Elijah,Woodwind,ewoodwindcm@etsy.com,Graphic Designer,4308,1877,6185
45818,Fee,Forri,fforricp@ox.ac.uk,Programmer II,8853,1740,10593
45242,Corissa,Carek,ccarekcs@phoca.cz,Internal Auditor,7841,738,8579
45970,Dana,Duny,ddunyct@nih.gov,General Manager,3838,211,4049
45553,Tan,Wadley,twadleycu@trellian.com,Paralegal,3326,1056,4382
45875,Hendrika,Niesing,hniesingcv@zimbio.com,Dental Hygienist,7118,1557,8675
45016,Rosene,De Souza,rdesouzacw@narod.ru,GIS Technical Architect,2868,622,3490
45854,Hamid,Mewe,hmewecx@elpais.com,Registered Nurse,1416,1217,2633
45571,Roseline,Fulmen,rfulmencz@devhub.com,Clinical Specialist,9884,212,10096
45137,Graig,Kirton,gkirtond2@vkontakte.ru,Financial Advisor,4303,348,4651
45612,Dudley,Sargeaunt,dsargeauntd4@123-reg.co.uk,Paralegal,5924,814,6738
45150,Keely,Cano,kcanod6@cnbc.com,Assistant Manager,3774,851,4625
45303,Sherry,Collcott,scollcottdb@cmu.edu,Recruiter,7904,1934,9838
45502,Marget,Ausello,mausellodc@amazon.com,Sales Representative,8621,547,9168
45896,Rozalin,Bowditch,rbowditchdf@indiatimes.com,Statistician IV,1142,1161,2303
45838,Morry,Lockitt,mlockittdg@lycos.com,Budget/Accounting Analyst IV,9880,1037,10917
45557,Shae,Ogger,soggerdi@salon.com,Mechanical Systems Engineer,7508,1527,9035
45277,Kassey,Struthers,kstruthersdj@uiuc.edu,VP Marketing,5348,638,5986
45983,Pearl,Brixey,pbrixeydl@stanford.edu,Associate Professor,5763,206,5969
45416,Claudell,Farlowe,cfarlowedm@ebay.co.uk,Junior Executive,6376,1654,8030
45472,Kalie,Sodory,ksodorydn@geocities.jp,Quality Engineer,5871,1521,7392
45227,Jen,Lademann,jlademanndp@mozilla.com,Research Nurse,3366,1878,5244
45558,Meredithe,Dikels,mdikelsdq@harvard.edu,Assistant Media Planner,8583,1036,9619
45956,Zsazsa,Frobisher,zfrobisherdr@hc360.com,Account Representative III,8106,851,8957
45999,Maurits,Banbrick,mbanbrickdv@arstechnica.com,Senior Cost Accountant,5578,613,6191
45165,Carolan,Reaveley,creaveleydw@bbc.co.uk,Nuclear Power Engineer,2180,1796,3976
45932,Antonia,Luberti,alubertidy@ucoz.com,VP Sales,3798,1282,5080
45402,Celka,Housiaux,chousiauxe1@earthlink.net,Food Chemist,3499,1487,4986
45580,Georgy,Ruthen,gruthene4@toplist.cz,Analog Circuit Design manager,9386,1198,10584
45019,Claudio,Gommes,cgommese5@google.com,Assistant Manager,3021,1411,4432
45032,Tallou,Stopp,tstoppe6@ehow.com,Computer Systems Analyst I,5889,1028,6917
45877,Shalna,Crossby,scrossbye7@naver.com,Civil Engineer,7415,735,8150
45208,Margret,Erangy,merangye8@miibeian.gov.cn,Senior Sales Associate,2088,1111,3199
45374,Ofella,Hospital,ohospitale9@ning.com,Budget/Accounting Analyst IV,8418,1409,9827
45916,Biddy,Tilbrook,btilbrookea@youtube.com,Research Nurse,1664,247,1911
45654,Dorene,Mallion,dmallioned@netscape.com,Dental Hygienist,4587,1120,5707
45428,Brandy,Croson,bcrosonee@networksolutions.com,Legal Assistant,9716,1946,11662
45085,Nonie,Dodridge,ndodridgeef@wordpress.com,Assistant Manager,4764,297,5061
45525,Gisele,Wyne,gwyneeg@networkadvertising.org,Help Desk Operator,3884,528,4412
45131,Shelly,Fisk,sfiskej@virginia.edu,Research Associate,4615,1113,5728
45853,Jesus,Meriet,jmerietem@google.com.au,Legal Assistant,1687,1626,3313
45681,Jedidiah,Sherborne,jsherborneen@cnn.com,Food Chemist,8321,1662,9983
45420,Murielle,Pacher,mpachereo@moonfruit.com,Statistician II,5942,594,6536
45569,Robbie,Airs,rairseq@irs.gov,Nurse Practicioner,4491,1360,5851
45846,Ansell,Gierardi,agierardier@globo.com,VP Sales,3266,566,3832
45332,Lauri,Cowup,lcowupes@newyorker.com,Environmental Specialist,3707,673,4380
45867,Ada,Neesam,aneesamet@ucoz.ru,Recruiter,9523,1236,10759
45831,Mathilda,Anstie,manstieev@chron.com,Account Representative IV,4076,761,4837
45960,Nels,Hulett,nhulettew@bluehost.com,VP Product Management,8489,681,9170
45419,Carter,Horsewood,chorsewoodex@icq.com,Senior Cost Accountant,7029,854,7883
45745,Zachery,Brannan,zbrannanez@freewebs.com,Systems Administrator II,9079,1230,10309
45430,Emanuele,Glasscoo,eglasscoof0@ihg.com,Sales Representative,2075,1204,3279
45346,Ingra,Clue,icluef1@ning.com,Food Chemist,6919,1656,8575
45685,Maxine,Jirka,mjirkaf2@imgur.com,Research Assistant I,8959,731,9690
45258,Korry,Nunson,knunsonf3@scientificamerican.com,Recruiter,6770,1063,7833
45858,Jackquelin,Greenstreet,jgreenstreetf8@1688.com,Account Coordinator,3775,768,4543
45611,Allan,Mawditt,amawdittf9@arizona.edu,Technical Writer,4715,349,5064
45584,Clarisse,Larratt,clarrattfd@istockphoto.com,Legal Assistant,9514,214,9728
45919,Normy,Maloney,nmaloneyfe@answers.com,Marketing Manager,2843,1793,4636
45653,Josselyn,Pyne,jpyneff@marriott.com,Nuclear Power Engineer,6244,1179,7423
45063,Case,Bouch,cbouchfh@t.co,VP Product Management,3402,1899,5301
45800,Layne,Duchatel,lduchatelfi@godaddy.com,Accounting Assistant I,6965,297,7262
45751,Rice,Aisman,raismanfj@netscape.com,Mechanical Systems Engineer,9837,1934,11771
45910,Molly,Combes,mcombesfk@yale.edu,Occupational Therapist,9788,1214,11002
45947,Alyss,Rosier,arosierfl@chron.com,Graphic Designer,8221,364,8585
45845,Nancee,Gerling,ngerlingfo@aboutads.info,Electrical Engineer,8136,333,8469
45945,Johanna,McSweeney,jmcsweeneyfp@mapy.cz,Electrical Engineer,4598,1708,6306
45652,Mateo,Brayne,mbraynefq@harvard.edu,Human Resources Manager,5528,636,6164
45070,Cecelia,Fairleigh,cfairleighfr@wix.com,Senior Editor,2463,1136,3599
45059,Darell,Kobera,dkoberaft@mtv.com,Teacher,8715,1160,9875
45989,Tyson,Laven,tlavenfu@craigslist.org,Programmer Analyst I,7983,1115,9098
45601,Jamil,Ashworth,jashworthfx@oracle.com,Teacher,8719,605,9324
45412,Holmes,Pollitt,hpollittg0@msu.edu,Teacher,7115,1289,8404
45348,Caritta,Gunda,cgundag2@uol.com.br,Internal Auditor,5711,1247,6958
45058,Cleo,Stratiff,cstratiffg5@ocn.ne.jp,Media Manager IV,7777,947,8724
45515,Dody,Sloegrave,dsloegraveg6@buzzfeed.com,Paralegal,6180,271,6451
45298,Bartlet,Mickleburgh,bmickleburghg7@utexas.edu,Analog Circuit Design manager,5690,956,6646
45438,Heath,Reckus,hreckusg8@wp.com,Assistant Manager,6170,1024,7194
45337,Roarke,Cargo,rcargog9@stanford.edu,Design Engineer,7359,797,8156
45174,Ewart,Bonson,ebonsonge@newsvine.com,Web Designer I,5785,1364,7149
45417,Norry,Birrane,nbirranegf@ifeng.com,Software Consultant,4136,1334,5470
45996,Dusty,Huxtable,dhuxtablegi@51.la,General Manager,6557,1143,7700
45624,Base,Benfield,bbenfieldgo@wired.com,Marketing Assistant,6378,905,7283
45102,Mariejeanne,Smalman,msmalmangr@webmd.com,Dental Hygienist,9505,1378,10883
45424,Frederica,Dormand,fdormandgs@symantec.com,Environmental Specialist,5998,741,6739
45214,Jabez,Sneller,jsnellergt@mtv.com,Administrative Assistant IV,8383,1868,10251
45548,Anestassia,Courtenay,acourtenaygu@pbs.org,Speech Pathologist,8261,1176,9437
45464,Chrysa,McMonies,cmcmoniesgv@plala.or.jp,Structural Engineer,1897,1069,2966
45997,Shanon,McAllen,smcallengx@ovh.net,Cost Accountant,2203,996,3199
45371,Meade,Tume,mtumegy@discuz.net,Operator,6001,1672,7673
45445,Nathalia,Cawthery,ncawtherygz@wikipedia.org,Paralegal,9982,504,10486
45159,Gris,Van Arsdall,gvanarsdallh2@4shared.com,Financial Analyst,2577,625,3202
46000,Vilhelmina,Dobble,vdobbleh3@taobao.com,Accounting Assistant I,5066,1938,7004
45765,Cori,Luchelli,cluchellih5@cocolog-nifty.com,Developer IV,7260,812,8072
45485,Annmaria,Brierton,abriertonh6@icq.com,Structural Engineer,6093,1811,7904
45384,Daveen,O'Reilly,doreillyh7@zdnet.com,Staff Scientist,1014,1220,2234
45597,Jacquelynn,Sabatier,jsabatierh8@marriott.com,Staff Scientist,7829,823,8652
45437,Carree,Inett,cinettha@nifty.com,Social Worker,5345,1676,7021
45704,Shea,Windham,swindhamhd@seesaa.net,Operator,8692,463,9155
45245,Aristotle,Westberg,awestberghe@smugmug.com,Senior Developer,7607,1983,9590
45757,Bevvy,Varnals,bvarnalshf@pen.io,Health Coach II,4152,1242,5394
45496,Kata,Wilber,kwilberhg@flickr.com,Assistant Professor,2041,1682,3723
45282,Berti,Henbury,bhenburyhh@washington.edu,Environmental Specialist,2613,1019,3632
45433,Gilbert,Vanderplas,gvanderplashi@booking.com,Financial Advisor,8504,1279,9783
45822,Mortimer,Loughrey,mloughreyhj@myspace.com,Software Consultant,6597,235,6832
45392,Marita,Dellenbrok,mdellenbrokhl@uol.com.br,Junior Executive,5365,903,6268
45123,Reggi,Yetton,ryettonhm@slashdot.org,Dental Hygienist,9936,798,10734
45920,Oby,Antognoni,oantognoniho@opensource.org,VP Marketing,9676,1846,11522
45978,Saraann,Forsdyke,sforsdykehs@creativecommons.org,Editor,4639,1768,6407
45755,Darelle,Gormley,dgormleyht@washington.edu,Speech Pathologist,6221,1507,7728
45777,Cami,Anglin,canglinhu@bandcamp.com,Developer III,8931,1879,10810
45236,Freemon,Tweed,ftweedhv@yolasite.com,Mechanical Systems Engineer,9221,528,9749
45353,Seline,Surridge,ssurridgei0@netvibes.com,Sales Representative,9214,559,9773
45828,Dion,Sussex,dsussexi1@ning.com,Structural Analysis Engineer,9522,677,10199
45311,Editha,Parkhouse,eparkhousei2@sun.com,Software Consultant,3397,920,4317
45098,Tanhya,Gerok,tgeroki3@cbslocal.com,Office Assistant III,2531,984,3515
45316,Ashlin,Ferretti,aferrettii5@ft.com,Financial Analyst,7368,1885,9253
45781,Reider,MacAllaster,rmacallasteri6@slashdot.org,Community Outreach Specialist,1679,253,1932
45331,Austina,Brown,abrowni7@hc360.com,Paralegal,9779,1757,11536
45399,Kelci,Rantoull,krantoulli9@a8.net,Desktop Support Technician,3792,1259,5051
45370,Creighton,Gettins,cgettinsia@bizjournals.com,Editor,3539,568,4107
45027,Stephan,Hoys,shoysib@va.gov,Editor,2295,933,3228
45508,Ansel,MacKay,amackayid@ehow.com,Media Manager II,7453,1218,8671
45761,Grover,De Micoli,gdemicoliie@amazon.co.uk,Pharmacist,8392,1185,9577
45622,Darbie,Buncher,dbuncherif@pbs.org,Accounting Assistant II,1448,1838,3286
45217,Ramsay,Wybern,rwybernig@google.co.jp,Data Coordiator,5207,432,5639
45713,Emmeline,Pretsell,epretsellih@de.vu,Environmental Specialist,8735,817,9552
45836,Priscilla,Colborn,pcolbornij@guardian.co.uk,Human Resources Assistant III,1232,1163,2395
45050,Trisha,Lundie,tlundieio@cargocollective.com,Operator,1470,740,2210
45344,Zackariah,MacCurley,zmaccurleyip@addtoany.com,Marketing Assistant,4477,1255,5732
45491,Melitta,Ranson,mransonir@hud.gov,Social Worker,4856,1277,6133
45439,Domini,Klimentyonok,dklimentyonokiu@cdc.gov,VP Sales,9661,1120,10781
45366,Lucy,Tidcomb,ltidcombiv@wix.com,Administrative Assistant I,7285,231,7516
45285,Toiboid,Rowthorne,trowthorneiw@state.tx.us,Internal Auditor,9339,213,9552
45637,Alethea,Aslin,aaslinix@bloomberg.com,Analog Circuit Design manager,4807,570,5377
45641,Mirabelle,O'Lagen,molageniy@cornell.edu,Mechanical Systems Engineer,1211,1676,2887
45926,Cheslie,Shipston,cshipstoniz@bizjournals.com,VP Accounting,6430,636,7066
45220,Klarrisa,Briggdale,kbriggdalej0@utexas.edu,Legal Assistant,9832,1892,11724
45175,Mano,Real,mrealj1@meetup.com,VP Sales,3951,1987,5938
45256,Vanda,Ferdinand,vferdinandj7@unblog.fr,Nuclear Power Engineer,1493,378,1871
45644,Danyette,Gipson,dgipsonj8@skyrock.com,Food Chemist,8899,1457,10356
45536,Padraig,Lewer,plewerj9@dmoz.org,Analog Circuit Design manager,8381,1921,10302
45100,Adlai,Jaffra,ajaffraja@prweb.com,Budget/Accounting Analyst III,1025,271,1296
45209,Millicent,Bracco,mbraccojb@washington.edu,Quality Engineer,6996,350,7346
45111,Rasia,Leipelt,rleipeltjd@army.mil,Structural Analysis Engineer,8542,957,9499
45381,Ravid,Wondraschek,rwondraschekjh@discovery.com,Quality Control Specialist,2081,235,2316
45535,Toma,Mann,tmannjk@cargocollective.com,Engineer II,1209,1259,2468
45699,Paola,Cooch,pcoochjl@yahoo.com,Programmer IV,7708,983,8691
45746,Flss,Lytton,flyttonjm@china.com.cn,Junior Executive,8874,716,9590
45168,Patrick,Condie,pcondiejn@addthis.com,Technical Writer,9396,1066,10462
45870,Donnamarie,Quimby,dquimbyjo@lycos.com,VP Accounting,6512,1043,7555
45072,Rafael,Scranney,rscranneyjp@omniture.com,Chemical Engineer,9439,1546,10985
45406,Dalli,Aburrow,daburrowjr@so-net.ne.jp,Research Nurse,8943,1116,10059
45084,Brunhilde,Gherardelli,bgherardellijs@go.com,Database Administrator III,4737,1196,5933
45700,Cicily,Wrightim,cwrightimjv@huffingtonpost.com,Statistician IV,5744,1371,7115
45349,Indira,Greswell,igreswelljx@hatena.ne.jp,Web Designer I,9717,1938,11655
45038,Augie,Winscum,awinscumk1@flickr.com,Office Assistant III,9500,1149,10649
45203,Cleavland,Paal,cpaalk2@virginia.edu,Biostatistician III,7241,1618,8859
45802,Junina,Cusworth,jcusworthk4@networkadvertising.org,Safety Technician IV,5867,527,6394
45894,Delainey,Clift,dcliftk6@wikipedia.org,Social Worker,7502,1152,8654
45163,Pier,Welldrake,pwelldrakeka@blogs.com,Operator,6172,354,6526
45451,Halsy,Dracksford,hdracksfordkb@mediafire.com,Software Consultant,9222,1451,10673
45969,Oby,Halsho,ohalshokd@xrea.com,VP Marketing,2299,1427,3726
45868,Junette,Huffey,jhuffeykh@pinterest.com,Administrative Officer,5654,1492,7146
45275,Anastasia,Gavozzi,agavozzikk@mapquest.com,Internal Auditor,1919,935,2854
45912,Timothy,Zisneros,tzisneroskm@tinyurl.com,Accountant III,2263,412,2675
45719,Vale,Crickmore,vcrickmorekn@weather.com,Legal Assistant,9793,1755,11548
45134,Charline,Wooland,cwoolandko@java.com,Administrative Officer,8134,1010,9144
45826,Octavius,Bouldstridge,obouldstridgekp@nbcnews.com,Account Coordinator,5857,1065,6922
45207,Philomena,Crosgrove,pcrosgrovekr@senate.gov,Biostatistician III,8943,256,9199
45701,Mauricio,Flemming,mflemmingku@ow.ly,Structural Engineer,3995,1160,5155
45475,Hoebart,Borrington,hborringtonl0@unesco.org,Desktop Support Technician,6958,1804,8762
45634,Fiann,Cecere,fcecerel1@springer.com,Financial Analyst,8444,564,9008
45772,Wat,Tunnacliffe,wtunnacliffel3@vimeo.com,Legal Assistant,9348,1537,10885
45769,Darlene,Maxfield,dmaxfieldl4@economist.com,Physical Therapy Assistant,5669,851,6520
45024,Elke,Leadbetter,eleadbetterl7@oaic.gov.au,Nurse Practicioner,9556,486,10042
45080,Hersh,Suthworth,hsuthworthl9@rambler.ru,GIS Technical Architect,9574,1148,10722
45651,Elmo,Heintsch,eheintschlb@geocities.jp,Speech Pathologist,6777,1343,8120
45949,Garrik,McCullough,gmcculloughlh@omniture.com,Structural Engineer,9529,217,9746
45778,Marybelle,Lansbury,mlansburylk@spiegel.de,Health Coach III,9501,1807,11308
45850,Pammie,Schooley,pschooleylm@weather.com,Research Associate,5754,1941,7695
45775,Alvinia,Bamfield,abamfieldln@e-recht24.de,Sales Representative,8660,1164,9824
45948,Val,Studdard,vstuddardlq@wufoo.com,GIS Technical Architect,9336,418,9754
45973,Tamera,Irvin,tirvinls@arstechnica.com,Information Systems Manager,2425,334,2759
45008,Clemmy,Hackleton,chackletonlu@deliciousdays.com,Administrative Officer,9946,346,10292
45561,Isadore,Cristoferi,icristoferilv@1688.com,Registered Nurse,7571,893,8464
45212,Geri,Brambley,gbrambleyly@bloomberg.com,Librarian,4643,988,5631
45754,Elspeth,Scardifeild,escardifeildm0@delicious.com,Chemical Engineer,8178,1692,9870
45794,Marigold,Surmeir,msurmeirm1@usatoday.com,Design Engineer,6683,785,7468
45860,Carney,Chaise,cchaisem3@fotki.com,GIS Technical Architect,2051,1622,3673
45817,Modestia,Haggerty,mhaggertym5@businessweek.com,Chemical Engineer,6843,1707,8550
45891,Gris,Smyley,gsmyleym6@privacy.gov.au,Staff Scientist,7443,1620,9063
45914,Sheena,Durie,sduriem8@sfgate.com,Research Assistant I,7626,863,8489
45001,Tisha,Juris,tjurisma@bloglovin.com,Quality Engineer,5311,1080,6391
45876,Hobie,Crucetti,hcrucettimb@youtube.com,Actuary,7225,1453,8678
45397,Whit,Kohring,wkohringmf@nhs.uk,General Manager,3237,1549,4786
45715,Scotty,Lowthian,slowthianmg@tuttocitta.it,VP Quality Control,8459,1529,9988
45961,Hunt,Sayles,hsaylesmh@constantcontact.com,Research Assistant IV,4043,832,4875
45423,Fleur,Zavattari,fzavattarimi@stanford.edu,Nurse,5326,1479,6805
45550,Lila,Patriche,lpatricheml@weebly.com,Nurse,6555,1912,8467
45394,Gerhardt,Glasman,gglasmanmm@networkadvertising.org,Administrative Officer,4955,1557,6512
45774,Estele,Brettelle,ebrettellemn@webs.com,Database Administrator II,2295,1362,3657
45988,Homer,Ianni,hiannimp@plala.or.jp,Structural Engineer,7943,1347,9290
45972,Ferrell,Minnis,fminnismr@elegantthemes.com,Librarian,1028,1230,2258
45254,Luciano,Radleigh,lradleighms@slideshare.net,Project Manager,7348,923,8271
45833,Marie-ann,Layborn,mlaybornmu@webmd.com,Sales Associate,3670,1435,5105
45572,Towney,Sambedge,tsambedgemv@reference.com,Nurse Practicioner,8253,1943,10196
45599,Tobias,Duffie,tduffiemw@jimdo.com,Financial Analyst,3044,878,3922
45066,Selestina,Deeprose,sdeeprosemy@simplemachines.org,GIS Technical Architect,2850,1944,4794
45954,Sharyl,Farahar,sfaraharn2@bravesites.com,Executive Secretary,8640,326,8966
45201,Esmeralda,Webland,eweblandn3@wisc.edu,Human Resources Assistant III,9406,1044,10450
45132,Ottilie,Erangy,oerangync@nbcnews.com,Design Engineer,8855,802,9657
45930,Fransisco,Audenis,faudenisnd@tuttocitta.it,Speech Pathologist,9399,1915,11314
45216,Kandace,Greenfield,kgreenfieldne@gov.uk,Marketing Manager,5531,1306,6837
45358,Britt,Arundale,barundalenf@furl.net,Executive Secretary,5452,787,6239
45556,Dehlia,Rolingson,drolingsonni@theglobeandmail.com,Help Desk Technician,2210,438,2648
45677,Amos,Luscombe,aluscombenk@google.com.au,Financial Analyst,1187,1332,2519
45994,Gaye,Heck,ghecknm@pen.io,Legal Assistant,7781,1510,9291
45680,Moise,Willets,mwilletsnn@amazon.co.uk,Chemical Engineer,8741,1715,10456
45710,Derby,Buchanan,dbuchanannp@fastcompany.com,Engineer II,9806,391,10197
45600,Melisse,Zanneli,mzannelinq@about.com,Speech Pathologist,1935,1292,3227
45356,Iolande,Robinett,irobinettnr@cornell.edu,Media Manager II,8568,1031,9599
45596,Jewelle,Cool,jcoolnu@barnesandnoble.com,Office Assistant II,9472,1342,10814
45908,Vassili,Giggie,vgiggienv@tumblr.com,Accounting Assistant IV,5033,1002,6035
45998,Amos,Kensy,akensynx@quantcast.com,Safety Technician IV,6707,343,7050
45529,Agnella,Windmill,awindmillny@harvard.edu,Software Engineer I,3050,217,3267
45968,Maye,De Dei,mdedeio0@redcross.org,Clinical Specialist,4136,1558,5694
45901,Aubrette,Laing,alaingo7@nhs.uk,Food Chemist,4513,1593,6106
45304,Tobie,Knotton,tknottonod@istockphoto.com,General Manager,1025,1494,2519
45144,Kristina,Ondrak,kondrakog@printfriendly.com,Programmer III,4537,608,5145
45022,Liza,Bunyard,lbunyardok@walmart.com,Quality Control Specialist,9866,756,10622
45313,Myrilla,Baszniak,mbaszniakom@cmu.edu,Administrative Assistant I,9091,1036,10127
45422,Essie,Izard,eizardoq@ameblo.jp,Research Nurse,1062,988,2050
45434,Niall,Froude,nfroudeor@who.int,Budget/Accounting Analyst I,6058,571,6629
45012,Gerrard,Walford,gwalfordou@hao123.com,Marketing Assistant,4080,419,4499
45568,Siegfried,Whiteway,swhitewayow@sakura.ne.jp,Administrative Officer,7889,693,8582
45051,Quincy,Orrett,qorrettox@bandcamp.com,Sales Associate,3216,1499,4715
45380,Ber,Petrowsky,bpetrowskyp0@networksolutions.com,Speech Pathologist,9891,1260,11151
45712,Emlynne,O'Sirin,eosirinp1@tamu.edu,Senior Editor,6533,1761,8294
45129,Henry,Forgie,hforgiep2@reddit.com,Geologist I,1805,1884,3689
45361,Esmaria,Hargie,ehargiep5@dot.gov,Engineer II,4184,841,5025
45136,Guss,Warlock,gwarlockp7@cbsnews.com,Software Test Engineer I,5032,828,5860
45079,Hanan,Muggach,hmuggachp9@go.com,Food Chemist,5522,1576,7098
45396,Gloriane,Audas,gaudaspd@cpanel.net,Financial Analyst,8488,237,8725
45570,Tamarah,Byrne,tbyrnepe@blogtalkradio.com,Systems Administrator IV,5259,558,5817
45153,Joceline,Suarez,jsuarezpf@ehow.com,Senior Cost Accountant,5905,1755,7660
45046,Rockie,Heinel,rheinelpi@ovh.net,Structural Analysis Engineer,7522,1693,9215
45401,Sonny,Hayler,shaylerpj@opensource.org,Associate Professor,3584,1470,5054
45842,Donnie,Sutterby,dsutterbypl@oakley.com,Quality Control Specialist,2122,818,2940
45372,Shaylynn,Falla,sfallapp@comsenz.com,Account Executive,9832,775,10607
45721,Mariann,Klimkin,mklimkinps@about.com,Programmer Analyst III,8171,1813,9984
45513,Roselia,Rhelton,rrheltonpu@printfriendly.com,General Manager,7112,1900,9012
45768,Lonee,Shimmin,lshimminpw@wikimedia.org,Senior Financial Analyst,7652,1095,8747
45922,Ruy,Faldoe,rfaldoepy@dedecms.com,Human Resources Assistant I,6644,1220,7864
45189,Eda,Woolway,ewoolwayq0@hud.gov,Geologist IV,6342,935,7277
45233,Wylie,Stilldale,wstilldaleq1@imgur.com,Actuary,8359,664,9023
45260,Murial,Batterton,mbattertonq7@blogspot.com,Nurse,4933,1251,6184
45143,Lisa,Bellin,lbellinqb@businessweek.com,Physical Therapy Assistant,2998,209,3207
45376,Eddi,Meanwell,emeanwellqe@wp.com,Administrative Assistant II,3854,479,4333
45097,Pamella,Seniour,pseniourqf@smh.com.au,Actuary,3832,1573,5405
45695,Ortensia,Gruby,ogrubyqk@nytimes.com,Marketing Assistant,8263,651,8914
45929,Malanie,Purches,mpurchesqn@comcast.net,Web Developer I,2524,1875,4399
45687,Etienne,Gowanson,egowansonqv@tamu.edu,Web Designer II,7267,1178,8445
45034,Violet,Ferrieres,vferrieresqw@ehow.com,Internal Auditor,7328,606,7934
45928,Jack,Shapter,jshapterqy@163.com,Operator,6004,1870,7874
45077,Horten,Larwood,hlarwoodqz@pagesperso-orange.fr,Nurse,3458,1625,5083
45633,Niki,Gerardi,ngerardir1@dell.com,Assistant Manager,9629,872,10501
45117,Moritz,Masterman,mmastermanr3@telegraph.co.uk,Registered Nurse,7330,1414,8744
45592,Charmian,Stockell,cstockellr4@joomla.org,Biostatistician II,8089,1458,9547
45890,Tana,Palmby,tpalmbyr6@businessweek.com,Geologist II,8688,688,9376
45480,Nerte,Mavin,nmavinr7@symantec.com,Food Chemist,7159,939,8098
45546,Doloritas,Doogue,ddooguer8@tuttocitta.it,Developer I,9998,562,10560
45801,Lyndsay,Andrick,landrickr9@mozilla.org,Staff Scientist,6305,706,7011
45335,Rolland,O'Hdirscoll,rohdirscollra@123-reg.co.uk,Financial Analyst,9316,663,9979
45322,Petrina,Dowsey,pdowseyrc@wikimedia.org,Automation Specialist IV,7381,878,8259
45771,Dixie,Tyers,dtyersrf@sciencedaily.com,Associate Professor,8587,1260,9847
45694,Rudolph,Skeemor,rskeemorrg@soundcloud.com,Business Systems Development Analyst,1718,1984,3702
45156,Phylys,Cunnane,pcunnanerk@google.com.hk,Accountant I,2794,1660,4454
45244,Danni,Yablsley,dyablsleyrm@hatena.ne.jp,Geological Engineer,9472,1110,10582
45796,Norry,Takos,ntakosrn@archive.org,Social Worker,1490,1974,3464
45006,Gayle,Fatscher,gfatscherrq@photobucket.com,Accountant III,3268,1457,4725
46852,Gisella,Hauxby,ghauxby0@sourceforge.net,Developer I,4605,767,5372
46413,Quinn,Zanitti,qzanitti1@pinterest.com,Geologist III,3104,1099,4203
46897,Parry,Loney,ploney2@answers.com,Automation Specialist IV,8559,1544,10103
46585,Xena,Culverhouse,xculverhouse3@un.org,GIS Technical Architect,1022,1009,2031
46531,Ursola,Tupling,utupling4@bizjournals.com,Registered Nurse,6082,312,6394
46991,Tabby,Leall,tleall5@ucla.edu,Teacher,3853,1997,5850
46648,Prentice,Orrill,porrill6@ask.com,Paralegal,4846,476,5322
46660,Haley,Kubis,hkubis7@gizmodo.com,Pharmacist,9416,1081,10497
46537,Emily,Lawrance,elawrance8@marriott.com,Occupational Therapist,3721,881,4602
46883,Clemens,Drews,cdrews9@springer.com,Sales Associate,9558,1778,11336
46188,Ira,Copyn,icopyna@naver.com,Safety Technician III,5819,925,6744
46286,Clem,Dorr,cdorrb@netlog.com,Director of Sales,2806,666,3472
46137,Franz,Angrave,fangravec@topsy.com,Financial Advisor,9170,874,10044
46100,Tate,Renard,trenardd@networksolutions.com,Structural Engineer,8023,430,8453
46039,Mariya,Trippett,mtrippette@independent.co.uk,Registered Nurse,8496,1066,9562
46667,Shirl,Kloster,sklosterf@nydailynews.com,Geological Engineer,9036,367,9403
46690,Bevon,Pedgrift,bpedgriftg@wikipedia.org,Technical Writer,6829,274,7103
46697,Eudora,Webby,ewebbyi@ucoz.com,VP Product Management,8097,747,8844
46695,Imogen,Watterson,iwattersonj@linkedin.com,Internal Auditor,6960,210,7170
46051,Marjory,Gilders,mgildersk@fotki.com,Staff Accountant III,3129,670,3799
46047,Sallyann,Grason,sgrasonl@rambler.ru,Assistant Manager,7398,1734,9132
46877,Dallas,Hambatch,dhambatchm@sun.com,Automation Specialist I,8502,519,9021
46633,Golda,Bollen,gbollenn@mac.com,Payment Adjustment Coordinator,6843,1095,7938
46685,Aluin,Riddett,ariddetto@gnu.org,Web Designer II,8195,722,8917
46922,Agosto,Strute,astrutep@umich.edu,Actuary,1422,1776,3198
46259,Camel,Keston,ckestonq@dagondesign.com,Sales Representative,1438,1342,2780
46520,Eberto,Bergin,eberginr@squidoo.com,Information Systems Manager,8257,1541,9798
46415,Kate,Cotty,kcottys@amazonaws.com,Account Executive,2156,1878,4034
46263,Amii,Bergeau,abergeaut@topsy.com,Budget/Accounting Analyst III,3209,958,4167
46019,Dallas,Hacket,dhacketu@about.me,Nuclear Power Engineer,1215,548,1763
46407,Rachele,Peacocke,rpeacockev@chicagotribune.com,Quality Control Specialist,2300,894,3194
46793,Alexis,Imason,aimasonw@nhs.uk,Graphic Designer,4475,1157,5632
46935,Jobyna,Goldsbury,jgoldsburyx@wix.com,Occupational Therapist,1024,307,1331
46369,Yvette,McMechan,ymcmechany@nsw.gov.au,Research Nurse,6044,898,6942
46297,Ludvig,Pichan,lpichanz@chronoengine.com,Quality Control Specialist,9044,1725,10769
46230,Juieta,Bousquet,jbousquet10@cbc.ca,Software Test Engineer II,4513,742,5255
46387,Freddie,Fray,ffray11@sogou.com,Financial Advisor,4741,409,5150
46871,Parrnell,McFarland,pmcfarland12@w3.org,Systems Administrator III,2239,1870,4109
46831,Shauna,Wannan,swannan13@howstuffworks.com,Recruiting Manager,5921,652,6573
46091,Dulce,Gosswell,dgosswell14@example.com,Office Assistant I,2085,233,2318
46478,Raul,Garrie,rgarrie15@biblegateway.com,Recruiting Manager,4898,1200,6098
46211,Sioux,Gallen,sgallen16@xrea.com,Senior Developer,6343,1560,7903
46843,Niels,Misson,nmisson17@slate.com,Analog Circuit Design manager,9314,719,10033
46143,Hillary,Costley,hcostley18@washington.edu,Business Systems Development Analyst,7095,523,7618
46209,Angelica,Linforth,alinforth1a@tiny.cc,Associate Professor,6762,1594,8356
46676,Sonnie,Halfhyde,shalfhyde1b@globo.com,Senior Developer,7099,1615,8714
46529,Lucinda,Troman,ltroman1c@taobao.com,Human Resources Manager,7874,1527,9401
46353,Mignon,Hansard,mhansard1d@slideshare.net,Legal Assistant,8081,1799,9880
46295,Hephzibah,Kings,hkings1e@guardian.co.uk,VP Marketing,6767,1551,8318
46947,Wash,Copcutt,wcopcutt1f@icio.us,Web Designer I,5747,375,6122
46289,Haley,Menear,hmenear1g@wordpress.com,Payment Adjustment Coordinator,9203,1139,10342
46496,Loise,Sefton,lsefton1h@paypal.com,Account Executive,1511,264,1775
46980,Herta,Frondt,hfrondt1i@trellian.com,Sales Associate,7431,473,7904
46860,Domenic,Hebbes,dhebbes1j@microsoft.com,Director of Sales,1165,1482,2647
46400,Karla,Euels,keuels1k@va.gov,Electrical Engineer,4047,1618,5665
46424,Stuart,Walwood,swalwood1l@gnu.org,Dental Hygienist,9526,1616,11142
46124,Cinderella,Berlin,cberlin1m@about.com,Environmental Tech,7480,1473,8953
46573,Lorrayne,Mollett,lmollett1n@dell.com,Biostatistician II,9936,670,10606
46298,Sasha,Moncarr,smoncarr1o@youtu.be,Senior Editor,4930,867,5797
46500,Ninetta,Pickle,npickle1p@live.com,Marketing Manager,3299,1831,5130
46819,Nannie,Fernao,nfernao1q@themeforest.net,Physical Therapy Assistant,3136,916,4052
46683,Penelopa,Bothie,pbothie1r@google.de,Programmer Analyst II,1147,1372,2519
46776,Elyse,Huller,ehuller1s@umn.edu,Graphic Designer,3179,1459,4638
46879,Theresa,Hymers,thymers1t@ustream.tv,Database Administrator IV,6638,1485,8123
46937,Ashleigh,Timby,atimby1u@oracle.com,Geologist IV,1673,249,1922
46926,Honor,Nancekivell,hnancekivell1v@chicagotribune.com,Pharmacist,7608,1348,8956
46751,Ciel,MacQueen,cmacqueen1w@mapy.cz,Pharmacist,6318,822,7140
46131,Karia,Wiburn,kwiburn1x@msn.com,Recruiter,6117,1224,7341
46012,Sarene,Clappson,sclappson1y@etsy.com,Geologist III,6760,1797,8557
46365,Ozzie,Buckbee,obuckbee1z@dailymotion.com,Accountant I,7468,859,8327
46040,Benji,Zuppa,bzuppa20@hostgator.com,Civil Engineer,2286,445,2731
46891,Marion,Scott,mscott21@fc2.com,Human Resources Manager,1958,827,2785
46919,Kare,Kenrick,kkenrick22@about.com,Engineer IV,9109,367,9476
46171,Elroy,Urey,eurey23@toplist.cz,Safety Technician I,4601,1953,6554
46360,Carter,Hanfrey,chanfrey24@infoseek.co.jp,Marketing Manager,8143,1051,9194
46189,Jacquelynn,Pippin,jpippin25@auda.org.au,Budget/Accounting Analyst I,9727,290,10017
46625,Milo,Rizon,mrizon26@netscape.com,Desktop Support Technician,5992,263,6255
46923,Arlee,Glynne,aglynne27@shareasale.com,Desktop Support Technician,2793,1431,4224
46744,Neddy,Guitt,nguitt28@thetimes.co.uk,Assistant Professor,3620,1140,4760
46145,Martin,Drohane,mdrohane29@naver.com,Geological Engineer,6342,745,7087
46718,Anette,Growcott,agrowcott2a@mozilla.com,Sales Representative,3145,756,3901
46578,Clair,Blampey,cblampey2b@constantcontact.com,Cost Accountant,3787,796,4583
46278,Buiron,Sundin,bsundin2c@technorati.com,Administrative Assistant II,6725,1424,8149
46550,Stormy,Odlin,sodlin2d@nhs.uk,Pharmacist,6919,1649,8568
46833,Lanny,Lambe,llambe2e@abc.net.au,Technical Writer,4047,1883,5930
46280,Alexi,Sustin,asustin2f@youtube.com,Administrative Assistant I,4790,1589,6379
46135,Carie,Blaskett,cblaskett2g@google.fr,Teacher,4312,1936,6248
46262,Vincenz,Eliasen,veliasen2h@utexas.edu,Junior Executive,7557,1372,8929
46789,Esdras,Varnals,evarnals2i@mozilla.org,Financial Analyst,7680,1401,9081
46719,Thornie,Greet,tgreet2j@google.com,Account Representative III,5943,1860,7803
46554,Tamarra,Bunner,tbunner2k@cyberchimps.com,Operator,5284,1383,6667
46004,Guinna,Linn,glinn2l@adobe.com,VP Accounting,4394,877,5271
46956,Grete,Dunnet,gdunnet2m@house.gov,Paralegal,8964,1944,10908
46988,Nye,Menham,nmenham2n@topsy.com,Professor,5684,997,6681
46606,Sibelle,Carlo,scarlo2o@mozilla.com,Social Worker,5520,205,5725
46434,Mischa,Mushett,mmushett2p@addtoany.com,Computer Systems Analyst II,8404,1380,9784
46059,Kermy,Still,kstill2q@amazonaws.com,Database Administrator I,3981,448,4429
46125,Arabel,Bearman,abearman2r@miitbeian.gov.cn,Automation Specialist I,9152,406,9558
46900,Guenevere,Bebbell,gbebbell2s@printfriendly.com,Internal Auditor,4848,1745,6593
46074,Jenna,Clement,jclement2t@a8.net,Software Test Engineer II,9862,1101,10963
46026,Tobey,Gantlett,tgantlett2u@usnews.com,Human Resources Manager,7297,363,7660
46788,Annalee,Traice,atraice2v@senate.gov,Nurse,7141,493,7634
46398,Tammy,Quene,tquene2y@geocities.jp,Occupational Therapist,3929,1428,5357
46340,Patric,Reyner,preyner2z@etsy.com,Financial Advisor,8102,814,8916
46302,Elianore,Penton,epenton30@sun.com,Help Desk Technician,1091,1413,2504
46351,Tatiana,Sodeau,tsodeau31@goo.ne.jp,Senior Editor,3657,1258,4915
46483,Waylen,Simner,wsimner32@dailymail.co.uk,Pharmacist,7580,1685,9265
46002,Mychal,Ormrod,mormrod33@mtv.com,Cost Accountant,6117,1036,7153
46250,Ferdy,Hay,fhay34@nps.gov,Chief Design Engineer,2657,1426,4083
46700,Barbaraanne,Luckcock,bluckcock35@icq.com,Associate Professor,4609,524,5133
46109,Shell,Tilley,stilley37@hubpages.com,Structural Engineer,3530,1857,5387
46954,Flint,Sarch,fsarch38@dedecms.com,Data Coordiator,2056,938,2994
46936,Jimmy,Twinterman,jtwinterman39@arstechnica.com,Assistant Professor,5475,656,6131
46570,Misti,Inderwick,minderwick3a@ebay.co.uk,VP Marketing,7758,1939,9697
46234,Ches,Melpuss,cmelpuss3b@bbb.org,Product Engineer,2782,1869,4651
46428,Van,Garrettson,vgarrettson3c@noaa.gov,Database Administrator IV,2894,1850,4744
46421,Warren,Readmire,wreadmire3d@craigslist.org,Marketing Manager,8200,1694,9894
46410,Ethelbert,Rycroft,erycroft3e@bbc.co.uk,Geological Engineer,9631,1767,11398
46981,Mari,Scotcher,mscotcher3f@over-blog.com,Senior Sales Associate,6247,1826,8073
46555,Tanner,Ireson,tireson3g@senate.gov,Tax Accountant,6096,499,6595
46232,Yorker,Rebbeck,yrebbeck3h@ycombinator.com,Assistant Manager,8293,769,9062
46597,Francois,Sineath,fsineath3i@people.com.cn,Business Systems Development Analyst,4327,909,5236
46874,Tripp,Parley,tparley3j@nih.gov,Clinical Specialist,9053,225,9278
46677,Delia,Grimley,dgrimley3l@shinystat.com,VP Sales,3395,1551,4946
46801,Candida,Felce,cfelce3m@privacy.gov.au,Statistician II,7393,1033,8426
46299,Florian,Vidineev,fvidineev3n@goo.ne.jp,Systems Administrator II,4208,1221,5429
46264,Jessie,Gheeorghie,jgheeorghie3o@yandex.ru,Operator,7860,590,8450
46223,Sileas,Stonelake,sstonelake3p@biglobe.ne.jp,Computer Systems Analyst II,7618,1165,8783
46187,Beale,Kaplin,bkaplin3r@techcrunch.com,Chief Design Engineer,4543,1913,6456
46440,Gawen,Allsep,gallsep3s@amazon.co.uk,Automation Specialist I,8290,473,8763
46427,Gil,Graysmark,ggraysmark3t@seesaa.net,Administrative Assistant IV,2863,793,3656
46120,Jemmie,Boolsen,jboolsen3u@squidoo.com,GIS Technical Architect,9748,1887,11635
46061,Bearnard,Bebb,bbebb3v@ted.com,Environmental Tech,5531,590,6121
46191,Sigfried,Reyson,sreyson3w@geocities.com,Statistician III,5887,1054,6941
46142,Lindsay,Eminson,leminson3x@bing.com,Speech Pathologist,4310,958,5268
46242,Leyla,Dellenbrook,ldellenbrook3y@foxnews.com,Environmental Specialist,1449,1077,2526
46416,Bridget,Tompkiss,btompkiss3z@census.gov,Graphic Designer,5078,1268,6346
46172,Eda,Losseljong,elosseljong40@de.vu,Staff Scientist,5094,687,5781
46067,Ora,Strutley,ostrutley41@cyberchimps.com,Nurse Practicioner,1420,620,2040
46661,Meggy,Radborne,mradborne42@ameblo.jp,Environmental Tech,9518,404,9922
46052,Oralle,Cottrill,ocottrill43@dyndns.org,Database Administrator II,2903,1372,4275
46238,Helli,Chadd,hchadd44@desdev.cn,Speech Pathologist,8782,1320,10102
46723,Joly,Stalf,jstalf45@nature.com,VP Sales,4405,1076,5481
46236,Giacomo,Culy,gculy46@angelfire.com,Internal Auditor,8403,1977,10380
46255,Randy,McBrearty,rmcbrearty48@ftc.gov,Human Resources Assistant IV,8425,383,8808
46743,Wallas,Mundy,wmundy49@uol.com.br,Senior Sales Associate,2141,453,2594
46504,Demetria,Flintoft,dflintoft4a@last.fm,Registered Nurse,4710,821,5531
46064,Ariana,Halligan,ahalligan4b@spotify.com,Accountant I,9008,1024,10032
46979,Brook,Cowlishaw,bcowlishaw4c@ask.com,Professor,5933,1107,7040
46106,Thibaud,Swaite,tswaite4d@twitter.com,Programmer Analyst I,5332,759,6091
46361,Tonie,Ornelas,tornelas4f@miibeian.gov.cn,Editor,9237,1552,10789
46944,Helenka,Veare,hveare4g@weibo.com,Automation Specialist IV,3764,888,4652
46492,Felic,Courson,fcourson4h@sakura.ne.jp,Analog Circuit Design manager,6070,1975,8045
46908,Kevina,De Meis,kdemeis4i@cafepress.com,Professor,8504,590,9094
46050,Delilah,Verick,dverick4j@miibeian.gov.cn,Recruiter,2084,1133,3217
46679,Erina,Bunney,ebunney4k@seesaa.net,Developer IV,1773,1548,3321
46033,Andree,Dalgardno,adalgardno4l@bbc.co.uk,Help Desk Operator,5076,494,5570
46576,Esmeralda,Panswick,epanswick4m@shareasale.com,Junior Executive,6549,1297,7846
46821,Danny,Faux,dfaux4n@digg.com,Research Associate,3588,301,3889
46346,Demetrius,Donizeau,ddonizeau4o@goo.gl,Media Manager IV,6321,557,6878
46969,Binny,Pinshon,bpinshon4p@springer.com,Design Engineer,5476,1171,6647
46194,Sallyann,Skivington,sskivington4q@macromedia.com,Environmental Specialist,4236,815,5051
46557,Sarine,Rivitt,srivitt4r@bandcamp.com,Accountant III,4481,1052,5533
46317,Chelsy,McIlmurray,cmcilmurray4t@washingtonpost.com,Senior Cost Accountant,3231,1827,5058
46251,Wilton,Pershouse,wpershouse4u@spiegel.de,Project Manager,4078,602,4680
46564,Nance,Burgwyn,nburgwyn4v@purevolume.com,Nurse,5560,1852,7412
46861,Vivian,Frowen,vfrowen4w@altervista.org,Systems Administrator IV,5373,1441,6814
46306,Kirstyn,Georger,kgeorger4x@hugedomains.com,Registered Nurse,9181,1970,11151
46928,Derek,Gossage,dgossage4y@fema.gov,Safety Technician III,3183,861,4044
46461,Wenda,Duckerin,wduckerin4z@qq.com,Developer II,1419,1965,3384
46350,Shelly,Trubshaw,strubshaw50@bbc.co.uk,Cost Accountant,9683,757,10440
46826,Pattie,Bayldon,pbayldon51@google.it,Design Engineer,9362,613,9975
46513,Jill,Gencke,jgencke52@samsung.com,Marketing Manager,5306,877,6183
46545,Barthel,Sirey,bsirey53@sakura.ne.jp,Health Coach III,3716,1962,5678
46014,Ola,Smeall,osmeall54@ucoz.ru,Product Engineer,2184,1245,3429
46738,Jaclin,Espinas,jespinas55@people.com.cn,General Manager,4487,654,5141
46095,Haily,Pyper,hpyper57@networkadvertising.org,Mechanical Systems Engineer,4991,1112,6103
46830,Amanda,Kertess,akertess58@vistaprint.com,Assistant Media Planner,6872,682,7554
46612,Jean,Stambridge,jstambridge59@facebook.com,Clinical Specialist,6819,1421,8240
46235,Con,Veljes,cveljes5a@cpanel.net,Social Worker,7006,253,7259
46058,Kelcy,Lotwich,klotwich5b@craigslist.org,Marketing Assistant,5971,1032,7003
46698,Stephine,Langrick,slangrick5c@joomla.org,Web Designer IV,2322,1568,3890
46730,Ash,O'Brollachain,aobrollachain5f@cnn.com,Junior Executive,8492,937,9429
46202,Rosaleen,Graser,rgraser5g@tripadvisor.com,Help Desk Technician,9497,207,9704
46903,Daryn,Jouanny,djouanny5h@merriam-webster.com,Quality Control Specialist,1049,575,1624
46527,Wilone,Koubu,wkoubu5k@biblegateway.com,General Manager,5222,1429,6651
46559,Candis,Blencowe,cblencowe5l@google.cn,Information Systems Manager,5381,778,6159
46174,Willi,Bouzek,wbouzek5m@theatlantic.com,Staff Accountant IV,4895,262,5157
46978,Winny,Bachanski,wbachanski5n@cocolog-nifty.com,Payment Adjustment Coordinator,6529,1064,7593
46354,Tess,Athersmith,tathersmith5o@com.com,Statistician IV,4342,850,5192
46276,Ruddy,Eyer,reyer5p@arstechnica.com,Account Coordinator,9992,1732,11724
46913,Ara,Teanby,ateanby5q@booking.com,Research Nurse,7122,274,7396
46491,Florencia,Mustoe,fmustoe5r@imageshack.us,Structural Analysis Engineer,9139,1474,10613
46748,Gil,Rake,grake5s@angelfire.com,Office Assistant I,6223,1314,7537
46355,Jasper,Brand,jbrand5t@ftc.gov,Operator,6512,1454,7966
46910,Fredek,Skyner,fskyner5u@google.it,Data Coordiator,1106,1066,2172
46953,Rocky,Abatelli,rabatelli5w@about.me,Developer I,3962,685,4647
46028,Koral,Arnli,karnli5x@hhs.gov,Systems Administrator II,9222,651,9873
46042,Eustace,Ruckhard,eruckhard5y@gmpg.org,Health Coach II,8863,757,9620
46141,Candide,Critzen,ccritzen5z@comcast.net,Speech Pathologist,7676,370,8046
46459,Beth,Hemmingway,bhemmingway60@etsy.com,Sales Representative,5503,1291,6794
46662,Sergeant,Yarnold,syarnold61@ning.com,Environmental Tech,7122,970,8092
46126,Ellie,Montrose,emontrose63@liveinternet.ru,Senior Editor,1319,1592,2911
46195,Madelon,Roby,mroby64@webs.com,Payment Adjustment Coordinator,8186,1987,10173
46024,Nicole,Yakovliv,nyakovliv66@360.cn,Safety Technician III,9037,604,9641
46626,Ximenes,Glader,xglader67@hubpages.com,Senior Sales Associate,2825,1919,4744
46315,Jennie,Mound,jmound68@state.tx.us,Assistant Media Planner,3814,532,4346
46381,Harriott,Salsbury,hsalsbury69@wufoo.com,Pharmacist,6885,343,7228
46973,Bondy,Elcome,belcome6a@desdev.cn,Graphic Designer,7956,1875,9831
46631,Pete,Feighry,pfeighry6b@mapquest.com,Clinical Specialist,2205,1924,4129
46791,Biddie,Vyse,bvyse6c@nps.gov,Assistant Media Planner,7096,1654,8750
46785,Skyler,Orteaux,sorteaux6f@indiatimes.com,Design Engineer,6904,1387,8291
46269,Ruth,Prynne,rprynne6g@ocn.ne.jp,Project Manager,2757,1944,4701
46159,Russ,Langlands,rlanglands6h@army.mil,VP Accounting,3857,727,4584
46161,Skip,Butrimovich,sbutrimovich6i@livejournal.com,VP Quality Control,7094,1408,8502
46610,Demetre,Devennie,ddevennie6k@yahoo.com,Speech Pathologist,4495,1648,6143
46583,Ephrem,Raittie,eraittie6m@tripadvisor.com,Librarian,7635,1977,9612
46105,Doria,Seabert,dseabert6n@vkontakte.ru,Administrative Assistant IV,5569,1898,7467
46179,Jewel,McInerney,jmcinerney6o@feedburner.com,Cost Accountant,6791,1326,8117
46701,Jacky,Clayhill,jclayhill6p@yellowpages.com,Sales Representative,6350,1009,7359
46983,Karlee,Basketter,kbasketter6q@linkedin.com,Technical Writer,3614,583,4197
46089,Corrine,Creamer,ccreamer6r@artisteer.com,Quality Control Specialist,2201,1417,3618
46439,Gretna,Bowdrey,gbowdrey6s@eventbrite.com,Registered Nurse,3629,1993,5622
46636,Virge,Sparry,vsparry6u@icio.us,Product Engineer,2657,972,3629
46720,Friedrick,Weson,fweson6v@java.com,Nurse,5854,1981,7835
46508,Lyssa,Ogilvy,logilvy6w@economist.com,Project Manager,7006,1390,8396
46136,Kev,Moar,kmoar6x@oaic.gov.au,Software Engineer I,8942,1558,10500
46603,Archaimbaud,Spore,aspore6y@microsoft.com,Internal Auditor,9803,1299,11102
46526,Heidie,Shewring,hshewring6z@e-recht24.de,Nurse Practicioner,2415,1157,3572
46856,Loy,Meacher,lmeacher72@biglobe.ne.jp,Electrical Engineer,9676,1933,11609
46138,Nomi,McMoyer,nmcmoyer73@mayoclinic.com,Media Manager I,6584,748,7332
46859,Bobbi,Close,bclose74@constantcontact.com,Senior Cost Accountant,8340,439,8779
46358,Abie,Pauleit,apauleit75@netscape.com,Pharmacist,9105,528,9633
46607,Dilan,Akam,dakam76@elegantthemes.com,Analyst Programmer,2845,809,3654
46588,Laney,Peet,lpeet79@cbslocal.com,Design Engineer,1959,1123,3082
46774,Biron,Bockings,bbockings7b@cdc.gov,Health Coach II,6819,1139,7958
46006,Tedie,Joul,tjoul7c@slideshare.net,Marketing Manager,5471,1833,7304
46445,Cyril,Sainsbury-Brown,csainsburybrown7d@slate.com,Mechanical Systems Engineer,5482,1751,7233
46746,Milena,Joist,mjoist7e@squarespace.com,Account Representative III,8595,1834,10429
46613,Killy,MacAne,kmacane7g@gravatar.com,Database Administrator I,4041,358,4399
46846,Bonnie,Frangione,bfrangione7i@nymag.com,Mechanical Systems Engineer,3206,801,4007
46207,Sophie,Dallmann,sdallmann7j@yale.edu,Technical Writer,8531,1998,10529
46673,Jeniffer,Crammy,jcrammy7k@instagram.com,Social Worker,7913,497,8410
46795,Alastair,Buston,abuston7l@theguardian.com,Senior Financial Analyst,4481,848,5329
46780,Vidovik,Dominico,vdominico7m@google.com,Media Manager IV,5797,1338,7135
46733,Clair,Morfey,cmorfey7r@techcrunch.com,Quality Engineer,6093,629,6722
46794,Carroll,Height,cheight7s@cbslocal.com,Administrative Assistant I,9655,570,10225
46318,Judith,Klain,jklain7t@i2i.jp,Automation Specialist III,5553,1333,6886
46239,Maxie,Rainsden,mrainsden7u@sciencedirect.com,Clinical Specialist,4553,1239,5792
46881,Ashly,Broszkiewicz,abroszkiewicz7v@prlog.org,Design Engineer,5935,556,6491
46029,Eloise,Le Barr,elebarr7w@nhs.uk,Recruiter,1501,385,1886
46462,Pippy,Gozney,pgozney7x@google.com,Systems Administrator II,7073,1568,8641
46150,Coral,Iacobucci,ciacobucci7y@e-recht24.de,Graphic Designer,2452,954,3406
46043,Samuele,Biswell,sbiswell80@cloudflare.com,Senior Cost Accountant,7674,547,8221
46652,Boot,Deer,bdeer83@blogspot.com,Graphic Designer,7867,978,8845
46873,Jess,Joppich,jjoppich85@typepad.com,VP Sales,9227,1961,11188
46053,Thaddeus,Vyvyan,tvyvyan86@loc.gov,Software Engineer III,9819,1156,10975
46994,Allie,Voff,avoff8a@ebay.com,Web Designer I,9036,814,9850
46616,Carmel,McNiven,cmcniven8c@soundcloud.com,Developer III,4603,1377,5980
46290,Ronda,Weldrake,rweldrake8e@symantec.com,Senior Quality Engineer,6546,228,6774
46970,Lanae,Aplin,laplin8f@icio.us,Civil Engineer,1406,775,2181
46219,Druci,Lawrinson,dlawrinson8g@gmpg.org,Budget/Accounting Analyst II,6232,1506,7738
46675,Katie,Mowen,kmowen8h@usa.gov,Recruiting Manager,4526,1341,5867
46671,Constantina,Beseke,cbeseke8i@irs.gov,Cost Accountant,7913,353,8266
46539,Martyn,Hessel,mhessel8j@seesaa.net,Software Test Engineer I,6495,345,6840
46773,Aguste,Brussels,abrussels8k@pen.io,Developer IV,6183,464,6647
46349,Cynthea,Kapelhoff,ckapelhoff8l@nydailynews.com,Chief Design Engineer,9139,1458,10597
46694,Xaviera,Faldoe,xfaldoe8m@independent.co.uk,Analyst Programmer,2448,1625,4073
46287,Luther,Kraut,lkraut8n@parallels.com,Mechanical Systems Engineer,4701,587,5288
46149,Germaine,Stairmand,gstairmand8o@newyorker.com,General Manager,6565,568,7133
46252,Spike,Billington,sbillington8p@foxnews.com,Recruiting Manager,9534,1069,10603
46380,Lindon,Gannicott,lgannicott8q@taobao.com,Professor,3993,1116,5109
46288,Andy,Layton,alayton8t@forbes.com,Senior Financial Analyst,1780,1192,2972
46872,Constantino,Shew,cshew8u@disqus.com,Help Desk Technician,1923,423,2346
46013,Inger,Boughton,iboughton8v@reverbnation.com,VP Product Management,4073,1750,5823
46382,Amalle,Pietruszka,apietruszka8x@nps.gov,Mechanical Systems Engineer,7848,379,8227
46458,Siobhan,Hollingsbee,shollingsbee90@bing.com,Biostatistician I,1493,1206,2699
46127,Lelia,Twitchett,ltwitchett91@vinaora.com,Financial Analyst,7778,1064,8842
46374,Paton,McGebenay,pmcgebenay92@pbs.org,Assistant Media Planner,2775,1640,4415
46750,Delaney,Boyen,dboyen93@delicious.com,Professor,9041,1939,10980
46827,Percy,Americi,pamerici98@upenn.edu,Internal Auditor,9743,353,10096
46763,Sidoney,Worsfield,sworsfield9a@redcross.org,Database Administrator IV,9624,206,9830
46806,Preston,Griswaite,pgriswaite9b@webnode.com,Business Systems Development Analyst,2378,279,2657
46199,Avrit,Brute,abrute9c@wsj.com,Social Worker,7621,335,7956
46158,Duffie,Rossiter,drossiter9d@technorati.com,VP Product Management,8893,1379,10272
46799,Fidelia,Kinze,fkinze9e@360.cn,Help Desk Operator,2116,708,2824
46254,Kelley,Lambshine,klambshine9f@aol.com,Environmental Tech,6061,884,6945
46835,Allin,MacKnockiter,amacknockiter9m@reverbnation.com,Administrative Assistant III,7592,1375,8967
46282,Eudora,Rouff,erouff9n@free.fr,Editor,5286,502,5788
46948,Rivy,Shaves,rshaves9p@discuz.net,Cost Accountant,4774,708,5482
46011,Tan,Dosdill,tdosdill9r@miibeian.gov.cn,Desktop Support Technician,6738,1842,8580
46920,Tawnya,Jakobssen,tjakobssen9s@alexa.com,General Manager,3691,726,4417
46674,Raynell,Chirm,rchirm9w@berkeley.edu,Biostatistician III,4144,1539,5683
46182,Ileana,Hiscocks,ihiscocks9y@drupal.org,Business Systems Development Analyst,4826,952,5778
46638,Roxane,Carter,rcarter9z@t.co,Data Coordiator,7768,1233,9001
46314,Tiffanie,Malden,tmaldena2@irs.gov,Graphic Designer,2578,1553,4131
46402,Beatrix,Frankiss,bfrankissa3@china.com.cn,Financial Advisor,7263,1542,8805
46952,Liliane,Tidbold,ltidbolda6@symantec.com,Design Engineer,2767,1132,3899
46990,Cathy,Markos,cmarkosa7@apache.org,Sales Representative,4906,812,5718
46313,Hayley,Gerler,hgerlera8@ox.ac.uk,Quality Engineer,1870,1297,3167
46308,Dory,Leming,dlemingaa@oaic.gov.au,Research Assistant III,5470,567,6037
46499,Aguie,Clash,aclashab@moonfruit.com,Human Resources Manager,9931,727,10658
46163,Adele,Whimp,awhimpac@whitehouse.gov,VP Sales,5718,1080,6798
46476,Abigael,Osinin,aosininah@multiply.com,Chief Design Engineer,3442,1123,4565
46063,Ailina,Kirwood,akirwoodaj@sina.com.cn,Account Executive,4710,380,5090
46017,Emelen,Doak,edoakak@godaddy.com,Speech Pathologist,4081,1125,5206
46399,Ruben,Stammler,rstammleram@elpais.com,Speech Pathologist,6813,227,7040
46586,Val,Antley,vantleyao@ow.ly,General Manager,2228,376,2604
46129,Nancy,Pfleger,npflegerar@eventbrite.com,Assistant Manager,5607,323,5930
46363,Ryann,Woolner,rwoolneras@ca.gov,Administrative Assistant I,3263,736,3999
46654,Darya,Lober,dloberav@examiner.com,Research Nurse,7112,1888,9000
46460,Ruth,Dearnley,rdearnleyay@about.com,Operator,2068,1542,3610
46233,Gilles,Abbes,gabbesaz@addthis.com,Social Worker,9937,851,10788
46502,Nariko,Gosart,ngosartb0@telegraph.co.uk,Geologist II,7376,696,8072
46070,Sallyann,Witard,switardb1@engadget.com,Statistician II,9465,566,10031
46486,Jorrie,Leverton,jlevertonb3@cdc.gov,Legal Assistant,4174,1220,5394
46622,Aylmar,Linny,alinnyb4@accuweather.com,Geological Engineer,6990,990,7980
46591,Ajay,Jahnke,ajahnkeb6@comcast.net,Junior Executive,7899,1983,9882
46905,Lotty,Crease,lcreaseb7@smugmug.com,Geological Engineer,1755,1783,3538
46333,Thorstein,Folliott,tfolliottbb@ustream.tv,Programmer Analyst I,5917,555,6472
46320,Sydney,Drinkall,sdrinkallbc@uol.com.br,Assistant Media Planner,8791,1319,10110
46574,Zak,Demke,zdemkebd@va.gov,Software Test Engineer I,4351,1076,5427
46949,Melly,Gallienne,mgalliennebe@princeton.edu,Senior Financial Analyst,8184,1559,9743
46658,Gerrie,Cumberlidge,gcumberlidgebf@ezinearticles.com,Environmental Specialist,4087,1837,5924
46272,Emmery,Caron,ecaronbg@istockphoto.com,Developer I,1599,1424,3023
46103,Roxane,Macy,rmacybh@whitehouse.gov,Quality Engineer,9474,396,9870
46231,Rriocard,Edelston,redelstonbi@auda.org.au,Automation Specialist II,9275,837,10112
46812,Thia,Runnalls,trunnallsbj@instagram.com,Nuclear Power Engineer,8141,1928,10069
46447,Cecilio,Gronaller,cgronallerbl@vk.com,Compensation Analyst,2273,1611,3884
46420,Carlo,Laight,claightbm@engadget.com,Information Systems Manager,2144,1146,3290
46323,Channa,Stannislawski,cstannislawskibn@gov.uk,Engineer IV,7771,902,8673
46628,Welbie,Wale,wwalebp@people.com.cn,Clinical Specialist,9489,1530,11019
46561,Kamilah,Willowby,kwillowbybr@webmd.com,Civil Engineer,7362,1365,8727
46653,Isaiah,Studart,istudartbs@dmoz.org,Account Executive,6108,1103,7211
46285,Gordie,Pickworth,gpickworthbt@imageshack.us,Information Systems Manager,4789,1864,6653
46863,Sibyl,Vakhrushin,svakhrushinbu@vimeo.com,Senior Financial Analyst,5610,1318,6928
46327,Pennie,Potteridge,ppotteridgebx@oracle.com,Speech Pathologist,3205,978,4183
46164,Jimmie,Dobbing,jdobbingby@opensource.org,Civil Engineer,5213,959,6172
46348,Krishnah,Blanchard,kblanchardc0@technorati.com,Media Manager II,5099,684,5783
46535,Dot,Ferrarotti,dferrarottic1@google.com,Teacher,8365,1340,9705
46062,Nealson,Surphliss,nsurphlissc2@sourceforge.net,Nurse Practicioner,5719,1255,6974
46726,Bobina,Mauchlen,bmauchlenc3@theglobeandmail.com,Occupational Therapist,9642,391,10033
46532,Donaugh,Ragbourn,dragbournc4@webeden.co.uk,Programmer I,1568,1951,3519
46414,Merola,Huggin,mhugginc5@dagondesign.com,Research Associate,6698,1222,7920
46132,Byram,MacLice,bmaclicec6@mashable.com,Junior Executive,4908,362,5270
46722,Barbee,Dobbins,bdobbinsc8@ftc.gov,Payment Adjustment Coordinator,3901,1736,5637
46682,Deva,Hunnicot,dhunnicotca@globo.com,Associate Professor,7304,1050,8354
46094,Moss,Wadwell,mwadwellcb@samsung.com,Recruiter,4926,1556,6482
46452,Holden,Matijasevic,hmatijaseviccc@opensource.org,Editor,4337,1312,5649
46864,Sallyanne,Gian,sgiancd@360.cn,VP Product Management,9764,367,10131
46226,Siouxie,Woof,swoofce@utexas.edu,Data Coordiator,7366,1465,8831
46560,Waverley,Farquarson,wfarquarsoncf@seesaa.net,Paralegal,7029,698,7727
46411,Barron,Ortiger,bortigerch@lycos.com,Office Assistant II,4097,231,4328
46404,Debra,Coolbear,dcoolbearcj@xinhuanet.com,Internal Auditor,5914,903,6817
46034,Hyacinthia,Alonso,halonsocm@friendfeed.com,Sales Representative,9808,1870,11678
46753,Datha,Chander,dchandercn@360.cn,Assistant Media Planner,9832,1052,10884
46934,Cam,Raselles,crasellescq@oaic.gov.au,Director of Sales,5689,934,6623
46507,Amii,Beebee,abeebeecr@github.com,Director of Sales,5277,1521,6798
46463,Beckie,Stock,bstockct@hostgator.com,Human Resources Assistant III,9810,1490,11300
46875,Ranee,Klulicek,rklulicekcu@reference.com,General Manager,4233,984,5217
46996,Mitzi,Povey,mpoveycw@ucla.edu,Paralegal,3210,622,3832
46942,Griz,Ruddlesden,gruddlesdencx@moonfruit.com,Research Nurse,1832,676,2508
46757,Lolita,O'Hickee,lohickeed0@plala.or.jp,Account Coordinator,1125,318,1443
46180,Aurlie,Lipprose,alipprosed1@booking.com,Analyst Programmer,6852,1486,8338
46964,Shelby,Malamore,smalamored2@census.gov,Physical Therapy Assistant,4750,297,5047
46115,Gretel,Kenrack,gkenrackd3@friendfeed.com,Help Desk Operator,3728,1587,5315
46533,Marillin,Troth,mtrothd6@yandex.ru,Sales Associate,7593,1909,9502
46048,Anetta,McHale,amchaled7@bizjournals.com,Operator,6094,1863,7957
46832,Kissie,Edland,kedlandd8@shareasale.com,Graphic Designer,9543,329,9872
46468,Broderic,Chaudret,bchaudretd9@google.it,Marketing Manager,1982,1819,3801
46454,Deloris,Sobey,dsobeydb@cargocollective.com,Project Manager,3274,961,4235
46553,Lida,Jahnisch,ljahnischdc@hibu.com,Nurse,6201,1509,7710
46878,Dillon,Beesey,dbeeseydd@yellowbook.com,Marketing Manager,6323,1353,7676
46227,Gwyneth,O'Callaghan,gocallaghande@redcross.org,Account Executive,6705,1375,8080
46393,Alexa,Argont,aargontdf@businessweek.com,Librarian,5899,1874,7773
46692,Sid,Critchard,scritcharddh@ihg.com,Pharmacist,4449,841,5290
46214,Ardyth,Bixley,abixleydi@sourceforge.net,Speech Pathologist,7517,424,7941
46247,Beauregard,Gregoretti,bgregorettidj@yahoo.com,Research Assistant III,5599,1988,7587
46644,Vivienne,Plank,vplankdk@godaddy.com,Computer Systems Analyst III,2860,252,3112
46431,Lanna,Cantopher,lcantopherdl@meetup.com,Web Designer II,6463,668,7131
46691,Brose,Oventon,boventondn@miitbeian.gov.cn,Legal Assistant,6666,1843,8509
46651,Bess,Willsmore,bwillsmoredp@facebook.com,Environmental Specialist,6279,1391,7670
46959,Ariel,Yewdell,ayewdelldq@forbes.com,Graphic Designer,8057,751,8808
46866,Ed,Smye,esmyedt@nationalgeographic.com,Compensation Analyst,4918,841,5759
46727,Wyatt,Strooband,wstroobanddv@economist.com,Senior Editor,6507,1211,7718
46035,Roxi,Pyecroft,rpyecroftdw@amazon.de,Software Test Engineer II,9750,1641,11391
46275,Stacy,McCarrell,smccarrelldy@wunderground.com,Sales Associate,1586,1983,3569
46215,Lawton,Prall,lpralle0@abc.net.au,Senior Developer,5329,1776,7105
46160,Becka,Bourrel,bbourrele1@marketwatch.com,Nurse Practicioner,4017,1928,5945
46985,Belia,Rounsivall,brounsivalle4@utexas.edu,Product Engineer,3498,469,3967
46517,Melisande,Pee,mpeee5@xrea.com,Electrical Engineer,6069,1129,7198
46739,Bearnard,Livens,blivensea@hibu.com,Recruiting Manager,7779,1750,9529
46190,Tonnie,Greeve,tgreeveec@google.pl,Research Assistant IV,3588,962,4550
46547,Bordy,Mordy,bmordyee@facebook.com,Actuary,1451,413,1864
46824,Leah,Van der Merwe,lvandermerweef@blog.com,Mechanical Systems Engineer,6782,1596,8378
46241,Gaspard,Dounbare,gdounbareeg@guardian.co.uk,Food Chemist,5939,371,6310
46595,Merna,Sivior,msivioreh@meetup.com,Environmental Tech,2312,555,2867
46541,Giraldo,Hartop,ghartopei@studiopress.com,Safety Technician II,4362,1210,5572
46823,Sharia,Roderick,sroderickej@delicious.com,Legal Assistant,9686,1951,11637
46082,Bobina,Wason,bwasonek@google.com.br,Recruiter,5613,1764,7377
46825,Ringo,Cook,rcookel@pcworld.com,Engineer IV,4936,964,5900
46309,Cordy,Moran,cmoraneo@etsy.com,Environmental Tech,9015,383,9398
46838,Weylin,Zettler,wzettleres@berkeley.edu,Tax Accountant,9264,1353,10617
46918,Tandy,Leed,tleedet@google.com.hk,Assistant Professor,1856,1799,3655
46670,Celesta,Lafont,clafonteu@vimeo.com,GIS Technical Architect,1376,1649,3025
46634,Anastassia,Armstrong,aarmstrongev@multiply.com,Project Manager,4308,945,5253
46941,Andy,Gellan,agellanez@51.la,Staff Accountant IV,6582,1978,8560
46114,Karine,Marling,kmarlingf0@house.gov,Product Engineer,1760,1217,2977
46072,Anestassia,Nanelli,ananellif1@histats.com,Senior Financial Analyst,7142,1618,8760
46332,Ophelie,Delmage,odelmagef2@dailymotion.com,Environmental Specialist,4699,553,5252
46450,Koo,Whanstall,kwhanstallf3@de.vu,Analog Circuit Design manager,4811,1063,5874
46621,Pooh,Garaway,pgarawayf5@fda.gov,VP Sales,8419,466,8885
46781,Rogerio,Trillow,rtrillowf7@who.int,Physical Therapy Assistant,3815,392,4207
46540,Tani,Gilvary,tgilvaryfa@baidu.com,Social Worker,1947,1676,3623
46858,Stanton,Blain,sblainfd@nifty.com,Software Consultant,1267,1208,2475
46344,Windy,Essam,wessamff@wikipedia.org,Librarian,3092,847,3939
46604,Debee,Anstiss,danstissfg@google.co.jp,VP Sales,3988,1510,5498
46839,Tomasina,Cavell,tcavellfh@goodreads.com,Quality Engineer,5476,259,5735
46279,Arlen,Geist,ageistfj@fotki.com,Desktop Support Technician,8239,229,8468
46347,Shepherd,Ciotto,sciottofk@devhub.com,Web Designer IV,1484,1291,2775
46755,Tremain,Epsly,tepslyfl@issuu.com,Accounting Assistant II,6685,1631,8316
46842,Ally,Akast,aakastfo@time.com,Nuclear Power Engineer,5965,302,6267
46356,Teodoor,Allery,talleryfp@theglobeandmail.com,Financial Analyst,8123,1831,9954
46530,Harmony,Unthank,hunthankfq@123-reg.co.uk,Product Engineer,1460,1214,2674
46686,Ingelbert,Gilbanks,igilbanksfr@springer.com,Associate Professor,1970,334,2304
46370,Lisbeth,Luebbert,lluebbertfs@eepurl.com,Safety Technician I,9920,985,10905
46181,Kimberly,Cardenosa,kcardenosaft@yellowbook.com,Account Coordinator,2143,524,2667
46514,Malachi,Moon,mmoonfu@mozilla.com,Help Desk Technician,8421,1748,10169
46590,Kim,Aberchirder,kaberchirderfw@yandex.ru,Technical Writer,6676,1535,8211
46020,Myrilla,Hayller,mhayllerfx@youtu.be,Executive Secretary,3542,414,3956
46995,Alejandro,Simmons,asimmonsfz@surveymonkey.com,Recruiter,4380,1852,6232
46140,Clerissa,Clague,cclagueg2@yellowpages.com,Software Consultant,3099,527,3626
46162,Alexina,Furse,afurseg3@free.fr,Database Administrator I,2521,1236,3757
46940,Querida,Gatward,qgatwardg4@exblog.jp,Human Resources Manager,9909,941,10850
46184,Pepito,Siney,psineyg5@google.ru,Software Consultant,1325,1390,2715
46248,Vivianna,Seebert,vseebertga@theatlantic.com,Environmental Tech,7388,1755,9143
46307,Jeremiah,Wardhaw,jwardhawgc@moonfruit.com,Health Coach IV,9057,684,9741
46629,Roda,Tigner,rtignergd@unblog.fr,Web Developer II,4122,1228,5350
46688,Darline,Haughton,dhaughtongf@example.com,Dental Hygienist,7222,931,8153
46228,Dillie,Pinder,dpindergh@cpanel.net,General Manager,1660,1707,3367
46518,Kynthia,Schubert,kschubertgi@nsw.gov.au,Database Administrator IV,2985,1705,4690
46579,Robenia,Giorgietto,rgiorgiettogk@merriam-webster.com,Biostatistician IV,4462,622,5084
46148,Robinet,Tuckwell,rtuckwellgm@wordpress.com,Nuclear Power Engineer,3506,1434,4940
46087,Carolyn,Yeulet,cyeuletgn@simplemachines.org,Design Engineer,5898,1956,7854
46853,Leanor,Coatsworth,lcoatsworthgp@paypal.com,VP Sales,5588,1316,6904
46703,Tucker,Cheal,tchealgq@ihg.com,Physical Therapy Assistant,4500,1987,6487
46640,August,Duiged,aduigedgs@usnews.com,Systems Administrator I,5238,1644,6882
46396,Connie,Lots,clotsgv@google.nl,Nurse Practicioner,3358,591,3949
46433,Wyatan,Werndley,wwerndleygz@howstuffworks.com,Food Chemist,7463,1290,8753
46274,Marlane,Terrazzo,mterrazzoh0@aboutads.info,Physical Therapy Assistant,3253,652,3905
46713,Sidonnie,Curtayne,scurtayneh2@ed.gov,Quality Control Specialist,2126,290,2416
46965,Stephi,Lamplough,slamploughh6@toplist.cz,VP Marketing,7420,848,8268
46229,Claybourne,Skacel,cskacelh9@va.gov,Developer III,5066,1600,6666
46665,Audrie,Hehnke,ahehnkeha@jigsy.com,Director of Sales,5618,1557,7175
46902,Willow,Oslar,woslarhb@biglobe.ne.jp,Financial Analyst,7550,1000,8550
46982,Olive,Fearnill,ofearnillhd@yandex.ru,Research Nurse,2583,995,3578
46639,Cilka,Eltune,celtunehh@mlb.com,Environmental Specialist,2965,1994,4959
46119,Ewan,Rissom,erissomhi@pagesperso-orange.fr,Help Desk Technician,5060,499,5559
46758,Inger,Kerley,ikerleyhl@flickr.com,Business Systems Development Analyst,8062,1663,9725
46495,Putnem,Strauss,pstrausshm@usnews.com,Analyst Programmer,3879,327,4206
46007,Raddy,Dennes,rdenneshn@google.com.br,Systems Administrator IV,1555,210,1765
46098,Horton,Mityashev,hmityashevho@vistaprint.com,Database Administrator II,9491,972,10463
46166,Jodi,Lavell,jlavellhp@youku.com,Help Desk Technician,1761,292,2053
46511,Lolly,Walsh,lwalshhq@miitbeian.gov.cn,Marketing Manager,3058,1506,4564
46895,Delainey,Royston,droystonhr@symantec.com,Analog Circuit Design manager,5806,938,6744
46139,Borg,Berwick,bberwickhs@intel.com,Senior Editor,3112,302,3414
46422,Karissa,Fratczak,kfratczakhx@google.co.jp,Analog Circuit Design manager,1901,885,2786
46943,Cyndie,Gaiford,cgaifordi0@sun.com,Junior Executive,8401,1792,10193
46154,Sawyere,Balam,sbalami1@wordpress.com,Paralegal,9868,1036,10904
46325,Claudette,Shingler,cshingleri6@google.com.au,Accountant I,6738,1159,7897
46208,Cecilia,Hunnicutt,chunnicutti7@xrea.com,Statistician IV,4470,260,4730
46587,Weidar,Patching,wpatchingi8@samsung.com,Engineer I,8436,1879,10315
46599,Blake,Strippling,bstripplingia@furl.net,Research Assistant IV,3451,1575,5026
46080,Susannah,Gilderoy,sgilderoyib@omniture.com,Programmer Analyst III,9488,1089,10577
46742,Clayton,Lowers,clowersic@angelfire.com,Dental Hygienist,7019,1117,8136
46917,Jany,Sarjant,jsarjantid@hud.gov,VP Quality Control,6117,390,6507
46655,Ingeberg,Colnet,icolnetie@bbc.co.uk,VP Marketing,6071,908,6979
46848,Hatti,Bulmer,hbulmerif@live.com,Quality Control Specialist,7139,1072,8211
46946,Berk,Coulthurst,bcoulthurstig@g.co,General Manager,3855,531,4386
46027,Leon,Linnock,llinnockij@geocities.com,Editor,9681,1909,11590
46618,Vinson,Standing,vstandingim@microsoft.com,VP Marketing,1067,1088,2155
46958,Caryl,Cashell,ccashellio@tmall.com,Programmer Analyst IV,4598,371,4969
46437,Licha,Barber,lbarberip@sogou.com,Marketing Assistant,1153,229,1382
46342,Arly,Teresia,ateresiaiq@harvard.edu,Human Resources Manager,2697,1072,3769
46379,Doe,Collyear,dcollyearir@privacy.gov.au,Sales Associate,8504,1973,10477
46528,Hector,Miell,hmiellis@chicagotribune.com,Administrative Officer,8258,1968,10226
46117,Bat,Hundy,bhundyiw@photobucket.com,Accounting Assistant I,9596,1237,10833
46822,Carlene,Gosland,cgoslandiz@opensource.org,Senior Editor,6471,729,7200
46960,Hill,O'Dyvoie,hodyvoiej0@linkedin.com,Clinical Specialist,1677,1125,2802
46107,Page,Esome,pesomej2@pcworld.com,Legal Assistant,8340,539,8879
46972,Vivian,Widdison,vwiddisonj6@usgs.gov,Information Systems Manager,4022,1677,5699
46510,Windham,Warters,wwartersj8@purevolume.com,Health Coach II,5182,1394,6576
46836,Lezley,McMonies,lmcmoniesjb@livejournal.com,Senior Financial Analyst,2846,1852,4698
46001,Xenia,Lenormand,xlenormandjc@quantcast.com,Help Desk Technician,8835,1128,9963
46632,Nerita,Ashfield,nashfieldjd@deliciousdays.com,Quality Control Specialist,8990,1646,10636
46729,Lucinda,Normanvell,lnormanvellji@github.com,Quality Control Specialist,2623,1586,4209
46113,Joline,Lett,jlettjj@w3.org,Senior Financial Analyst,8807,1960,10767
46057,Paolina,Cutchee,pcutcheejl@utexas.edu,Data Coordiator,4197,622,4819
46687,Stanley,Huggard,shuggardjm@microsoft.com,Technical Writer,8554,400,8954
46609,Maryann,Woolf,mwoolfjn@yellowbook.com,Senior Editor,3508,717,4225
46367,Charla,Baurerich,cbaurerichjo@admin.ch,Financial Analyst,2795,330,3125
46104,Fredra,Shetliff,fshetliffjq@mozilla.com,General Manager,4742,622,5364
46914,Odey,Luckes,oluckesjs@goo.ne.jp,Paralegal,4071,1994,6065
46929,Christoforo,Felgat,cfelgatjt@google.co.jp,Teacher,1879,221,2100
46038,Tab,Van Niekerk,tvanniekerkju@indiegogo.com,Sales Representative,7331,1109,8440
46909,Marv,Benstead,mbensteadjv@wunderground.com,Design Engineer,7756,1599,9355
46837,Christabel,Beteriss,cbeterissjx@latimes.com,Accountant II,4997,1132,6129
46206,Willabella,Goodrick,wgoodrickjy@i2i.jp,Analyst Programmer,3575,243,3818
46711,Baron,Bradtke,bbradtkek0@senate.gov,Desktop Support Technician,8930,512,9442
46536,Carroll,Flippen,cflippenk1@livejournal.com,Programmer Analyst I,7194,1289,8483
46647,See,Domel,sdomelk2@guardian.co.uk,Senior Sales Associate,2604,455,3059
46715,Hyman,Tuson,htusonk3@army.mil,VP Product Management,2795,1976,4771
46425,Edmon,Pont,epontk5@omniture.com,Software Engineer I,2194,455,2649
46079,Newton,Esmead,nesmeadk7@squidoo.com,Operator,8760,1739,10499
46016,Lionello,Starsmeare,lstarsmeareke@wordpress.org,Help Desk Technician,4276,1999,6275
46401,Baillie,Twomey,btwomeykf@squarespace.com,VP Product Management,7600,528,8128
46736,Yorgo,Sibylla,ysibyllakh@pen.io,Product Engineer,4456,266,4722
46925,Jerrie,Bearcock,jbearcockkl@amazon.co.uk,Payment Adjustment Coordinator,9614,1346,10960
46569,Kerry,McClymond,kmcclymondkm@nasa.gov,Graphic Designer,3854,1192,5046
46646,Karoline,Hould,khouldkn@instagram.com,Web Designer III,2735,918,3653
46623,Benjamin,Earp,bearpko@wikia.com,Human Resources Manager,4915,246,5161
46101,Nichole,Ions,nionskp@spiegel.de,Information Systems Manager,6480,1169,7649
46505,Donalt,Huckabe,dhuckabekq@opera.com,Human Resources Manager,1891,1221,3112
46076,Tybie,Huot,thuotkr@salon.com,Structural Engineer,2455,571,3026
46931,Lewie,Finn,lfinnks@tinyurl.com,Operator,7712,685,8397
46375,Junia,Marzellano,jmarzellanokw@simplemachines.org,Tax Accountant,5828,937,6765
46330,Fax,Welch,fwelchkx@newyorker.com,Marketing Assistant,2416,429,2845
46815,Giustina,Symmons,gsymmonsky@google.ru,Electrical Engineer,5522,1802,7324
46523,Janeen,Maybery,jmayberykz@fda.gov,Staff Accountant I,7758,1988,9746
46465,Coraline,Tappor,ctapporl0@feedburner.com,Paralegal,5375,1361,6736
46798,Ody,Diggens,odiggensl2@canalblog.com,Data Coordiator,5844,1367,7211
46270,Raffarty,Ivers,riversl3@icio.us,Human Resources Manager,2071,1321,3392
46009,Homer,Fabb,hfabbl4@hatena.ne.jp,Human Resources Assistant I,6592,669,7261
46267,Ernaline,Monelle,emonellel8@artisteer.com,Accountant I,6784,290,7074
46749,Otis,Beagen,obeagenl9@techcrunch.com,Financial Advisor,6705,1904,8609
46443,Daniel,Gearty,dgeartyla@chron.com,Geologist I,8275,977,9252
46563,Hamlin,Goose,hgooselb@spiegel.de,Structural Analysis Engineer,3772,1803,5575
46224,Arvie,Licence,alicencele@walmart.com,Dental Hygienist,6021,1903,7924
46448,Kelley,Girodon,kgirodonlq@dyndns.org,VP Marketing,6188,668,6856
46388,Karee,Karsh,kkarshlr@smh.com.au,Health Coach IV,5469,237,5706
46170,Vallie,Scantlebury,vscantleburyls@wsj.com,Engineer II,5643,1183,6826
46968,Silvain,Dobrovolski,sdobrovolskilt@omniture.com,Research Nurse,6851,1771,8622
46620,Joey,Zecchinii,jzecchiniilv@diigo.com,Geologist II,3691,213,3904
46664,Nehemiah,Backwell,nbackwellly@hostgator.com,Nurse,1121,1102,2223
46772,Marilyn,Petruk,mpetrukm0@mediafire.com,Project Manager,6776,1442,8218
46277,Herta,Saich,hsaichm1@wikimedia.org,Budget/Accounting Analyst IV,6759,1126,7885
46630,Parke,Massie,pmassiem2@japanpost.jp,Desktop Support Technician,5641,808,6449
46643,Bar,Jacobssen,bjacobssenm6@economist.com,Physical Therapy Assistant,9277,1395,10672
46324,Kati,Haborn,khabornm8@trellian.com,Physical Therapy Assistant,5550,1053,6603
46144,Krisha,Turvie,kturviemc@flickr.com,Tax Accountant,5786,1210,6996
46915,Geneva,Peake,gpeakeme@time.com,Graphic Designer,9067,1664,10731
46403,Lazarus,Nortcliffe,lnortcliffemf@lulu.com,Legal Assistant,4339,1481,5820
46764,Brunhilde,Bagley,bbagleyml@themeforest.net,Office Assistant I,3970,221,4191
46782,Juieta,Semor,jsemormo@booking.com,Research Nurse,9727,592,10319
46168,Valera,Harvey,vharveymq@indiegogo.com,Data Coordiator,4904,529,5433
46645,Clemmie,Pavluk,cpavlukmr@icq.com,Assistant Manager,8254,1796,10050
46066,Karlyn,Callear,kcallearmv@imageshack.us,Help Desk Operator,5394,288,5682
46741,Neysa,Alderwick,nalderwickmx@apache.org,Environmental Specialist,2328,221,2549
46575,Sharlene,Peterffy,speterffymz@nifty.com,Senior Editor,9832,1108,10940
46641,Anatola,Wickson,awicksonn2@acquirethisname.com,Environmental Specialist,4329,1818,6147
46999,Barris,Paice,bpaicen5@mlb.com,Payment Adjustment Coordinator,1350,1323,2673
46426,Dougie,Camoys,dcamoysn6@arizona.edu,Senior Financial Analyst,7722,1978,9700
46212,Ronica,Tuson,rtusonn7@imgur.com,Quality Control Specialist,6830,1696,8526
46901,Allie,Tie,atien8@1688.com,Senior Editor,9923,1354,11277
46927,Skyler,Huikerby,shuikerbyn9@mapy.cz,Budget/Accounting Analyst I,8402,442,8844
46201,Genni,Fowlie,gfowlienl@uol.com.br,Computer Systems Analyst II,4388,502,4890
46598,Conan,Hassall,chassallnm@home.pl,Geologist III,1739,1905,3644
46345,Jobina,Dionisi,jdionisinp@google.com.au,Financial Advisor,9757,1150,10907
46475,Talbot,Gricewood,tgricewoodnq@baidu.com,Project Manager,6616,1763,8379
46311,Gael,Grassett,ggrassettnu@intel.com,Food Chemist,9609,981,10590
46716,Lidia,Feldbrin,lfeldbrinnx@mediafire.com,Physical Therapy Assistant,8157,289,8446
46469,Evvy,Baldassi,ebaldassiny@amazon.co.jp,Chief Design Engineer,7165,641,7806
46880,Ibrahim,Grindall,igrindallnz@freewebs.com,Pharmacist,7422,1985,9407
46122,Merrielle,Dadge,mdadgeo0@zdnet.com,Compensation Analyst,4852,1576,6428
46650,Val,Poulsum,vpoulsumo1@dedecms.com,Systems Administrator III,4129,1925,6054
46886,Oona,Fenemore,ofenemoreo3@nba.com,Chemical Engineer,9202,1421,10623
46770,Piggy,Sarfas,psarfaso6@cafepress.com,Marketing Manager,6802,823,7625
46963,Caresa,Cattrell,ccattrello7@vinaora.com,Analog Circuit Design manager,9082,1895,10977
46615,Francois,Linnell,flinnello8@blogtalkradio.com,Junior Executive,8324,740,9064
46966,Guntar,Berrey,gberreyob@hubpages.com,VP Product Management,9548,1358,10906
46371,Cymbre,Ripsher,cripsheroc@rambler.ru,Marketing Manager,3487,970,4457
46945,Catrina,Kemetz,ckemetzof@woothemes.com,Assistant Manager,5437,1262,6699
46372,Jecho,Stoker,jstokeroj@pen.io,Desktop Support Technician,7343,527,7870
46086,Marnia,Hache,mhacheol@fc2.com,Budget/Accounting Analyst III,1670,1636,3306
46319,Annis,O'Doireidh,aodoireidhom@timesonline.co.uk,Research Assistant II,5981,766,6747
46699,Albertina,Sawtell,asawtellon@stanford.edu,Teacher,4834,238,5072
46525,Brad,Mold,bmoldoo@xing.com,Clinical Specialist,7644,712,8356
46037,Aylmar,Emanuele,aemanueleor@chicagotribune.com,VP Product Management,3618,1460,5078
46797,Sonny,Wyles,swylesou@indiegogo.com,Programmer Analyst I,9678,836,10514
46896,Kimberley,Dinnage,kdinnageox@microsoft.com,Dental Hygienist,9142,508,9650
46608,Jaquenette,Taylot,jtaylotoz@accuweather.com,Social Worker,4372,1498,5870
46409,Dede,Gutridge,dgutridgep1@bing.com,VP Accounting,9419,1061,10480
46368,Wyn,Putson,wputsonp4@dailymail.co.uk,Human Resources Assistant I,1751,1031,2782
46245,Ravid,Kennaird,rkennairdp5@dmoz.org,Computer Systems Analyst I,5201,1426,6627
46423,Thorny,McWhorter,tmcwhorterp7@pcworld.com,Human Resources Manager,2172,439,2611
46932,Vere,Grenville,vgrenvillep8@plala.or.jp,Software Test Engineer IV,3520,801,4321
46907,Sebastien,Tonna,stonnapa@elpais.com,Community Outreach Specialist,9697,985,10682
46441,Gaye,Cribbins,gcribbinspb@dailymotion.com,Research Associate,7170,342,7512
46316,Marilee,Portal,mportalpd@gnu.org,Business Systems Development Analyst,4697,1158,5855
46071,Joyann,Fittes,jfittespe@is.gd,Executive Secretary,3956,751,4707
46205,Ulric,Guslon,uguslonpl@ebay.co.uk,Business Systems Development Analyst,2781,370,3151
46494,Feodora,Tregiddo,ftregiddopm@theatlantic.com,Design Engineer,5494,1736,7230
46258,Hastings,Cowdroy,hcowdroyps@redcross.org,Geological Engineer,2190,975,3165
46637,Brigg,Dubose,bdubosepu@nba.com,Marketing Manager,7648,572,8220
46384,Modesty,Moreland,mmorelandq0@vimeo.com,Marketing Manager,9852,1372,11224
46386,Avram,Lathey,alatheyq1@chronoengine.com,Analog Circuit Design manager,1368,374,1742
46196,Jacenta,Bagger,jbaggerq2@oakley.com,Programmer II,1143,642,1785
46116,Norbie,Spurryer,nspurryerqb@skyrock.com,Operator,2329,1208,3537
46075,Trixy,Malt,tmaltqc@nasa.gov,Account Coordinator,6456,1140,7596
46672,Danila,Callear,dcallearqe@cornell.edu,Physical Therapy Assistant,4115,1406,5521
46240,Brade,Pahler,bpahlerqf@feedburner.com,Senior Cost Accountant,9468,598,10066
46809,Maritsa,Ivanyushkin,mivanyushkinqg@google.co.jp,Teacher,7372,938,8310
46828,Milli,Rutt,mruttql@state.tx.us,Nurse,1900,871,2771
46516,Pammy,Francescuccio,pfrancescuccioqp@bloomberg.com,Research Assistant I,1790,1867,3657
46377,Lacee,Engel,lengelqq@buzzfeed.com,Information Systems Manager,6019,307,6326
46997,Evyn,Toombes,etoombesqs@businessweek.com,Staff Accountant III,6690,1347,8037
46442,Kelby,Macvey,kmacveyqv@cnn.com,Assistant Media Planner,7838,252,8090
46457,Lina,Frick,lfrickqw@51.la,Occupational Therapist,8130,796,8926
46301,Donna,Bortolussi,dbortolussir0@mail.ru,Recruiter,4853,1579,6432
46489,Danny,Milner,dmilnerr1@google.ca,Cost Accountant,8649,847,9496
46731,Kylie,Uglow,kuglowr5@wiley.com,VP Product Management,7359,1594,8953
46081,Antonietta,Bernardi,abernardir6@phpbb.com,GIS Technical Architect,9738,358,10096
46217,Wenonah,McPartlin,wmcpartlinr7@un.org,Financial Analyst,1767,579,2346
46684,Hugues,Lindsell,hlindsellr8@buzzfeed.com,Financial Analyst,7889,1594,9483
46153,Benson,Holah,bholahr9@bbc.co.uk,Graphic Designer,1568,1471,3039
46710,Wayland,Endrizzi,wendrizzirb@dmoz.org,Programmer Analyst III,1400,778,2178
46849,Eileen,Booty,ebootyrd@yellowbook.com,Tax Accountant,4765,1754,6519
46473,Jesse,Labrone,jlabronere@independent.co.uk,Senior Cost Accountant,9431,1423,10854
46971,Darci,Rikel,drikelrg@usatoday.com,Financial Advisor,1168,1013,2181
46056,Bradan,Summergill,bsummergillrh@histats.com,Research Assistant IV,3216,1203,4419
46524,Kyla,Petriello,kpetriellork@stumbleupon.com,Civil Engineer,7158,567,7725
46221,Andris,Wagstaff,awagstaffrl@jiathis.com,Analog Circuit Design manager,9741,1549,11290
46176,Taylor,Penticoot,tpenticootro@webnode.com,Registered Nurse,8208,1006,9214
47825,Karie,Acum,kacum0@nsw.gov.au,Safety Technician III,4722,1065,5787
47004,Sydel,McNeilley,smcneilley1@istockphoto.com,Structural Analysis Engineer,1339,981,2320
47874,Denys,Brayson,dbrayson2@woothemes.com,Senior Financial Analyst,8522,467,8989
47021,Duncan,Gabriely,dgabriely3@ca.gov,Chemical Engineer,3931,1548,5479
47354,Chaddie,Gaythwaite,cgaythwaite4@mozilla.com,Internal Auditor,2602,1485,4087
47465,Clemens,Wing,cwing5@thetimes.co.uk,VP Quality Control,2771,1202,3973
47488,Ariel,Chazelle,achazelle6@reference.com,Financial Analyst,1688,650,2338
47547,Ermina,Buessen,ebuessen7@behance.net,Budget/Accounting Analyst II,3065,1561,4626
47351,Tabbie,Rosewell,trosewell8@upenn.edu,Executive Secretary,5410,630,6040
47096,Marti,Newey,mnewey9@eepurl.com,Occupational Therapist,8635,503,9138
47119,Georgeanne,Philippson,gphilippsona@zimbio.com,Help Desk Operator,4004,1774,5778
47626,Norah,Delgado,ndelgadob@360.cn,VP Quality Control,7472,1789,9261
47612,Mord,Arend,marendc@so-net.ne.jp,Community Outreach Specialist,2149,1240,3389
47580,Marlie,Summerskill,msummerskilld@pen.io,General Manager,7878,657,8535
47840,Xenia,Berrow,xberrowe@hibu.com,Physical Therapy Assistant,4424,577,5001
47727,Pepillo,Franca,pfrancaf@fc2.com,Media Manager I,8288,1860,10148
47084,Bax,Redier,bredierg@buzzfeed.com,Research Associate,9158,1123,10281
47914,Cassie,Turfs,cturfsh@nydailynews.com,Software Consultant,8643,1377,10020
47028,Haze,De-Ville,hdevillei@google.nl,VP Product Management,9887,1063,10950
47957,Frasier,Ivushkin,fivushkinj@unblog.fr,Web Developer IV,6593,1931,8524
47956,Royall,Sedgebeer,rsedgebeerk@com.com,Web Developer II,2503,261,2764
47637,Gottfried,Reagan,greaganl@biglobe.ne.jp,Physical Therapy Assistant,4642,1231,5873
47422,Fey,Jameson,fjamesonm@bbb.org,Senior Developer,1744,1827,3571
47721,Berny,Deeves,bdeevesn@nytimes.com,Analyst Programmer,6537,1249,7786
47095,Reggis,McMurty,rmcmurtyo@vk.com,Programmer II,6385,261,6646
47908,Alethea,Levane,alevanep@creativecommons.org,Internal Auditor,1919,1075,2994
47981,Berkley,Inglis,binglisr@canalblog.com,Research Assistant III,5244,1494,6738
47556,Jeramie,Goodier,jgoodiers@ucoz.com,Statistician II,5052,1643,6695
47146,Kittie,Stormes,kstormest@netvibes.com,Senior Sales Associate,3705,767,4472
47143,Rozalin,Loyndon,rloyndonu@auda.org.au,Safety Technician II,7242,1106,8348
47656,Alexis,Allabush,aallabushv@typepad.com,Media Manager III,2476,832,3308
47102,Devin,Jaggard,djaggardw@naver.com,Professor,8466,1017,9483
47587,Marjory,Philips,mphilipsx@nydailynews.com,Safety Technician II,7876,1502,9378
47652,Tamarra,Fearey,tfeareyy@baidu.com,Paralegal,5126,1216,6342
47065,Daisey,Vassar,dvassarz@springer.com,Associate Professor,8467,662,9129
47791,Conni,Hudel,chudel10@163.com,Design Engineer,2187,930,3117
47622,Allard,Onslow,aonslow11@washington.edu,Geologist III,6781,671,7452
47025,Orton,Kenafaque,okenafaque12@bizjournals.com,Geological Engineer,7239,1260,8499
47098,Alia,Buglass,abuglass13@ning.com,General Manager,2637,1215,3852
47349,Isabelle,Upstell,iupstell14@macromedia.com,Health Coach IV,2049,1821,3870
47080,Maribelle,Peddersen,mpeddersen15@photobucket.com,Structural Analysis Engineer,3236,1183,4419
47033,Letisha,Senyard,lsenyard17@quantcast.com,Budget/Accounting Analyst III,1258,710,1968
47125,Serge,Clampe,sclampe18@fda.gov,GIS Technical Architect,2538,861,3399
47196,Dalis,Pearcey,dpearcey19@merriam-webster.com,Nuclear Power Engineer,9594,713,10307
47682,Andrea,Bliven,abliven1a@hp.com,Electrical Engineer,4056,998,5054
47769,Jessalin,Jzhakov,jjzhakov1b@infoseek.co.jp,Environmental Tech,7126,609,7735
47681,Jarad,Hessenthaler,jhessenthaler1c@mac.com,Web Designer IV,2680,1110,3790
47719,Brand,Sloane,bsloane1d@independent.co.uk,Accounting Assistant II,3737,490,4227
47245,Melania,Coldbath,mcoldbath1e@mail.ru,Internal Auditor,5099,236,5335
47658,Fania,Ormston,formston1f@twitpic.com,VP Marketing,3928,687,4615
48000,Kennett,Sneezem,ksneezem1g@symantec.com,VP Accounting,7767,971,8738
47045,Cull,Ashbee,cashbee1h@mapquest.com,VP Marketing,6200,547,6747
47158,Claudina,Cuttles,ccuttles1i@home.pl,Food Chemist,9832,1512,11344
47925,Rhodia,Ollie,rollie1j@yellowpages.com,Business Systems Development Analyst,2778,539,3317
47197,Saw,Wisniewski,swisniewski1k@cargocollective.com,Senior Editor,7414,208,7622
47417,Cindy,Hiland,chiland1l@printfriendly.com,Clinical Specialist,7479,1001,8480
47254,Ax,Posnette,aposnette1m@squidoo.com,Human Resources Manager,8594,423,9017
47618,Jocelin,Castangia,jcastangia1n@nps.gov,VP Accounting,8104,1930,10034
47609,Katerine,Sweatland,ksweatland1o@wiley.com,Computer Systems Analyst II,1164,441,1605
47831,Agustin,Fyldes,afyldes1p@uiuc.edu,Quality Engineer,8686,747,9433
47262,Willie,Baseke,wbaseke1q@nbcnews.com,Registered Nurse,1547,830,2377
47795,Bancroft,Aldiss,baldiss1r@google.fr,Desktop Support Technician,5330,846,6176
47160,Ashly,Coatman,acoatman1s@wikispaces.com,Clinical Specialist,9513,863,10376
47998,Iris,Bloodworthe,ibloodworthe1t@reddit.com,Tax Accountant,7195,783,7978
47776,Georgiana,Culwen,gculwen1u@state.gov,Research Nurse,6148,1803,7951
47754,Charin,Lacy,clacy1v@discuz.net,Cost Accountant,7889,413,8302
47269,Vikki,Bowring,vbowring1w@discuz.net,Research Nurse,3855,1358,5213
47541,Vivie,Dendle,vdendle1x@earthlink.net,Clinical Specialist,1676,1461,3137
47001,Jasun,Royste,jroyste1y@ftc.gov,Staff Accountant I,7148,301,7449
47757,Gabriel,Howford,ghowford1z@prlog.org,Staff Scientist,4822,1700,6522
47865,Brody,Radbond,bradbond20@merriam-webster.com,Civil Engineer,7568,262,7830
47745,Mora,McLuckie,mmcluckie21@mac.com,Occupational Therapist,6818,915,7733
47384,Dyane,Kern,dkern22@imageshack.us,Graphic Designer,6113,766,6879
47330,Stacee,Theriot,stheriot23@jugem.jp,Physical Therapy Assistant,3717,1274,4991
47131,Barton,Swett,bswett24@quantcast.com,Editor,3149,382,3531
47085,Zia,Cleynman,zcleynman25@weibo.com,Budget/Accounting Analyst III,9760,954,10714
47412,Kamilah,Witherdon,kwitherdon26@hostgator.com,Office Assistant IV,7021,2000,9021
47585,Isadore,Snowball,isnowball27@loc.gov,Graphic Designer,6027,220,6247
47815,Marlo,Butterwick,mbutterwick28@360.cn,Account Coordinator,1892,1152,3044
47477,Almeria,Garard,agarard29@mediafire.com,Data Coordiator,9619,721,10340
47279,Bartolemo,Bock,bbock2a@independent.co.uk,Marketing Manager,2456,855,3311
47779,Erika,Moro,emoro2b@bravesites.com,Electrical Engineer,5578,528,6106
47415,Aldon,Weatherup,aweatherup2c@youtube.com,Director of Sales,4154,1085,5239
47334,Joli,Barthelet,jbarthelet2d@naver.com,Research Assistant III,2816,257,3073
47834,Emlynn,Rizzardi,erizzardi2e@alexa.com,Developer III,8074,1682,9756
47094,Fran,Dussy,fdussy2f@seesaa.net,Engineer IV,3557,587,4144
47842,Baxter,Abbett,babbett2g@imageshack.us,Database Administrator I,2605,1481,4086
47895,Delly,Seeley,dseeley2h@businesswire.com,Biostatistician I,6379,1141,7520
47694,Dorelia,Vlasenkov,dvlasenkov2j@issuu.com,Staff Accountant IV,2544,973,3517
47015,Ebba,Suffield,esuffield2k@google.com.hk,Quality Control Specialist,7590,1399,8989
47617,Rita,Veschambes,rveschambes2l@yellowpages.com,Administrative Officer,1090,824,1914
47223,Jedd,Methley,jmethley2m@skype.com,Recruiting Manager,6595,1702,8297
47097,Arlyn,More,amore2n@webeden.co.uk,Clinical Specialist,6304,226,6530
47613,Ruthi,McGlynn,rmcglynn2p@umn.edu,Executive Secretary,8225,1984,10209
47020,Annora,Hartwright,ahartwright2q@umn.edu,Safety Technician III,4981,1198,6179
47047,Teodorico,Mirralls,tmirralls2r@artisteer.com,Quality Control Specialist,6011,508,6519
47715,Geoffrey,Dwelly,gdwelly2s@abc.net.au,Occupational Therapist,8522,1602,10124
47486,Ivette,Hazlehurst,ihazlehurst2t@lycos.com,Environmental Specialist,8895,1602,10497
47540,Mill,Savatier,msavatier2u@is.gd,Professor,6676,1840,8516
47820,Rosemarie,Aliberti,raliberti2v@hexun.com,Account Representative II,3536,442,3978
47604,Constantine,Licciardiello,clicciardiello2w@mit.edu,Sales Representative,3799,1201,5000
47337,Shannen,Tarn,starn2x@ibm.com,Structural Engineer,9249,1966,11215
47003,Denys,Daulton,ddaulton2y@upenn.edu,Software Test Engineer I,9504,245,9749
47747,Frank,Donat,fdonat2z@addtoany.com,Web Developer III,2428,1864,4292
47406,Janifer,Jerrans,jjerrans30@patch.com,Account Coordinator,2228,1371,3599
47919,Avie,Reiling,areiling31@cbsnews.com,Research Assistant IV,7738,820,8558
47478,Nikolaos,Lye,nlye33@vimeo.com,Developer IV,7195,1462,8657
47214,Tabbatha,Frowde,tfrowde34@typepad.com,Office Assistant IV,4646,783,5429
47856,Tann,Bourgeois,tbourgeois35@dropbox.com,VP Accounting,1736,1910,3646
47748,Garwin,Decreuze,gdecreuze36@prlog.org,Operator,4649,341,4990
47913,Rafaelia,Rowberry,rrowberry39@php.net,Pharmacist,8670,1173,9843
47150,Darrell,Martini,dmartini3a@nba.com,Analyst Programmer,7414,1291,8705
47986,Vern,Tregien,vtregien3b@bloglovin.com,Geologist IV,8487,984,9471
47362,Hernando,Penbarthy,hpenbarthy3c@ehow.com,Physical Therapy Assistant,5434,1063,6497
47076,Zilvia,Ughetti,zughetti3d@ucsd.edu,Safety Technician I,1023,769,1792
47643,Wileen,Bewlay,wbewlay3e@nydailynews.com,Software Engineer III,6445,1604,8049
47303,Barret,Cassey,bcassey3f@gov.uk,Graphic Designer,3725,1881,5606
47296,Thurston,Arnaudon,tarnaudon3g@foxnews.com,Senior Sales Associate,9963,1567,11530
47061,Ches,Goodliffe,cgoodliffe3h@timesonline.co.uk,Nurse Practicioner,8248,774,9022
47793,Patton,O'Dulchonta,podulchonta3i@constantcontact.com,Assistant Manager,9076,556,9632
47809,Jasper,Syder,jsyder3j@dmoz.org,Systems Administrator III,1503,863,2366
47203,Olag,Bosma,obosma3k@umich.edu,Registered Nurse,4489,651,5140
47640,Matilde,Dussy,mdussy3l@vkontakte.ru,VP Product Management,9111,1108,10219
47250,Adan,Kermott,akermott3m@sciencedirect.com,Desktop Support Technician,9405,899,10304
47786,Gaultiero,Reeve,greeve3n@washingtonpost.com,Senior Developer,1831,709,2540
47252,Vanda,Mc Meekan,vmcmeekan3o@google.cn,Teacher,5102,397,5499
47370,Velma,Vittet,vvittet3p@qq.com,Analyst Programmer,4313,935,5248
47480,Golda,Cuseck,gcuseck3q@marriott.com,Media Manager IV,6174,865,7039
47457,Davin,Hargie,dhargie3r@foxnews.com,Speech Pathologist,4457,973,5430
47955,Carolyn,Bartaletti,cbartaletti3s@xinhuanet.com,Technical Writer,8071,820,8891
47624,Buffy,Pynn,bpynn3t@yellowpages.com,Social Worker,4115,1323,5438
47071,Electra,Cronshaw,ecronshaw3u@bloomberg.com,Web Developer I,4611,1143,5754
47961,Sidonia,Stoffels,sstoffels3v@blogtalkradio.com,Health Coach III,8439,788,9227
47912,Elizabeth,Baff,ebaff3w@amazon.co.uk,Health Coach II,8740,1739,10479
47360,Lorrayne,Di Biagi,ldibiagi3x@arizona.edu,Software Consultant,2538,1651,4189
47206,Patten,Gayler,pgayler3z@whitehouse.gov,Community Outreach Specialist,5796,1417,7213
47009,Lewie,Langhorn,llanghorn42@apple.com,Environmental Specialist,7625,652,8277
47072,Paul,Mulcahy,pmulcahy43@washingtonpost.com,Business Systems Development Analyst,7649,476,8125
47276,Andros,Airdrie,aairdrie44@homestead.com,Business Systems Development Analyst,1221,723,1944
47736,Efren,Lehrian,elehrian45@dyndns.org,Marketing Manager,5524,1096,6620
47760,Mureil,Boggers,mboggers46@census.gov,Account Representative I,3471,884,4355
47399,Chad,Baudains,cbaudains47@themeforest.net,Analyst Programmer,1229,1430,2659
47309,Corabella,Ravenscraft,cravenscraft48@hostgator.com,Help Desk Operator,2082,1200,3282
47744,Beulah,Sandbach,bsandbach49@360.cn,Occupational Therapist,8333,1854,10187
47566,Una,Gabbett,ugabbett4a@businessinsider.com,Editor,8865,813,9678
47034,Jeffie,O' Finan,jofinan4b@geocities.com,Graphic Designer,4766,1021,5787
47659,Evania,Lindman,elindman4c@psu.edu,Senior Financial Analyst,5647,639,6286
47489,Meggy,Ygou,mygou4d@nhs.uk,Speech Pathologist,6744,846,7590
47292,Homer,Adamek,hadamek4e@psu.edu,Paralegal,3081,503,3584
47689,Melba,Longbottom,mlongbottom4f@biblegateway.com,Chief Design Engineer,7567,640,8207
47535,Jeana,MacBrearty,jmacbrearty4g@cocolog-nifty.com,Financial Advisor,9756,213,9969
47199,Larisa,Truelove,ltruelove4h@shinystat.com,Analog Circuit Design manager,8261,1260,9521
47892,Bastian,Heliot,bheliot4i@ehow.com,Executive Secretary,6650,1156,7806
47444,Eugen,Beasleigh,ebeasleigh4j@google.com.br,Senior Developer,2043,930,2973
47527,Peterus,O'Breen,pobreen4k@nydailynews.com,Nurse,8839,804,9643
47763,Bear,Magner,bmagner4l@360.cn,Recruiting Manager,9359,1462,10821
47325,Andris,Tungate,atungate4m@topsy.com,Editor,8452,581,9033
47575,Ariela,Fairholme,afairholme4n@merriam-webster.com,Geological Engineer,2430,1665,4095
47101,Deane,Ridger,dridger4o@ftc.gov,Biostatistician II,2523,666,3189
47151,Melloney,Brideau,mbrideau4p@youtube.com,Assistant Manager,9261,1280,10541
47599,Rhodia,Houldey,rhouldey4q@sphinn.com,Data Coordiator,2788,1610,4398
47576,Ash,Baynes,abaynes4r@hubpages.com,Programmer Analyst IV,2095,1036,3131
47230,Kerk,Pryell,kpryell4s@loc.gov,Information Systems Manager,8207,1356,9563
47978,Gwendolyn,Birkinshaw,gbirkinshaw4t@gmpg.org,VP Sales,3655,1428,5083
47247,Carlie,Rowlstone,crowlstone4u@jugem.jp,Staff Accountant IV,1175,1363,2538
47946,Taite,Lakey,tlakey4v@infoseek.co.jp,Paralegal,2330,1053,3383
47453,Lydon,Baleine,lbaleine4w@hubpages.com,Web Developer II,4455,665,5120
47375,Lesya,Tuckett,ltuckett4x@chronoengine.com,General Manager,8424,1260,9684
47327,Agatha,McAuslan,amcauslan4y@house.gov,Data Coordiator,7499,795,8294
47476,Brant,Illingworth,billingworth4z@nba.com,Nurse Practicioner,3078,747,3825
47551,Katheryn,Leverson,kleverson51@w3.org,Recruiting Manager,1437,721,2158
47133,Chryste,Simcoe,csimcoe52@sourceforge.net,Paralegal,9350,904,10254
47787,Walliw,King,wking53@soup.io,Administrative Officer,2901,1028,3929
47595,Denise,Ulyat,dulyat54@seesaa.net,Senior Developer,3753,407,4160
47671,Melisent,Scrancher,mscrancher55@tuttocitta.it,Structural Engineer,6752,893,7645
47728,Niel,Sydney,nsydney56@uiuc.edu,VP Quality Control,6673,1905,8578
47027,Eugene,McGilleghole,emcgilleghole58@soundcloud.com,Human Resources Manager,2589,1746,4335
47572,Filide,Pudge,fpudge59@adobe.com,Social Worker,3571,700,4271
47743,Brittney,Gilbey,bgilbey5a@businessweek.com,Marketing Assistant,8832,1183,10015
47533,Jammal,Willows,jwillows5b@hp.com,Administrative Assistant II,4942,1352,6294
47649,Hunter,Caisley,hcaisley5c@w3.org,Director of Sales,5202,841,6043
47813,Didi,Basnett,dbasnett5d@fda.gov,Marketing Manager,9946,677,10623
47798,Cale,Kuhnt,ckuhnt5e@alexa.com,Payment Adjustment Coordinator,3165,1745,4910
47534,Wylie,Gwin,wgwin5f@mapquest.com,VP Marketing,5076,933,6009
47355,Blane,Lace,blace5h@sciencedaily.com,Librarian,5887,1902,7789
47785,Elena,Snedker,esnedker5i@webmd.com,Technical Writer,9132,1962,11094
47537,Brook,Laffoley-Lane,blaffoleylane5j@google.com.au,Associate Professor,5111,1858,6969
47132,Tadd,Osgerby,tosgerby5k@indiegogo.com,Professor,9887,1037,10924
47110,Faina,Sainsbury-Brown,fsainsburybrown5l@rediff.com,Food Chemist,2785,1612,4397
47274,Pen,Sollett,psollett5m@newyorker.com,Budget/Accounting Analyst II,8033,831,8864
47767,Darcey,Krysztowczyk,dkrysztowczyk5o@cargocollective.com,Automation Specialist III,6060,728,6788
47826,Thurstan,Von Helmholtz,tvonhelmholtz5p@goodreads.com,Assistant Media Planner,9829,762,10591
47286,Roxana,Telford,rtelford5q@who.int,Senior Quality Engineer,9111,1348,10459
47836,Jermaine,Edwin,jedwin5r@privacy.gov.au,Nurse Practicioner,5542,1182,6724
47563,Grissel,Beall,gbeall5s@tmall.com,Legal Assistant,8879,508,9387
47215,Suzy,Maffia,smaffia5t@unesco.org,Community Outreach Specialist,1497,440,1937
47405,Laryssa,Hinze,lhinze5v@psu.edu,Quality Engineer,3258,547,3805
47056,Peterus,Knappen,pknappen5x@hatena.ne.jp,Software Consultant,6229,257,6486
47036,Harri,Jolley,hjolley5y@de.vu,Administrative Assistant II,6155,1285,7440
47075,Travers,Brissenden,tbrissenden5z@freewebs.com,Nurse,1455,247,1702
47331,Andy,Skedgell,askedgell60@princeton.edu,Registered Nurse,7782,1860,9642
47210,Ruth,Killelea,rkillelea63@nature.com,Paralegal,6222,1404,7626
47202,Carlye,Mintoff,cmintoff65@delicious.com,Developer II,9134,1357,10491
47942,Violetta,Davidovic,vdavidovic67@ed.gov,Tax Accountant,4088,627,4715
47611,Claudette,Haestier,chaestier68@amazon.com,Project Manager,4830,1517,6347
47032,Timmie,Willder,twillder69@chronoengine.com,Automation Specialist I,8163,1007,9170
47109,Bennett,Dake,bdake6a@upenn.edu,Marketing Manager,6458,1460,7918
47359,Auguste,Minthorpe,aminthorpe6b@myspace.com,Account Coordinator,9139,1304,10443
47431,Louella,O'Leahy,loleahy6c@sciencedaily.com,Account Representative IV,1765,1768,3533
47358,Curt,Glaum,cglaum6d@yandex.ru,Project Manager,2925,1430,4355
47756,Corbett,Bence,cbence6e@reverbnation.com,Financial Analyst,8497,944,9441
47356,Joell,Cullrford,jcullrford6f@nbcnews.com,Payment Adjustment Coordinator,6452,1402,7854
47896,Roxana,Denholm,rdenholm6g@feedburner.com,Database Administrator III,2881,1041,3922
47699,Tanner,Dericut,tdericut6h@a8.net,Senior Financial Analyst,7648,1008,8656
47764,Hammad,Stollwerck,hstollwerck6i@altervista.org,Sales Representative,7157,1195,8352
47782,Serena,McFayden,smcfayden6j@diigo.com,Senior Cost Accountant,7646,372,8018
47552,Robinet,Kyteley,rkyteley6k@ucoz.ru,Account Representative I,6338,1663,8001
47166,Briggs,Quilliam,bquilliam6l@a8.net,VP Sales,1434,1261,2695
47586,Calvin,Elson,celson6m@deliciousdays.com,Technical Writer,1228,509,1737
47255,Gloria,Vedyaev,gvedyaev6n@cnn.com,Senior Financial Analyst,2988,1122,4110
47561,Kariotta,Telfer,ktelfer6o@elegantthemes.com,Cost Accountant,5157,663,5820
47774,Hailey,Crumbleholme,hcrumbleholme6q@tamu.edu,Sales Representative,5708,821,6529
47342,Lutero,Hardingham,lhardingham6r@odnoklassniki.ru,Environmental Tech,4729,749,5478
47529,Norris,McBrady,nmcbrady6s@icio.us,Recruiting Manager,9814,276,10090
47600,Sioux,Osboldstone,sosboldstone6t@uiuc.edu,Health Coach I,2000,499,2499
47053,Nicolle,Bluett,nbluett6u@unicef.org,Developer I,3994,819,4813
47153,Zarah,Cheverell,zcheverell6v@usgs.gov,Senior Quality Engineer,9144,1986,11130
47971,Auberta,Swinford,aswinford6w@state.gov,Safety Technician III,2094,418,2512
47182,Bell,Guirardin,bguirardin6x@angelfire.com,Senior Editor,1062,1775,2837
47850,Wynn,McCurtain,wmccurtain6y@sbwire.com,Operator,6654,1048,7702
47817,Sascha,Dearlove,sdearlove6z@woothemes.com,Electrical Engineer,8343,1067,9410
47607,Ezechiel,Fernandes,efernandes70@google.com,Community Outreach Specialist,2821,577,3398
47363,Kikelia,Dufore,kdufore71@miibeian.gov.cn,Quality Engineer,1456,577,2033
47907,Diena,Boddy,dboddy72@angelfire.com,Human Resources Assistant II,1355,404,1759
47030,Tana,Cisland,tcisland73@netlog.com,Research Assistant IV,1739,1279,3018
47390,Brnaba,Benedyktowicz,bbenedyktowicz74@cnn.com,Research Associate,2505,1915,4420
47122,Ora,Eadmeades,oeadmeades75@gravatar.com,Budget/Accounting Analyst III,3482,1760,5242
47087,Cody,Menichino,cmenichino77@google.com.br,Administrative Officer,7511,324,7835
47475,Mahala,Smith,msmith78@epa.gov,VP Product Management,7272,328,7600
47995,Xylina,Stolworthy,xstolworthy79@netscape.com,Health Coach IV,1154,1074,2228
47088,Hewet,Chalker,hchalker7b@hp.com,Teacher,6466,1171,7637
47426,Rochella,Gobert,rgobert7c@clickbank.net,Marketing Manager,5585,817,6402
47499,Helli,Cartlidge,hcartlidge7e@cyberchimps.com,Occupational Therapist,6266,1582,7848
47106,Meir,Chadney,mchadney7f@live.com,Legal Assistant,2128,977,3105
47346,Natale,Mulqueen,nmulqueen7g@mac.com,Payment Adjustment Coordinator,7284,1328,8612
47522,Britta,Dublin,bdublin7h@myspace.com,VP Product Management,9298,461,9759
47733,Juline,Dailly,jdailly7i@newsvine.com,Operator,5667,801,6468
47069,Gill,Hayman,ghayman7j@boston.com,Financial Advisor,2142,964,3106
47698,Olly,Sloat,osloat7k@marketwatch.com,VP Accounting,7305,949,8254
47947,Vladamir,Panyer,vpanyer7l@is.gd,Graphic Designer,5126,1151,6277
47503,Gabbie,Playfair,gplayfair7m@usa.gov,Budget/Accounting Analyst II,8291,1303,9594
47950,Gan,Dottrell,gdottrell7n@imdb.com,Physical Therapy Assistant,6476,1233,7709
47863,Brad,O'Duane,boduane7o@sohu.com,Senior Editor,4564,1322,5886
47858,Henrie,Cossell,hcossell7p@slate.com,Software Consultant,1716,1614,3330
47124,Artie,Minto,aminto7q@meetup.com,Teacher,7753,1235,8988
47819,Hersh,Brownstein,hbrownstein7r@bbc.co.uk,Actuary,7633,714,8347
47901,Lenard,Dawbery,ldawbery7s@sun.com,Geologist IV,3459,1434,4893
47239,Aurilia,Keppel,akeppel7v@cnn.com,Administrative Assistant I,7229,1829,9058
47259,Garik,Bold,gbold7x@miitbeian.gov.cn,General Manager,1844,219,2063
47282,Cindi,Killock,ckillock7y@wufoo.com,Business Systems Development Analyst,3493,872,4365
47236,Colleen,Cornill,ccornill7z@illinois.edu,Account Coordinator,4670,533,5203
47050,Hale,MacFadden,hmacfadden80@storify.com,Administrative Officer,2644,1181,3825
47288,Andrei,Brambell,abrambell81@youku.com,Assistant Media Planner,3338,1043,4381
47414,Maynord,Coniff,mconiff82@microsoft.com,Nuclear Power Engineer,1272,305,1577
47135,Aleda,Gergely,agergely83@state.gov,Database Administrator I,7069,1091,8160
47136,Marlon,Flower,mflower84@google.ru,Nuclear Power Engineer,2405,857,3262
47481,Vonnie,MacGuiness,vmacguiness85@va.gov,Geological Engineer,8243,964,9207
47579,Dew,Roughsedge,droughsedge86@freewebs.com,Web Designer III,3818,1078,4896
47319,Durante,Otto,dotto88@booking.com,Graphic Designer,9918,1323,11241
47830,Alberta,Machel,amachel8a@ebay.com,Quality Engineer,7320,526,7846
47898,Abel,Goodfellowe,agoodfellowe8b@soup.io,VP Marketing,5831,718,6549
47002,Ingrim,Stoite,istoite8d@bigcartel.com,Help Desk Operator,4482,1629,6111
47079,Oswell,Storrier,ostorrier8e@artisteer.com,Media Manager I,3772,1160,4932
47306,Eduardo,Keher,ekeher8g@feedburner.com,Assistant Manager,5635,1525,7160
47710,Dianna,Northidge,dnorthidge8h@dot.gov,Research Assistant III,6377,1308,7685
47064,Valentine,Whatley,vwhatley8k@weebly.com,Budget/Accounting Analyst II,9885,271,10156
47796,Opalina,Duplain,oduplain8l@shop-pro.jp,Recruiting Manager,7756,1504,9260
47523,Weidar,Ruscoe,wruscoe8m@engadget.com,Chemical Engineer,9761,1665,11426
47227,Keith,Gerish,kgerish8n@cam.ac.uk,Design Engineer,3498,213,3711
47639,Bunnie,Koba,bkoba8o@ucoz.ru,Engineer III,6807,817,7624
47007,Easter,Klampt,eklampt8q@utexas.edu,Legal Assistant,3051,677,3728
47574,Prentiss,Mathwen,pmathwen8r@pcworld.com,Teacher,3359,1478,4837
47411,Carrie,Chazelas,cchazelas8s@ebay.com,VP Product Management,1845,672,2517
47328,Minny,Guihen,mguihen8u@huffingtonpost.com,Programmer Analyst III,2845,1347,4192
47498,Jeanna,Gibbeson,jgibbeson8v@guardian.co.uk,Human Resources Manager,9071,961,10032
47248,Pattie,Shorten,pshorten8w@utexas.edu,Web Developer III,6520,1919,8439
47827,Dana,Everson,deverson8x@dagondesign.com,Nurse,6403,655,7058
47994,Jolene,Hayller,jhayller8z@printfriendly.com,VP Sales,5064,922,5986
47880,Agata,Velasquez,avelasquez90@aol.com,Safety Technician IV,4805,1953,6758
47427,Jodie,Penniell,jpenniell91@canalblog.com,VP Quality Control,4025,369,4394
47368,Lawrence,Kinker,lkinker94@sogou.com,Actuary,3813,402,4215
47281,Jeth,Tyrer,jtyrer96@google.com.br,Assistant Media Planner,8566,1308,9874
47134,Terry,Pomroy,tpomroy98@gravatar.com,Administrative Officer,1293,316,1609
47738,Amanda,Boothebie,aboothebie99@livejournal.com,Speech Pathologist,5525,639,6164
47005,Romeo,Sine,rsine9b@people.com.cn,Marketing Manager,2533,1192,3725
47614,Adriano,Larenson,alarenson9c@umn.edu,Software Engineer II,7904,814,8718
47295,Irving,Lurriman,ilurriman9d@marketwatch.com,Environmental Specialist,5837,1818,7655
47829,Terrance,O'Dowgaine,todowgaine9e@dot.gov,Editor,5669,1739,7408
47231,Isidoro,Codron,icodron9f@imageshack.us,Civil Engineer,2674,1934,4608
47588,Rae,Rudsdell,rrudsdell9g@hugedomains.com,VP Product Management,1484,958,2442
47312,Frazer,Cohn,fcohn9h@vimeo.com,Help Desk Technician,6262,1373,7635
47035,Ingaberg,Rackam,irackam9i@tmall.com,Associate Professor,7912,809,8721
47511,Kellen,Lamplough,klamplough9j@e-recht24.de,Food Chemist,5181,230,5411
47512,Blaire,McWhinnie,bmcwhinnie9n@virginia.edu,Director of Sales,4034,532,4566
47093,Kathryn,Sodeau,ksodeau9o@fotki.com,Sales Representative,9105,1922,11027
47884,Merrel,Bamforth,mbamforth9q@examiner.com,Developer III,7620,886,8506
47118,Raddy,Rosetti,rrosetti9r@squarespace.com,Dental Hygienist,6138,1604,7742
47353,Selig,Elijah,selijah9s@infoseek.co.jp,Health Coach III,4168,1591,5759
47709,Camilla,Dineen,cdineen9t@angelfire.com,Senior Sales Associate,9895,1770,11665
47147,Octavia,Aizikovich,oaizikovich9v@ovh.net,VP Marketing,6610,1296,7906
47275,Sebastian,Joslow,sjoslow9w@bing.com,Registered Nurse,8621,1623,10244
47708,Laurette,Stollenbeck,lstollenbeck9x@about.me,Electrical Engineer,5385,1705,7090
47186,Sheree,Kohnemann,skohnemann9y@nyu.edu,Data Coordiator,4767,1702,6469
47665,Helsa,MacAne,hmacane9z@ft.com,Assistant Professor,5803,953,6756
47438,Carrol,Plaschke,cplaschkea1@amazonaws.com,Food Chemist,4542,1183,5725
47022,Shermy,Brownsett,sbrownsetta2@e-recht24.de,Web Developer III,7428,1568,8996
47181,Felice,Suter,fsutera3@miitbeian.gov.cn,Statistician II,8482,1320,9802
47302,Maurizio,Dawtrey,mdawtreya7@salon.com,Director of Sales,4194,684,4878
47041,Clifford,Gilbee,cgilbeea8@free.fr,Web Developer III,2468,1496,3964
47977,Therese,Planque,tplanquea9@mapy.cz,Information Systems Manager,8049,821,8870
47544,Findley,Proudlock,fproudlockaa@cdbaby.com,Social Worker,7070,1806,8876
47092,Jamil,Skoggings,jskoggingsad@smh.com.au,Community Outreach Specialist,9860,584,10444
47222,Carlie,McPhillimey,cmcphillimeyae@accuweather.com,Operator,6784,953,7737
47952,Odelinda,Kennelly,okennellyaf@google.com,Programmer Analyst I,8754,797,9551
47258,Noreen,Whordley,nwhordleyag@simplemachines.org,Information Systems Manager,5350,679,6029
47531,Gillian,Leyland,gleylandai@lycos.com,Help Desk Operator,9267,464,9731
47606,Stephannie,Keuntje,skeuntjeaj@seesaa.net,Dental Hygienist,3542,1527,5069
47564,Constancy,Nend,cnendam@sogou.com,Legal Assistant,6745,407,7152
47991,Jude,Doubleday,jdoubledayao@businessweek.com,GIS Technical Architect,6845,1611,8456
47176,Stephenie,Turbayne,sturbayneaq@123-reg.co.uk,Project Manager,9545,200,9745
47573,Lucio,Faustian,lfaustianas@si.edu,Occupational Therapist,6385,1502,7887
47746,Jocelyn,Whaplington,jwhaplingtonau@mac.com,Administrative Officer,8203,1529,9732
47372,Chic,Dell Casa,cdellcasaav@japanpost.jp,Chief Design Engineer,1387,639,2026
47921,Hildagarde,Betho,hbethoaw@hp.com,Chemical Engineer,7542,1291,8833
47867,Nathanil,Cressar,ncressaray@tripadvisor.com,Developer II,7981,1305,9286
47502,Raina,Tabourin,rtabourinaz@xing.com,General Manager,5846,1201,7047
47990,Conrad,Latter,clatterb0@amazonaws.com,Senior Editor,2653,1175,3828
47213,Camala,Avesque,cavesqueb1@fc2.com,Data Coordiator,5499,365,5864
47646,Kizzee,Iacovino,kiacovinob2@mapquest.com,Civil Engineer,1701,1548,3249
47023,Lorrin,Kembrey,lkembreyb4@ihg.com,Senior Developer,2420,1492,3912
47931,Rutter,Lyenyng,rlyenyngb7@thetimes.co.uk,Legal Assistant,5375,1813,7188
47220,Ives,Beddoes,ibeddoesb9@smugmug.com,Project Manager,9314,933,10247
47605,Hervey,Stimpson,hstimpsonbb@archive.org,Chemical Engineer,3601,814,4415
47891,Avis,Denney,adenneybc@livejournal.com,Automation Specialist I,2573,1844,4417
47381,Prescott,Wethey,pwetheybd@indiegogo.com,Database Administrator III,1687,1454,3141
47155,Liva,Eliyahu,leliyahube@last.fm,Software Engineer IV,5122,1890,7012
47460,Hanna,McManus,hmcmanusbf@alibaba.com,Pharmacist,7616,1212,8828
47462,Melinde,Stening,msteningbg@mac.com,Graphic Designer,8505,1108,9613
47751,Wynnie,Southall,wsouthallbj@webeden.co.uk,Civil Engineer,6025,913,6938
47999,Ariela,Schermick,aschermickbk@nationalgeographic.com,Cost Accountant,1593,1244,2837
47920,Freemon,Dowall,fdowallbl@disqus.com,Research Nurse,7793,644,8437
47583,Howie,Chadd,hchaddbm@devhub.com,Senior Cost Accountant,4460,256,4716
47224,Denise,Chevins,dchevinsbn@epa.gov,Accountant III,9691,1568,11259
47040,Linnell,Mellings,lmellingsbo@dailymail.co.uk,Research Assistant IV,5562,1962,7524
47373,Dolph,Orme,dormebq@japanpost.jp,Technical Writer,1868,1606,3474
47016,Clair,Lewsey,clewseybs@amazonaws.com,Dental Hygienist,1906,635,2541
47514,Dewitt,Boutcher,dboutcherbv@theatlantic.com,Chemical Engineer,3455,231,3686
47917,Darda,Jakoubec,djakoubecbw@shinystat.com,Information Systems Manager,8145,1996,10141
47066,Klement,Launder,klaunderby@drupal.org,Legal Assistant,9742,565,10307
47706,Van,Turone,vturonebz@addthis.com,Office Assistant III,9713,1670,11383
47054,Aigneis,Clavey,aclaveyc1@myspace.com,Safety Technician II,9624,1825,11449
47943,Sibeal,Checo,schecoc3@go.com,Recruiting Manager,2670,1906,4576
47530,Brynna,Murtell,bmurtellc4@engadget.com,Pharmacist,2904,1542,4446
47117,Raquela,Sirkett,rsirkettc5@japanpost.jp,GIS Technical Architect,6298,567,6865
47922,Donnie,Ellicock,dellicockc6@cnet.com,Speech Pathologist,4018,1201,5219
47352,Odey,McChruiter,omcchruiterc9@themeforest.net,Help Desk Operator,6010,1793,7803
47291,Addison,Joanic,ajoanicca@bloglines.com,Account Executive,7163,1867,9030
47441,Ailey,Easseby,aeassebycc@qq.com,Senior Quality Engineer,2539,1576,4115
47799,Ursulina,Aliberti,ualiberticd@dagondesign.com,Account Coordinator,8519,1789,10308
47403,Vinni,Iveagh,viveaghcf@ovh.net,VP Sales,6599,736,7335
47448,Abbott,Evenden,aevendencg@paypal.com,Senior Developer,4524,1918,6442
47508,Giff,Kemmett,gkemmettcl@pinterest.com,Senior Sales Associate,3897,1849,5746
47389,Pieter,Stott,pstottcm@usnews.com,Teacher,4304,778,5082
47869,Thekla,Feares,tfearescn@earthlink.net,Recruiter,8944,1773,10717
47290,Rowan,Ocheltree,rocheltreecp@vkontakte.ru,Nurse,9683,436,10119
47635,Lidia,McFater,lmcfatercq@opera.com,Administrative Officer,5324,1193,6517
47264,Desmond,Gimbart,dgimbartcs@fema.gov,Editor,3685,1893,5578
47287,Mareah,Hanmer,mhanmerct@wp.com,Environmental Specialist,1486,1763,3249
47521,Viviene,Pedrick,vpedrickcv@last.fm,Marketing Assistant,7958,756,8714
47464,Tori,Winkworth,twinkworthcw@ft.com,Legal Assistant,3678,653,4331
47841,Bing,Reynold,breynoldcx@unesco.org,Programmer IV,3226,505,3731
47676,Connie,Chazerand,cchazerandd0@fc2.com,Junior Executive,2933,798,3731
47350,Lyndsay,Gunthorpe,lgunthorped1@berkeley.edu,Media Manager IV,3003,1398,4401
47393,Kari,Ockland,kocklandd2@unesco.org,Clinical Specialist,5802,480,6282
47781,Torey,Mabley,tmableyd3@stanford.edu,Chemical Engineer,8277,842,9119
47332,Noland,Thraves,nthravesd4@yahoo.com,Electrical Engineer,6507,702,7209
47578,Dulcy,Niese,dniesed5@behance.net,Chief Design Engineer,1216,1858,3074
47369,Ruben,Ianelli,rianellid6@narod.ru,Help Desk Technician,9503,700,10203
47818,Tine,Marcham,tmarchamd7@a8.net,Software Consultant,5564,1996,7560
47821,Cinda,Champ,cchampd8@istockphoto.com,Financial Advisor,2288,480,2768
47126,Amber,Gyenes,agyenesd9@ameblo.jp,Business Systems Development Analyst,7996,1690,9686
47703,Sile,Abrahamoff,sabrahamoffda@drupal.org,Health Coach III,8364,1907,10271
47190,Jillana,Wiggall,jwiggalldc@booking.com,Structural Engineer,9781,373,10154
47645,Arlana,Lea,aleadf@pagesperso-orange.fr,Recruiter,5670,1960,7630
47941,Arnaldo,Hotchkin,ahotchkindg@gmpg.org,Statistician III,6784,1736,8520
47226,Keri,Ellcock,kellcockdh@ox.ac.uk,Social Worker,3658,1364,5022
47911,Parsifal,Zealander,pzealanderdk@vistaprint.com,Community Outreach Specialist,8139,1131,9270
47289,Humbert,Panniers,hpanniersdl@wikia.com,Electrical Engineer,2417,419,2836
47962,Menard,Godilington,mgodilingtondm@cocolog-nifty.com,Product Engineer,7716,511,8227
47759,Freddy,Rubinow,frubinowdo@simplemachines.org,Design Engineer,4555,711,5266
47992,Melodie,Leele,mleeledr@diigo.com,Social Worker,2900,1996,4896
47631,Anne,Manshaw,amanshawdt@typepad.com,General Manager,3152,492,3644
47142,Kain,Palk,kpalkdy@yandex.ru,Financial Analyst,8738,1869,10607
47324,Rafi,Aggas,raggasdz@yahoo.co.jp,Junior Executive,7267,748,8015
47167,Gayleen,Dabbes,gdabbese0@who.int,Sales Representative,3086,637,3723
47905,Lucia,Moncreiff,lmoncreiffe1@ameblo.jp,Staff Accountant IV,5247,725,5972
47059,Sollie,Kiffe,skiffee3@gmpg.org,Staff Scientist,3460,1241,4701
47058,Krissie,Mateu,kmateue4@noaa.gov,Web Developer I,9325,255,9580
47997,Lenore,Ibbison,libbisone5@columbia.edu,Quality Engineer,4798,1399,6197
47228,Aloin,Dickin,adickine9@japanpost.jp,Assistant Manager,6895,1974,8869
47060,Abbie,Iceton,aicetoneb@t.co,Analog Circuit Design manager,6323,296,6619
47073,Raymond,Gives,rgivesec@phpbb.com,Marketing Assistant,3666,1130,4796
47482,Kennan,Warfield,kwarfielded@sitemeter.com,VP Marketing,7454,865,8319
47641,Ted,Twigley,ttwigleyee@imdb.com,Structural Engineer,5481,828,6309
47321,Jessica,Chillcot,jchillcoteg@diigo.com,Statistician III,4582,936,5518
47909,Maude,Welbrock,mwelbrockeh@theglobeandmail.com,Software Test Engineer III,6584,1407,7991
47852,Boote,Tunuy,btunuyei@xing.com,Budget/Accounting Analyst III,9646,259,9905
47839,Ram,Paolozzi,rpaolozziem@twitpic.com,Pharmacist,4031,412,4443
47420,Irene,Easdon,ieasdonen@xing.com,Administrative Assistant I,7540,959,8499
47697,Fonz,Capehorn,fcapehorneq@goodreads.com,Web Designer I,4902,1774,6676
47770,Thea,Leaburn,tleaburner@typepad.com,Environmental Tech,5806,501,6307
47112,Clint,Cockaday,ccockadayeu@alexa.com,Nuclear Power Engineer,3803,500,4303
47730,Sheeree,Jeffcoat,sjeffcoatev@parallels.com,Health Coach IV,1881,1595,3476
47567,Ronald,Cowins,rcowinsey@adobe.com,VP Accounting,4610,1182,5792
47376,Celestyn,Marlow,cmarlowf2@sciencedaily.com,Professor,6286,1422,7708
47590,Ailina,Uphill,auphillf3@google.fr,Technical Writer,1369,1719,3088
47078,Eloisa,Rosenwald,erosenwaldf4@friendfeed.com,VP Sales,3065,1418,4483
47714,Harcourt,Lammert,hlammertf5@dmoz.org,Senior Sales Associate,5243,1578,6821
47669,Teri,Domnin,tdomninf6@discovery.com,Paralegal,5501,910,6411
47936,Mildrid,Curwen,mcurwenf8@usda.gov,Research Assistant III,2360,1598,3958
47387,Cullin,Philippet,cphilippetf9@mozilla.com,Tax Accountant,3641,1941,5582
47972,Niki,Hickford,nhickfordfa@bizjournals.com,Analyst Programmer,6672,390,7062
47077,Rochelle,Van Arsdalen,rvanarsdalenfb@engadget.com,Human Resources Assistant IV,9782,702,10484
47940,Lurline,Pauncefort,lpauncefortfd@microsoft.com,Food Chemist,9268,1753,11021
47602,Sisely,Cereceres,scereceresfe@usnews.com,Help Desk Technician,9411,1888,11299
47463,Ellette,Cheverton,echevertonff@unc.edu,Speech Pathologist,1966,350,2316
47157,Keeley,Soaper,ksoaperfg@is.gd,GIS Technical Architect,1816,1355,3171
47735,Hurlee,Oertzen,hoertzenfh@e-recht24.de,VP Accounting,7778,462,8240
47240,Ardeen,Braun,abraunfi@nih.gov,General Manager,9180,578,9758
47667,Korrie,Churm,kchurmfj@harvard.edu,Clinical Specialist,8873,1025,9898
47326,Bevin,Fitkin,bfitkinfk@walmart.com,Design Engineer,1192,1509,2701
47887,Andra,Fatharly,afatharlyfl@mozilla.com,Software Test Engineer I,9512,1048,10560
47711,Sayres,Fawcitt,sfawcittfn@canalblog.com,Software Consultant,9900,1984,11884
47700,Marc,Sloane,msloanefq@rakuten.co.jp,Food Chemist,7421,915,8336
47234,Marcelle,Guidera,mguiderafr@usatoday.com,Administrative Assistant III,5783,358,6141
47445,Abelard,Skule,askulefw@clickbank.net,Budget/Accounting Analyst III,1060,661,1721
47392,Clevie,Holttom,cholttomfy@wordpress.com,VP Quality Control,9880,1911,11791
47396,Nalani,Cuttings,ncuttingsfz@eepurl.com,Geological Engineer,7446,739,8185
47953,Ragnar,Bridgestock,rbridgestockg0@cornell.edu,Accountant I,4555,1744,6299
47492,Rooney,Pardal,rpardalg1@google.com.hk,Paralegal,1632,916,2548
47857,Freeman,Cruickshank,fcruickshankg2@timesonline.co.uk,Human Resources Manager,4882,472,5354
47571,Marybeth,Whapple,mwhappleg4@51.la,VP Product Management,5317,889,6206
47766,Vitia,Poundsford,vpoundsfordg6@weibo.com,Paralegal,1784,587,2371
47430,Shelley,Butten,sbutteng7@tiny.cc,VP Sales,6796,1515,8311
47297,Inesita,De Vries,idevriesgd@huffingtonpost.com,Accountant III,4370,1561,5931
47723,Avivah,Sreenan,asreenange@tumblr.com,Biostatistician III,1659,578,2237
47951,Pooh,Carlino,pcarlinogk@archive.org,Project Manager,9062,961,10023
47980,Christa,Fennessy,cfennessygl@amazonaws.com,Account Executive,1560,1060,2620
47116,Algernon,Strong,astronggn@acquirethisname.com,Assistant Professor,4114,329,4443
47205,Germana,Philbrook,gphilbrookgo@github.io,Business Systems Development Analyst,2650,1709,4359
47975,Emma,Ridesdale,eridesdalegt@google.it,Junior Executive,4112,528,4640
47932,Damita,Mattiacci,dmattiaccigu@list-manage.com,Financial Analyst,4767,1637,6404
47410,Mahalia,Wannan,mwannangv@tuttocitta.it,Structural Engineer,6158,1084,7242
47805,Fraze,McKim,fmckimgz@51.la,Chief Design Engineer,2772,488,3260
47315,Kellen,Coverdale,kcoverdaleh0@jugem.jp,Structural Analysis Engineer,8863,1000,9863
47771,Alwyn,Hallawell,ahallawellh1@liveinternet.ru,Environmental Tech,5282,1655,6937
47783,Marcos,Summons,msummonsh2@cpanel.net,Computer Systems Analyst III,1793,1741,3534
47629,Dorree,Measor,dmeasorh3@usda.gov,Research Associate,4135,1524,5659
47501,Jsandye,Mardell,jmardellh4@forbes.com,Marketing Assistant,1780,1585,3365
47695,Bob,Pickthorne,bpickthorneh5@over-blog.com,Product Engineer,4598,1807,6405
47472,Kiele,Pawle,kpawleh7@archive.org,Research Associate,1300,500,1800
47610,Lindsy,Priestnall,lpriestnallh9@cargocollective.com,Sales Associate,2863,276,3139
47634,Alair,Prinett,aprinettha@blogger.com,Budget/Accounting Analyst IV,8372,329,8701
47177,Tamara,Trevor,ttrevorhc@rediff.com,Software Engineer I,2128,429,2557
47837,Tanny,Bobasch,tbobaschhf@weebly.com,Chief Design Engineer,1511,1803,3314
47219,Sharon,Rebillard,srebillardhg@macromedia.com,Technical Writer,9828,1881,11709
47960,Bondie,Bradie,bbradiehh@patch.com,Analyst Programmer,4014,277,4291
47505,Clemmy,Hellwing,chellwinghi@statcounter.com,Legal Assistant,9433,704,10137
47844,Ignatius,Gniewosz,igniewoszhj@sphinn.com,Senior Financial Analyst,6543,360,6903
47293,Tabbie,Lipmann,tlipmannhk@bandcamp.com,Analog Circuit Design manager,6511,1387,7898
47011,Rubie,Walkington,rwalkingtonhl@reference.com,Safety Technician IV,8264,836,9100
47866,Michelina,Arrigo,marrigohn@shinystat.com,Office Assistant III,4493,442,4935
47129,Malorie,Daniell,mdaniellhp@salon.com,Actuary,1161,1345,2506
47490,Gipsy,Fideler,gfidelerhr@webs.com,Clinical Specialist,5720,1280,7000
47732,Mead,McIlhagga,mmcilhaggahs@mozilla.org,Accounting Assistant II,5504,365,5869
47935,Corilla,Miko,cmikoht@1688.com,Programmer III,4148,940,5088
47238,Amandie,Hartshorne,ahartshornehv@reddit.com,Software Engineer IV,2721,375,3096
47644,Vernen,Hazeltine,vhazeltinehw@woothemes.com,Marketing Assistant,1811,218,2029
47861,Wit,Wyman,wwymanhz@whitehouse.gov,Human Resources Assistant II,2679,1890,4569
47515,Weider,Parmeter,wparmeteri1@newyorker.com,VP Sales,8821,1781,10602
47074,Roldan,Stebles,rsteblesi2@drupal.org,Account Executive,2099,1143,3242
47812,Raye,Heath,rheathi3@ucoz.ru,Teacher,3866,1914,5780
47739,Bili,Breckon,bbreckoni8@instagram.com,Web Developer I,3731,1013,4744
47506,Ezekiel,Lewknor,elewknoria@nbcnews.com,GIS Technical Architect,5930,677,6607
47459,Irina,Bartczak,ibartczakib@oracle.com,Junior Executive,2597,1437,4034
47737,Pegeen,Spada,pspadaid@amazon.com,Senior Sales Associate,9195,716,9911
47070,Quint,Nanson,qnansonif@cafepress.com,Desktop Support Technician,1637,448,2085
47938,Myer,Rao,mraoii@forbes.com,Junior Executive,4917,428,5345
47696,Caralie,Quigg,cquiggij@bigcartel.com,Sales Representative,9945,402,10347
47120,Allix,Beatey,abeateyim@squarespace.com,Budget/Accounting Analyst I,1830,454,2284
47592,Violette,Gabbatiss,vgabbatissir@aboutads.info,Research Associate,5832,522,6354
47043,Malynda,Golt,mgoltit@ucoz.com,Community Outreach Specialist,8554,338,8892
47705,Ashlin,O'Lyhane,aolyhaneiu@examiner.com,Nurse,1128,1757,2885
47993,Joeann,Rivlin,jrivlinj0@creativecommons.org,Tax Accountant,9667,326,9993
47668,Rip,Tamlett,rtamlettj1@example.com,Senior Developer,4093,1384,5477
47933,Levin,Cramond,lcramondj2@t-online.de,Media Manager IV,7526,1226,8752
47555,Vaughan,Pentlow,vpentlowj3@drupal.org,Director of Sales,9963,1845,11808
47871,Archy,Bamborough,abamboroughj4@yellowbook.com,Structural Analysis Engineer,4365,1181,5546
47260,Britta,Laste,blastej7@myspace.com,Environmental Tech,7043,925,7968
47038,Bo,Antonikov,bantonikovj8@sciencedirect.com,Editor,2629,663,3292
47323,Norean,Whilder,nwhilderjb@mysql.com,Marketing Manager,9040,1906,10946
47449,Cornie,Lesslie,clessliejh@cdbaby.com,Nurse,4368,654,5022
47945,Enoch,Davidesco,edavidescoji@state.tx.us,Nuclear Power Engineer,4261,1133,5394
47974,Shirleen,Latch,slatchjl@youku.com,Physical Therapy Assistant,2359,1490,3849
47435,Kristos,MacIllrick,kmacillrickjo@slate.com,Assistant Media Planner,2794,1541,4335
47270,Berta,Maciunas,bmaciunasjp@weather.com,Nurse Practicioner,9243,640,9883
47500,Gwenni,Hebblewaite,ghebblewaitejq@boston.com,Recruiting Manager,3257,1822,5079
47189,Gerhardine,Tregunnah,gtregunnahjx@netvibes.com,Assistant Professor,8221,1587,9808
47243,Sarene,Chazette,schazettejy@reference.com,Accounting Assistant II,8368,583,8951
47545,Way,Novik,wnovikk6@pcworld.com,Research Nurse,1444,580,2024
47383,Timothea,Asel,taselk7@github.io,Librarian,1090,1242,2332
47851,Elga,Mogg,emoggk8@usda.gov,VP Accounting,8589,1605,10194
47597,Elizabeth,Stede,estedekb@census.gov,Recruiting Manager,9077,582,9659
47987,Cherie,Frood,cfroodkc@whitehouse.gov,Graphic Designer,9501,394,9895
47433,Vladimir,Whittles,vwhittleskd@alexa.com,Geologist IV,3759,1269,5028
47516,Minna,Ratt,mrattkk@macromedia.com,Sales Associate,6761,1136,7897
47627,Rossy,Manston,rmanstonkl@foxnews.com,Senior Cost Accountant,9173,1643,10816
47171,Carol-jean,Dyott,cdyottkn@webeden.co.uk,Quality Control Specialist,9165,1246,10411
47395,Jo,Marielle,jmarielleko@ca.gov,Engineer III,7290,1467,8757
47704,Rafaello,Gimenez,rgimenezkp@purevolume.com,Technical Writer,7713,1571,9284
47495,Merle,Curthoys,mcurthoysks@cbsnews.com,Junior Executive,8229,645,8874
47888,Petronella,Freschi,pfreschikt@ebay.com,Paralegal,8641,297,8938
47385,Darren,Polle,dpolleky@unicef.org,Community Outreach Specialist,1704,754,2458
47333,Regina,Sugg,rsuggl1@domainmarket.com,Recruiter,7617,1842,9459
47019,Shawn,Peacop,speacopl6@quantcast.com,Senior Editor,7560,940,8500
47458,Em,Nutbean,enutbeanl8@indiegogo.com,Health Coach IV,4124,1228,5352
47443,Rudolfo,Alsina,ralsinal9@vimeo.com,Research Assistant IV,1015,806,1821
47923,Cayla,Kadar,ckadarle@ebay.co.uk,Assistant Manager,4600,1191,5791
47409,Teressa,Meynell,tmeynelllf@microsoft.com,Research Nurse,5887,481,6368
47418,Grethel,Linck,glincklj@cnn.com,Dental Hygienist,9855,1556,11411
47868,Cassius,Campbell-Dunlop,ccampbelldunloplm@samsung.com,Recruiting Manager,7345,1813,9158
47944,Irita,Amar,iamarln@huffingtonpost.com,Civil Engineer,9110,1961,11071
47091,Gustaf,Boichat,gboichatlp@is.gd,Professor,2613,1458,4071
47893,Ruth,Balsellie,rbalsellielq@exblog.jp,Social Worker,4999,1212,6211
47539,Phaidra,Wedderburn,pwedderburnlr@cdc.gov,Nuclear Power Engineer,8834,1768,10602
47823,Jock,Cremer,jcremerlu@springer.com,General Manager,4036,931,4967
47672,Clare,Varian,cvarianm8@ycombinator.com,Media Manager IV,6317,1141,7458
47954,Boyd,O'Donohue,bodonohuem9@prnewswire.com,Food Chemist,8311,1988,10299
47712,Phil,Tyzack,ptyzackmb@telegraph.co.uk,Project Manager,9334,1388,10722
47170,Rozelle,Chaffen,rchaffenmd@w3.org,Chemical Engineer,4198,788,4986
47169,Dougy,Lippi,dlippime@hexun.com,Geological Engineer,1667,1429,3096
47903,Maura,Izard,mizardmg@ezinearticles.com,VP Product Management,8112,213,8325
47487,Tarra,Blomfield,tblomfieldmm@vistaprint.com,Media Manager IV,9392,1433,10825
47246,Corinne,Portriss,cportrissmn@ycombinator.com,Associate Professor,1326,1466,2792
47648,Augusto,Athelstan,aathelstanmq@over-blog.com,VP Marketing,1390,1442,2832
47927,Antonio,Creamen,acreamenmr@tiny.cc,Accounting Assistant II,4922,678,5600
47163,Bartolemo,Clubbe,bclubbemt@ocn.ne.jp,Programmer Analyst II,7288,1190,8478
47915,Chicky,Parnell,cparnellmw@imageshack.us,Software Test Engineer III,1916,623,2539
47429,Edeline,McReedy,emcreedymx@godaddy.com,Nurse Practicioner,1663,499,2162
47507,Wat,Bleas,wbleasmy@1und1.de,Web Designer II,2521,1396,3917
47298,Esma,Melan,emelanmz@guardian.co.uk,VP Sales,4565,308,4873
47272,Sigfried,Revill,srevilln3@unc.edu,Geological Engineer,8988,1066,10054
47808,Lethia,Triplett,ltriplettn4@google.co.jp,Human Resources Assistant II,8688,1071,9759
47928,Collette,Pavolillo,cpavolillon5@cbc.ca,VP Sales,6383,1209,7592
47451,Alexei,Telfer,atelfern8@wufoo.com,Structural Engineer,6769,656,7425
47257,Devin,Pilpovic,dpilpovicn9@about.com,Recruiter,6473,393,6866
47788,Abram,Baldassi,abaldassinc@usda.gov,Senior Sales Associate,2921,1972,4893
47550,Lyndy,Lidgate,llidgatene@networksolutions.com,Senior Financial Analyst,6634,1122,7756
47864,Maible,Beardsall,mbeardsallnf@list-manage.com,Technical Writer,1726,1305,3031
47089,Abigale,Lawson,alawsonnh@usatoday.com,Associate Professor,9512,1406,10918
47311,Elmira,Ragless,eraglessni@rakuten.co.jp,Structural Analysis Engineer,1273,1241,2514
47108,Corine,Akister,cakisternj@wunderground.com,Accountant IV,1585,1543,3128
47673,Lezley,Lilbourne,llilbournenl@nhs.uk,Marketing Assistant,1788,446,2234
47657,Randene,Reuss,rreussnn@indiegogo.com,Operator,1136,1579,2715
47692,Suzy,Ossenna,sossennanr@ocn.ne.jp,Staff Scientist,5846,277,6123
47265,Lewiss,Creavan,lcreavanns@sfgate.com,Research Nurse,7778,1098,8876
47569,Felisha,Malinson,fmalinsonnt@hibu.com,Sales Associate,8602,307,8909
47318,Fransisco,Simonelli,fsimonellinw@washingtonpost.com,Data Coordiator,7752,1664,9416
47524,Merline,Laxtonne,mlaxtonnenz@yelp.com,Programmer Analyst IV,6087,1408,7495
47824,Rubi,Keynes,rkeyneso2@state.tx.us,Junior Executive,3502,421,3923
47185,Karissa,Tutchener,ktutchenero3@feedburner.com,Data Coordiator,1493,1854,3347
47268,Blake,Batterbee,bbatterbeeo5@nationalgeographic.com,VP Accounting,1683,646,2329
47979,Carmelle,Alfuso,calfusoo6@wikispaces.com,Geologist IV,8534,604,9138
47926,Arthur,Verna,avernao8@bbb.org,Senior Editor,1880,309,2189
47218,Julissa,Cubley,jcubleyob@furl.net,Statistician II,5842,1360,7202
47519,Dare,McQuaid,dmcquaidod@chronoengine.com,Legal Assistant,6624,682,7306
47804,Imelda,Cattach,icattachof@hexun.com,Sales Associate,4721,1999,6720
47416,Luciana,Konerding,lkonerdingoj@addthis.com,Quality Control Specialist,7915,1865,9780
47570,Janessa,Cramer,jcramerok@ocn.ne.jp,Senior Cost Accountant,2014,556,2570
47518,Duff,Etchell,detchellon@nymag.com,Internal Auditor,6181,1930,8111
47278,Keith,Canny,kcannyop@nps.gov,Payment Adjustment Coordinator,7280,1372,8652
47989,Pryce,Bour,pbouroq@zdnet.com,VP Marketing,8034,1322,9356
47191,Ermina,Rowlstone,erowlstoneov@howstuffworks.com,Budget/Accounting Analyst I,7879,503,8382
47702,Dulsea,Farryan,dfarryanow@samsung.com,Speech Pathologist,4458,1806,6264
47632,Winfield,Fiddian,wfiddianoz@joomla.org,Sales Associate,4728,207,4935
47113,Taylor,De la Eglise,tdelaeglisep3@vimeo.com,GIS Technical Architect,6991,711,7702
47067,Tobie,Devennie,tdevenniep6@ustream.tv,Senior Developer,9204,525,9729
47184,Gabrila,Slyde,gslydepc@technorati.com,Internal Auditor,9476,1187,10663
47860,Jo-ann,Lunam,jlunampd@pinterest.com,Marketing Assistant,8817,1883,10700
47048,Maryellen,Moens,mmoenspe@icio.us,Database Administrator II,7759,448,8207
47100,Flo,Costain,fcostainpf@dropbox.com,Analog Circuit Design manager,3301,910,4211
47148,Isidoro,Blackshaw,iblackshawph@nps.gov,Operator,2002,1019,3021
47055,Carmelia,Vannini,cvanninipj@cafepress.com,Web Developer III,3053,488,3541
47833,Barde,Polamontayne,bpolamontaynepk@networkadvertising.org,Community Outreach Specialist,5133,433,5566
47988,Giacopo,Fryers,gfryerspo@deviantart.com,Environmental Specialist,4855,1226,6081
47470,Leroy,Andrich,landrichpp@uol.com.br,Clinical Specialist,3926,920,4846
47063,Miof mela,Saunderson,msaundersonpq@vkontakte.ru,Graphic Designer,5457,1147,6604
47707,Rafaelia,Castelow,rcastelowpr@stanford.edu,VP Quality Control,8189,1102,9291
47485,Horton,Latchmore,hlatchmorepu@europa.eu,Executive Secretary,7521,1164,8685
47407,Osbert,Gianiello,ogianiellopz@globo.com,Librarian,2681,318,2999
47344,Morgan,Janeczek,mjaneczekq0@twitpic.com,Senior Sales Associate,9905,995,10900
47801,Clarance,Maydway,cmaydwayq2@cocolog-nifty.com,Associate Professor,7215,264,7479
47853,Maxwell,Haliburton,mhaliburtonq3@wordpress.com,General Manager,8607,1571,10178
47081,Niccolo,Barnhill,nbarnhillq6@cnn.com,Account Coordinator,2758,1862,4620
47862,Aurel,Sawtell,asawtellq9@woothemes.com,Nurse Practicioner,8994,1265,10259
47491,Duke,Frane,dfraneqa@reverbnation.com,Web Developer III,5752,1177,6929
47890,Armand,Courtney,acourtneyqb@sitemeter.com,Database Administrator II,5106,1031,6137
47983,Terencio,Sloat,tsloatqc@theglobeandmail.com,Geological Engineer,7858,719,8577
47225,Estelle,Ivers,eiversqd@microsoft.com,Budget/Accounting Analyst III,5678,286,5964
47964,Mitchel,Purshouse,mpurshouseqe@businessweek.com,Budget/Accounting Analyst I,9453,1494,10947
47716,Reg,Cullen,rcullenqg@vkontakte.ru,Financial Analyst,8478,1509,9987
47674,Loria,Coddrington,lcoddringtonqi@reverbnation.com,Desktop Support Technician,9678,1540,11218
47425,Aldo,Mathews,amathewsqj@discovery.com,Programmer III,6400,1682,8082
47910,Marlow,de Savery,mdesaveryqm@washington.edu,Chemical Engineer,1411,877,2288
47854,Gasparo,Snoding,gsnodingqn@sina.com.cn,Quality Control Specialist,5955,1585,7540
47591,Ingamar,Burrells,iburrellsqr@java.com,Assistant Manager,6743,961,7704
47670,Ernestus,Marquess,emarquessqs@icq.com,VP Sales,8127,401,8528
47386,Nollie,Henriquet,nhenriquetqt@eepurl.com,Quality Control Specialist,5053,1614,6667
47701,Clemmy,Badcock,cbadcockqw@soup.io,Payment Adjustment Coordinator,2536,1168,3704
47899,Craggie,Vickors,cvickorsqy@phoca.cz,Developer II,9419,1217,10636
47208,Cicely,Mathelin,cmathelinqz@rakuten.co.jp,Data Coordiator,1650,874,2524
47663,Dora,Torre,dtorrer5@tumblr.com,Legal Assistant,7022,676,7698
47722,Astrix,Dirkin,adirkinr6@desdev.cn,Marketing Manager,9287,1732,11019
47664,Yale,Jarrett,yjarrettr7@ning.com,General Manager,5586,700,6286
47217,Ali,Bridgens,abridgensrc@cbslocal.com,Compensation Analyst,7862,919,8781
47052,Ugo,Watmore,uwatmorerh@surveymonkey.com,Staff Scientist,5230,618,5848
47647,Bert,Winsley,bwinsleyrl@redcross.org,Automation Specialist IV,8614,1156,9770
47137,Ardath,Elie,aeliern@ucoz.com,Help Desk Operator,4153,231,4384
47195,Mathew,Mathy,mmathyro@nydailynews.com,Senior Developer,5164,431,5595
1259,Wilfrid,Gimeno,wgimeno0@pcworld.com,Accountant I,2331,644,2975
1314,Lawry,Rawling,lrawling1@intel.com,Financial Analyst,5707,1175,6882
1174,Angy,Horstead,ahorstead2@delicious.com,Senior Developer,2538,1107,3645
1523,Tamqrah,Hacon,thacon3@timesonline.co.uk,Accountant II,7320,1180,8500
1951,Bonny,Witcherley,bwitcherley4@skyrock.com,Biostatistician II,4934,1364,6298
1962,Una,Blay,ublay5@goo.ne.jp,Graphic Designer,2264,980,3244
1783,Tonie,Gallier,tgallier6@imdb.com,Graphic Designer,9011,886,9897
1117,Onofredo,Pasby,opasby7@twitter.com,Statistician III,3126,543,3669
1599,Kameko,Rodmell,krodmell8@nba.com,Help Desk Operator,3639,1543,5182
1207,Winslow,Siggs,wsiggs9@bigcartel.com,Account Coordinator,3349,1917,5266
1753,Isac,Alenin,ialenina@nature.com,Assistant Media Planner,5262,375,5637
1242,Patty,Yezafovich,pyezafovichb@etsy.com,Recruiting Manager,2524,1081,3605
1111,Timotheus,Primmer,tprimmerc@istockphoto.com,Quality Engineer,8347,263,8610
1838,Chloris,Aris,carisd@phoca.cz,Food Chemist,1014,942,1956
1138,Cheryl,Heake,cheakee@ifeng.com,Environmental Specialist,9756,954,10710
1453,Fedora,Armsby,farmsbyf@rakuten.co.jp,Social Worker,8970,1834,10804
1232,Jarrad,Tomasek,jtomasekg@forbes.com,Account Executive,3139,466,3605
1084,Byran,Kernermann,bkernermannh@umich.edu,Systems Administrator I,3969,481,4450
1262,Ker,Duchart,kducharti@vkontakte.ru,Senior Editor,6093,1101,7194
1615,Laureen,Furmonger,lfurmongerj@about.com,General Manager,3737,277,4014
1115,Terrence,Glowacki,tglowackik@chron.com,Compensation Analyst,2105,1959,4064
1629,Nathalie,Cuvley,ncuvleyl@w3.org,Graphic Designer,1993,622,2615
1901,Emmie,Carcas,ecarcasm@google.co.jp,Web Developer III,4385,1783,6168
1842,Harbert,Toderbrugge,htoderbruggen@wikimedia.org,Librarian,4478,841,5319
1947,Morlee,Drayton,mdraytono@mozilla.org,Nuclear Power Engineer,5807,684,6491
1927,Mattias,Skerme,mskermep@nasa.gov,Media Manager IV,8851,1305,10156
1762,Shepherd,Ghio,sghioq@fema.gov,Tax Accountant,8382,854,9236
1204,Marlena,Tingley,mtingleyr@hao123.com,Compensation Analyst,3633,302,3935
1063,Lon,Neary,lnearys@friendfeed.com,Help Desk Technician,1644,578,2222
1374,Calla,Orbine,corbinet@liveinternet.ru,Research Associate,2243,1939,4182
1935,Paulette,Eloy,peloyu@dedecms.com,Cost Accountant,1653,684,2337
1371,Brewer,Deverose,bdeverosev@timesonline.co.uk,Actuary,2726,1011,3737
1282,Araldo,Annable,aannablew@nps.gov,Editor,9938,1433,11371
1874,Dorolisa,Stalf,dstalfx@state.tx.us,Marketing Assistant,4150,944,5094
1197,Carmon,Neeves,cneevesy@blinklist.com,Research Assistant IV,7471,1030,8501
1012,Anson,Gauthorpp,agauthorppz@skype.com,Recruiting Manager,4453,1263,5716
1985,Ulberto,Cathie,ucathie10@csmonitor.com,Registered Nurse,3958,359,4317
1605,Clementina,Kingswoode,ckingswoode11@salon.com,Software Test Engineer IV,8571,1360,9931
1894,Liana,Wildman,lwildman12@vinaora.com,Compensation Analyst,7064,605,7669
1254,Jennie,Swatradge,jswatradge13@weibo.com,VP Sales,3205,867,4072
1589,Thebault,Edgerley,tedgerley14@pcworld.com,Research Associate,5195,1374,6569
1645,Baillie,Souten,bsouten15@newyorker.com,Paralegal,5597,1311,6908
1710,Fidelia,MacVean,fmacvean16@booking.com,Marketing Manager,4275,823,5098
1493,Rosalia,Leyborne,rleyborne17@google.it,Physical Therapy Assistant,3428,1232,4660
1983,Danit,Bagnall,dbagnall18@uol.com.br,Accountant IV,1408,1725,3133
1619,Sophronia,Wagnerin,swagnerin19@1688.com,Research Associate,4719,1223,5942
1850,Pincus,Ell,pell1a@auda.org.au,Senior Editor,7255,1209,8464
1557,Jaquith,Wrathall,jwrathall1c@wikia.com,Sales Representative,7952,1002,8954
1568,Kippy,Gowen,kgowen1d@godaddy.com,Technical Writer,2056,277,2333
1972,Fairlie,Lucken,flucken1g@independent.co.uk,Programmer Analyst IV,7575,1635,9210
1720,Cammy,Flicker,cflicker1h@arstechnica.com,Electrical Engineer,5295,668,5963
1503,Ambrose,Nealon,anealon1i@accuweather.com,Executive Secretary,9431,744,10175
1163,Corinna,Rainbow,crainbow1j@amazon.co.jp,Software Engineer II,1482,1000,2482
1108,Burnaby,Josse,bjosse1k@hatena.ne.jp,Editor,2245,1944,4189
1482,Salli,Mangeney,smangeney1l@telegraph.co.uk,Statistician II,7059,872,7931
1121,Alissa,Boomes,aboomes1m@quantcast.com,Recruiting Manager,7185,1792,8977
1752,Sam,Balaizot,sbalaizot1n@cdc.gov,Structural Analysis Engineer,2046,437,2483
1087,Hyacinthe,Whotton,hwhotton1o@opera.com,Software Consultant,7767,1636,9403
1165,Rivkah,Possel,rpossel1p@tuttocitta.it,Associate Professor,3677,1815,5492
1714,Wally,Scyone,wscyone1q@meetup.com,Dental Hygienist,5860,1835,7695
1819,Sissy,Hamper,shamper1r@360.cn,Marketing Manager,2773,1696,4469
1562,Almeta,Adame,aadame1s@reuters.com,Account Representative IV,4491,1536,6027
1300,Jaimie,Hendrik,jhendrik1t@google.co.jp,Assistant Professor,8994,454,9448
1155,Rorke,Tute,rtute1u@edublogs.org,Sales Associate,6862,421,7283
1997,Violante,Spall,vspall1v@senate.gov,Structural Engineer,4587,1314,5901
1724,Chrysa,Shuard,cshuard1w@myspace.com,Nurse,9046,1358,10404
1600,Beverie,Gethouse,bgethouse1x@cnbc.com,Help Desk Technician,8731,996,9727
1537,Lance,Linebarger,llinebarger20@hc360.com,Structural Engineer,3651,1155,4806
1829,Fina,Ludron,fludron21@hc360.com,Structural Analysis Engineer,9006,710,9716
1917,Zollie,Ulrik,zulrik22@mit.edu,Staff Scientist,3948,600,4548
1541,Meghan,Coolican,mcoolican23@edublogs.org,Analyst Programmer,6435,587,7022
1215,Christy,Acheson,cacheson24@home.pl,Senior Developer,3398,449,3847
1388,Stirling,Curtoys,scurtoys25@yandex.ru,Technical Writer,4394,491,4885
1134,Warden,Caitlin,wcaitlin26@cbslocal.com,Recruiting Manager,8212,1291,9503
1237,Peta,Annakin,pannakin27@xinhuanet.com,Research Nurse,1262,1759,3021
1851,Angus,Izatson,aizatson28@1688.com,Safety Technician IV,6034,1287,7321
1756,Dallas,Dradey,ddradey29@disqus.com,Nurse,5331,1629,6960
1409,Godard,McCalum,gmccalum2a@globo.com,Associate Professor,7729,293,8022
1194,Godfrey,Zupo,gzupo2b@addthis.com,Pharmacist,5781,1816,7597
1469,June,Fintoph,jfintoph2c@github.com,Electrical Engineer,2541,1620,4161
1665,Karisa,Filde,kfilde2d@booking.com,Mechanical Systems Engineer,8566,429,8995
1941,Alvina,Roseaman,aroseaman2e@nih.gov,Actuary,8785,1982,10767
1809,Xenos,Ohanessian,xohanessian2f@time.com,Account Representative II,3977,898,4875
1140,Filippo,Shedd,fshedd2g@psu.edu,Teacher,9184,1544,10728
1323,Daisi,Eakin,deakin2h@storify.com,Research Nurse,8002,459,8461
1244,Rahel,Bowdery,rbowdery2i@vkontakte.ru,Food Chemist,6834,632,7466
1091,Evvy,Sokill,esokill2j@huffingtonpost.com,Engineer II,1975,699,2674
1210,Juli,Lamlin,jlamlin2k@ftc.gov,Professor,5509,1046,6555
1592,Kathryn,Oldham,koldham2l@ifeng.com,Professor,4046,1833,5879
1281,Engelbert,Devitt,edevitt2m@gnu.org,Software Test Engineer II,2435,481,2916
1502,Isidor,Borsnall,iborsnall2n@wordpress.com,Physical Therapy Assistant,4187,1546,5733
1045,Flss,Stuer,fstuer2o@businessweek.com,Database Administrator III,5973,1468,7441
1149,Nichole,Rhymer,nrhymer2p@baidu.com,Business Systems Development Analyst,3262,400,3662
1889,Bertha,Maccrea,bmaccrea2q@vistaprint.com,VP Quality Control,5516,1029,6545
1171,Tonya,Ransfield,transfield2r@liveinternet.ru,Civil Engineer,9744,792,10536
1046,Laurena,Schreiner,lschreiner2s@4shared.com,Sales Representative,5496,242,5738
1946,Cristie,Bauldry,cbauldry2t@google.es,VP Marketing,6867,1220,8087
1125,Jordana,Russo,jrusso2u@va.gov,Health Coach IV,2048,238,2286
1186,Zsazsa,Paulig,zpaulig2v@omniture.com,Statistician IV,8757,392,9149
1773,Tye,Hyams,thyams2w@w3.org,Occupational Therapist,9506,709,10215
1995,Evan,Akister,eakister2x@imageshack.us,Computer Systems Analyst II,2165,1163,3328
1025,Hartley,Andresen,handresen2y@npr.org,Associate Professor,8490,1605,10095
1732,Carol-jean,Mee,cmee30@elegantthemes.com,Senior Cost Accountant,5803,1416,7219
1890,Cinnamon,McFetrich,cmcfetrich31@nps.gov,VP Sales,4488,504,4992
1799,Willette,Snowman,wsnowman32@harvard.edu,Software Engineer III,9101,1214,10315
1276,Hewitt,Rogerson,hrogerson33@vkontakte.ru,Clinical Specialist,1264,512,1776
1731,Shermy,Chrippes,schrippes34@ucoz.com,VP Product Management,6131,1126,7257
1844,Lanny,Adger,ladger36@skyrock.com,Pharmacist,1468,1416,2884
1636,Chester,Bilney,cbilney37@virginia.edu,Technical Writer,2454,1859,4313
1345,Joly,Varley,jvarley38@mozilla.org,Quality Engineer,5641,880,6521
1751,Carma,Ber,cber39@cmu.edu,Associate Professor,8579,1713,10292
1402,Elia,Gagg,egagg3b@feedburner.com,Accountant I,2770,1625,4395
1682,Avivah,Chazerand,achazerand3c@patch.com,VP Accounting,6966,743,7709
1590,Libbie,Chillistone,lchillistone3d@accuweather.com,Engineer I,8733,1173,9906
1580,Valentia,Gunningham,vgunningham3e@go.com,Administrative Assistant II,2307,1118,3425
1626,Humphrey,Tassell,htassell3g@squidoo.com,Marketing Assistant,3410,1746,5156
1343,Ellerey,Barczynski,ebarczynski3h@creativecommons.org,Design Engineer,6254,634,6888
1375,Julian,Honig,jhonig3i@macromedia.com,Tax Accountant,4784,885,5669
1102,Matilda,Thrower,mthrower3k@irs.gov,VP Accounting,7886,1197,9083
1392,Justen,Abramovitch,jabramovitch3l@google.ca,Software Engineer I,3444,1981,5425
1123,Mallory,McMullen,mmcmullen3m@nytimes.com,Structural Analysis Engineer,8154,990,9144
1302,Trudey,Kewish,tkewish3n@whitehouse.gov,General Manager,4395,1183,5578
1431,Chelsae,Adolfsen,cadolfsen3o@wsj.com,Health Coach I,9068,1860,10928
1335,Yalonda,Wenderott,ywenderott3p@psu.edu,Paralegal,7184,1626,8810
1957,Erinn,Stebbings,estebbings3s@npr.org,Help Desk Operator,1122,1168,2290
1602,Carmel,Mordaunt,cmordaunt3t@twitter.com,Staff Scientist,9129,1491,10620
1316,Abeu,Whatley,awhatley3u@un.org,Clinical Specialist,9021,665,9686
1514,Morrie,Ripley,mripley3v@latimes.com,Biostatistician III,6062,1226,7288
1795,Lonna,Dagger,ldagger3w@icio.us,Engineer III,1543,250,1793
1401,Valeria,Learoid,vlearoid3y@cbsnews.com,Help Desk Operator,6220,1589,7809
1648,Eric,Menault,emenault3z@mac.com,Administrative Assistant II,3997,745,4742
1275,Nariko,Pineaux,npineaux40@usnews.com,Senior Editor,8080,934,9014
1794,Jeffrey,Ghest,jghest41@craigslist.org,Executive Secretary,5673,1953,7626
1532,Gerome,Shackell,gshackell42@naver.com,Recruiter,5840,1635,7475
1325,Janka,Kerry,jkerry43@google.com.br,Software Engineer I,5876,1482,7358
1200,Melinda,Lohrensen,mlohrensen44@ning.com,Sales Representative,4448,420,4868
1036,Adriena,Dadge,adadge45@ning.com,Web Developer III,5020,1056,6076
1771,Skipton,Pirie,spirie46@hhs.gov,Mechanical Systems Engineer,4838,1039,5877
1755,Laurie,Szimon,lszimon47@amazonaws.com,Electrical Engineer,9293,1675,10968
1396,Ellerey,Balch,ebalch48@shutterfly.com,Environmental Tech,6009,655,6664
1446,Giulietta,Riceards,griceards49@latimes.com,Account Representative II,5955,1006,6961
1247,Jere,Skillern,jskillern4a@nih.gov,Food Chemist,3751,1171,4922
1840,Mirabelle,Burr,mburr4b@ovh.net,Media Manager III,8474,486,8960
1810,Heather,Klamman,hklamman4c@csmonitor.com,Professor,6480,1614,8094
1494,Nari,Marriner,nmarriner4d@stumbleupon.com,Desktop Support Technician,6767,1684,8451
1439,Jae,Connor,jconnor4e@upenn.edu,Statistician III,1974,1719,3693
1749,Muffin,Roon,mroon4f@360.cn,Automation Specialist I,8559,1489,10048
1139,Lyndsey,Listone,llistone4h@nsw.gov.au,Programmer Analyst II,6073,1821,7894
1668,Lawton,Zoren,lzoren4i@ustream.tv,Clinical Specialist,4124,1502,5626
1584,Cymbre,McNea,cmcnea4j@odnoklassniki.ru,Occupational Therapist,3314,301,3615
1879,Ardith,Spencley,aspencley4k@wordpress.com,Senior Quality Engineer,9473,894,10367
1372,Robbi,Kilpin,rkilpin4m@un.org,Sales Representative,6857,1222,8079
1673,Tine,Ruddiforth,truddiforth4n@prweb.com,Recruiter,5210,1430,6640
1845,Carmelia,Ondrousek,condrousek4o@mysql.com,Quality Engineer,3485,776,4261
1717,Rowen,Appleby,rappleby4p@prnewswire.com,Assistant Professor,1964,1393,3357
1869,Chloris,Meeron,cmeeron4q@reuters.com,Computer Systems Analyst II,9745,1233,10978
1598,Abbe,Haslehurst,ahaslehurst4r@bbb.org,Geologist IV,3106,1033,4139
1796,Verna,McPhillips,vmcphillips4s@apache.org,Office Assistant III,1883,1259,3142
1740,Ryun,Bowhay,rbowhay4u@google.com.br,Internal Auditor,7430,1756,9186
1987,Jefferey,Pasek,jpasek4v@meetup.com,Sales Representative,4058,1567,5625
1958,Renie,Solomonides,rsolomonides4w@bloomberg.com,Marketing Manager,3659,617,4276
1837,Harwell,Fittis,hfittis4x@pen.io,Pharmacist,8537,274,8811
1680,Ginevra,Willetts,gwilletts4z@com.com,Software Test Engineer III,5625,1740,7365
1236,Katy,Bricket,kbricket50@sogou.com,Environmental Specialist,8675,649,9324
1070,Shari,Pourvoieur,spourvoieur51@qq.com,Registered Nurse,5945,602,6547
1816,Juliane,Neylan,jneylan52@sakura.ne.jp,Occupational Therapist,1148,1644,2792
1925,Patience,Arnaez,parnaez53@vistaprint.com,Environmental Specialist,8940,1276,10216
1764,Hank,Carr,hcarr54@so-net.ne.jp,Assistant Manager,9747,1570,11317
1412,Poppy,Curle,pcurle56@chicagotribune.com,Nurse,6580,513,7093
1772,Benedicto,Morgon,bmorgon57@uol.com.br,Occupational Therapist,7170,990,8160
1758,Catrina,Blythin,cblythin59@whitehouse.gov,Registered Nurse,6149,1664,7813
1612,Brendan,MacGown,bmacgown5a@berkeley.edu,Research Assistant II,7638,576,8214
1333,Adriana,Lettley,alettley5c@virginia.edu,Systems Administrator II,2766,1859,4625
1882,Hamel,Bubbear,hbubbear5d@nih.gov,Electrical Engineer,3097,1701,4798
1113,Sanderson,Sugars,ssugars5e@jugem.jp,Recruiting Manager,5457,390,5847
1090,Virge,Shreenan,vshreenan5f@sbwire.com,Director of Sales,3084,682,3766
1991,Trista,Ryland,tryland5g@oakley.com,Help Desk Operator,7084,566,7650
1069,Sollie,Steane,ssteane5i@fc2.com,Occupational Therapist,9446,1744,11190
1147,Florida,Robbel,frobbel5j@trellian.com,Tax Accountant,8870,1859,10729
1603,Aigneis,Reijmers,areijmers5k@cmu.edu,Environmental Tech,2942,303,3245
1777,Bianca,Maw,bmaw5l@ehow.com,Executive Secretary,9267,1819,11086
1344,Loretta,Prandin,lprandin5m@biblegateway.com,Software Test Engineer III,2401,1784,4185
1684,Kristina,Gwatkin,kgwatkin5p@salon.com,Paralegal,4311,1577,5888
1881,Gonzalo,Gibbonson,ggibbonson5r@theguardian.com,VP Quality Control,2814,1206,4020
1235,Felecia,Kivelhan,fkivelhan5s@plala.or.jp,Senior Quality Engineer,1176,244,1420
1766,Kali,Salatino,ksalatino5t@youtu.be,Developer IV,5667,1342,7009
1006,Elaina,Elden,eelden5v@amazon.co.uk,Marketing Assistant,4006,1361,5367
1263,Hyacinth,Lomb,hlomb5x@blogspot.com,Automation Specialist III,3252,723,3975
1824,Briggs,Morat,bmorat5z@businessinsider.com,Human Resources Manager,6855,1939,8794
1228,Corly,Mussotti,cmussotti60@cam.ac.uk,Structural Analysis Engineer,3605,1838,5443
1382,Appolonia,Rhelton,arhelton61@ebay.co.uk,Assistant Professor,9697,1686,11383
1126,Rubin,Cridge,rcridge63@digg.com,Computer Systems Analyst III,5867,793,6660
1130,Alfons,Tunnick,atunnick64@mapquest.com,Assistant Professor,1127,1745,2872
1367,Rip,Gadd,rgadd65@aboutads.info,Software Engineer I,1240,1896,3136
1757,Chanda,Fillary,cfillary66@example.com,Legal Assistant,6052,1796,7848
1550,Blancha,Phebee,bphebee67@gizmodo.com,Structural Engineer,5670,400,6070
1255,Alano,Wanstall,awanstall68@ovh.net,Graphic Designer,4589,1088,5677
1043,Lewie,Filip,lfilip69@scientificamerican.com,Senior Quality Engineer,3052,506,3558
1921,Claudia,Mungham,cmungham6a@princeton.edu,Quality Engineer,8970,446,9416
1251,Ginni,Birkmyr,gbirkmyr6b@nhs.uk,Assistant Manager,7438,1699,9137
1199,Ludovico,Gislebert,lgislebert6c@diigo.com,VP Sales,1544,363,1907
1038,Nate,Brasse,nbrasse6d@ustream.tv,Chemical Engineer,8817,1829,10646
1644,Dione,Guerro,dguerro6e@umn.edu,Programmer I,7142,1717,8859
1945,Darda,Petroselli,dpetroselli6f@google.de,Executive Secretary,2178,1192,3370
1779,Cobbie,Glisane,cglisane6g@blogs.com,Software Consultant,4282,223,4505
1029,Inness,Kienlein,ikienlein6i@privacy.gov.au,Teacher,6007,1384,7391
1065,Selma,Hawarden,shawarden6k@auda.org.au,Food Chemist,8800,1641,10441
1539,Vincent,Longmate,vlongmate6l@usatoday.com,Nurse,2014,1211,3225
1895,Lark,Dillicate,ldillicate6n@mapquest.com,Executive Secretary,3927,1708,5635
1410,Shelbi,Puller,spuller6o@posterous.com,Software Engineer IV,1111,1212,2323
1487,Christoper,Youhill,cyouhill6p@etsy.com,Occupational Therapist,3426,1863,5289
1699,Phillie,Hanks,phanks6q@apple.com,Staff Scientist,6416,1235,7651
1715,Theresa,Douglass,tdouglass6r@about.me,Media Manager I,4791,604,5395
1811,Alfreda,Beckingham,abeckingham6s@salon.com,Account Executive,2533,707,3240
1990,Rickard,Adnams,radnams6u@booking.com,Budget/Accounting Analyst II,3190,1042,4232
1745,Zorina,Benam,zbenam6w@dailymail.co.uk,Director of Sales,1084,1692,2776
1030,Anna-maria,Quadling,aquadling6x@ifeng.com,Marketing Assistant,3976,393,4369
1597,Hermia,Shama,hshama6y@geocities.com,Financial Analyst,3437,1404,4841
1317,Dylan,Bettridge,dbettridge6z@hud.gov,Senior Quality Engineer,9994,1823,11817
1681,Whitman,Dono,wdono70@techcrunch.com,Automation Specialist I,7888,522,8410
1258,Nico,Heinrich,nheinrich71@java.com,Research Assistant II,6330,597,6927
1478,Drona,Guage,dguage72@marriott.com,Geologist III,8383,1224,9607
1269,Linnell,Yandell,lyandell74@t.co,Clinical Specialist,7051,1382,8433
1032,Clementine,Labell,clabell76@amazon.co.uk,Actuary,2190,662,2852
1184,Josepha,Batterton,jbatterton77@yahoo.co.jp,Speech Pathologist,3098,1410,4508
1691,Jarad,Gervaise,jgervaise78@tamu.edu,GIS Technical Architect,6588,783,7371
1071,Valene,Jacox,vjacox7a@behance.net,Assistant Media Planner,5075,608,5683
1566,Hortensia,Burdell,hburdell7b@yandex.ru,Account Coordinator,5248,570,5818
1650,Barr,Warre,bwarre7d@bigcartel.com,Internal Auditor,8122,1977,10099
1977,Dexter,Bockler,dbockler7e@eventbrite.com,Chemical Engineer,7252,1958,9210
1577,Cortie,Radley,cradley7f@army.mil,Marketing Manager,1056,601,1657
1114,Hymie,Cuncliffe,hcuncliffe7g@istockphoto.com,Safety Technician I,2892,1924,4816
1703,Sutton,Houson,shouson7h@nyu.edu,Desktop Support Technician,3160,1821,4981
1196,Everard,Vidgen,evidgen7i@xrea.com,Programmer I,7505,1700,9205
1544,Donny,Pasfield,dpasfield7j@oakley.com,Director of Sales,4797,1889,6686
1923,Sheffie,Winsbury,swinsbury7k@vkontakte.ru,Staff Accountant III,7419,939,8358
1801,Beth,Swidenbank,bswidenbank7l@ustream.tv,VP Sales,4740,1680,6420
1609,Binky,Guilleton,bguilleton7m@ycombinator.com,Mechanical Systems Engineer,7587,1442,9029
1060,Meredith,Berwick,mberwick7n@go.com,Senior Financial Analyst,9511,635,10146
1304,Andriette,Bartolic,abartolic7o@weibo.com,Project Manager,2519,322,2841
1154,Jedediah,Turbard,jturbard7p@mozilla.com,Compensation Analyst,8705,1634,10339
1168,Ewan,Avramow,eavramow7q@ox.ac.uk,Financial Analyst,8763,566,9329
1411,Barthel,Rickardes,brickardes7r@theatlantic.com,Environmental Specialist,5337,450,5787
1760,Davidson,Pryell,dpryell7t@prlog.org,General Manager,8276,482,8758
1862,Daffi,Foan,dfoan7u@salon.com,Nuclear Power Engineer,4719,1643,6362
1129,Cyrill,Rawlingson,crawlingson7v@columbia.edu,Financial Analyst,6387,1261,7648
1831,Lucille,Huglin,lhuglin7w@cocolog-nifty.com,Librarian,1087,255,1342
1697,Afton,Toquet,atoquet7x@apple.com,Technical Writer,1931,383,2314
1746,Dalia,Presslee,dpresslee7z@altervista.org,Research Associate,7209,1688,8897
1658,Cory,Linskey,clinskey80@artisteer.com,Executive Secretary,3188,300,3488
1675,Jedidiah,Hourihane,jhourihane81@ask.com,Web Designer I,8464,788,9252
1238,Natty,Jordeson,njordeson82@lycos.com,Paralegal,9296,1324,10620
1416,Husain,Krimmer,hkrimmer83@eepurl.com,Cost Accountant,6284,965,7249
1934,Chip,Tregian,ctregian85@reference.com,Financial Analyst,3523,1877,5400
1843,Mariam,Eckersley,meckersley86@cocolog-nifty.com,Librarian,2759,1028,3787
1094,Aguie,Pidon,apidon88@europa.eu,Nurse Practicioner,1475,1331,2806
1329,Rustie,Croucher,rcroucher89@paginegialle.it,Analog Circuit Design manager,5639,392,6031
1041,Art,Stubbington,astubbington8a@gizmodo.com,Programmer II,6528,254,6782
1364,Valaria,Mirrlees,vmirrlees8b@woothemes.com,Associate Professor,9509,1266,10775
1160,Ted,Geindre,tgeindre8d@naver.com,Geological Engineer,3953,1103,5056
1452,Judi,Calbert,jcalbert8e@umich.edu,Analyst Programmer,7607,1595,9202
1423,Aubrey,Ashling,aashling8g@cnn.com,Help Desk Operator,4172,1818,5990
1015,Thebault,Dauney,tdauney8h@ihg.com,Help Desk Technician,9204,1930,11134
1826,Ninnetta,Soigoux,nsoigoux8i@google.ru,Media Manager IV,9677,564,10241
1538,Frieda,Boot,fboot8j@shareasale.com,Director of Sales,4563,484,5047
1319,Karel,Dreigher,kdreigher8k@npr.org,Quality Control Specialist,1869,1301,3170
1127,Dane,Mariette,dmariette8l@ameblo.jp,Dental Hygienist,1400,1081,2481
1230,Conrado,Kattenhorn,ckattenhorn8n@so-net.ne.jp,Help Desk Technician,1971,978,2949
1103,Gaby,Izard,gizard8o@wikispaces.com,Senior Sales Associate,3018,454,3472
1981,Jeremiah,Richard,jrichard8p@dot.gov,Senior Developer,2800,1325,4125
1574,Anita,Flanagan,aflanagan8r@nytimes.com,Administrative Assistant IV,5696,479,6175
1280,Fax,Welton,fwelton8s@tamu.edu,Staff Scientist,2056,630,2686
2000,Ivor,Shaxby,ishaxby8t@123-reg.co.uk,Marketing Manager,8332,885,9217
1456,Jillene,Hawker,jhawker8u@alexa.com,Financial Advisor,9754,1729,11483
1376,Ida,Caveney,icaveney8v@gov.uk,Software Test Engineer II,8405,304,8709
1352,Merilee,Skitch,mskitch8w@ebay.com,Legal Assistant,9771,1329,11100
1971,Merle,Hayers,mhayers8z@cisco.com,Help Desk Technician,8986,1507,10493
1499,Friedrich,Rickardsson,frickardsson90@dailymail.co.uk,Food Chemist,5501,1002,6503
1835,Lindsy,Bottleson,lbottleson92@youtube.com,Software Test Engineer IV,4424,1738,6162
1705,Barbee,Simmens,bsimmens94@google.com.au,Paralegal,5631,1223,6854
1098,Nerita,De Rye Barrett,nderyebarrett96@sbwire.com,Quality Control Specialist,3259,1055,4314
1118,Fulton,McClelland,fmcclelland97@hibu.com,Design Engineer,1214,463,1677
1803,Lanna,Chettoe,lchettoe98@goo.gl,Clinical Specialist,9908,525,10433
1864,Tomas,Bangham,tbangham99@squarespace.com,Nurse,3539,1229,4768
1759,Kerk,Hartegan,khartegan9a@edublogs.org,Software Engineer II,4311,320,4631
1664,Gael,Goforth,ggoforth9b@drupal.org,Systems Administrator II,2276,1085,3361
1967,Edwina,Grennan,egrennan9c@google.cn,Automation Specialist II,4770,275,5045
1606,Penelope,Perrie,pperrie9d@ning.com,VP Product Management,8459,1393,9852
1719,Selestina,Leabeater,sleabeater9f@bandcamp.com,Assistant Media Planner,2935,1526,4461
1039,Nathalie,Bushnell,nbushnell9i@slate.com,Human Resources Manager,7736,777,8513
1739,Korrie,Leggat,kleggat9j@cdbaby.com,General Manager,7360,1439,8799
1018,Durant,Hollyar,dhollyar9k@bandcamp.com,Registered Nurse,5557,712,6269
1019,Abbe,Duchenne,aduchenne9l@blogger.com,Pharmacist,8143,1703,9846
1338,Jermaine,Anger,janger9m@ezinearticles.com,Health Coach I,4906,1447,6353
1782,Pauly,Bigley,pbigley9n@thetimes.co.uk,Nurse,1672,1244,2916
1786,Carri,Haskett,chaskett9p@addthis.com,Account Coordinator,8597,1614,10211
1942,Gaylor,Oughtright,goughtright9q@google.com,Nurse Practicioner,5758,820,6578
1310,Ferdinande,Barnwille,fbarnwille9r@angelfire.com,Research Nurse,9066,1852,10918
1591,Ivy,Tatlow,itatlow9s@sciencedaily.com,Executive Secretary,2559,344,2903
1763,Waly,Castanaga,wcastanaga9t@redcross.org,Environmental Tech,8063,1164,9227
1742,Aida,Gerssam,agerssam9u@canalblog.com,Systems Administrator IV,4550,1663,6213
1257,Maryrose,Perrigo,mperrigo9v@artisteer.com,Office Assistant IV,6350,1143,7493
1226,Brittani,Bartusek,bbartusek9z@tripadvisor.com,Software Engineer II,5244,1906,7150
1479,Jamie,Boughtwood,jboughtwooda0@barnesandnoble.com,Statistician III,3485,555,4040
1513,Daffie,Brumbie,dbrumbiea3@va.gov,Senior Sales Associate,7976,1234,9210
1785,Helenelizabeth,Dailey,hdaileya4@ebay.com,Help Desk Operator,9442,1196,10638
1067,Paulina,Salerg,psalerga5@discovery.com,Information Systems Manager,6090,631,6721
1980,Hattie,Loveman,hlovemana6@seattletimes.com,Help Desk Technician,4626,959,5585
1004,Marcy,Eassom,meassoma7@paypal.com,Clinical Specialist,4484,1603,6087
1283,Danielle,Drysdale,ddrysdalea8@ustream.tv,Programmer Analyst III,6953,984,7937
1556,Payton,Shackell,pshackella9@flickr.com,Food Chemist,2551,934,3485
1932,Romola,Weston,rwestonaa@state.gov,Database Administrator II,5855,1993,7848
1218,Barbette,Bramer,bbramerab@ezinearticles.com,Senior Financial Analyst,6623,293,6916
1944,Riane,Aldins,raldinsac@discuz.net,Project Manager,3854,1724,5578
1460,Mychal,Spivey,mspiveyad@answers.com,Executive Secretary,5202,812,6014
1738,Averyl,Sage,asageae@alibaba.com,Data Coordiator,2742,602,3344
1522,Timothee,Phelps,tphelpsaf@linkedin.com,Marketing Manager,6771,1341,8112
1462,Harriette,Danilovich,hdanilovichag@tamu.edu,Design Engineer,5880,1137,7017
1417,Pembroke,Pallent,ppallentaj@usgs.gov,Professor,6622,742,7364
1064,Elianore,Ranahan,eranahanak@simplemachines.org,Help Desk Technician,7265,1051,8316
1571,Herman,Pavese,hpaveseal@gov.uk,Software Consultant,4862,683,5545
1110,Adara,Tolomelli,atolomelliao@elpais.com,Biostatistician IV,4553,1031,5584
1660,Claire,Rands,crandsap@moonfruit.com,Assistant Media Planner,5953,598,6551
1695,Vonnie,Tokell,vtokellaq@bbb.org,Quality Engineer,7497,1485,8982
1298,Colin,Paddington,cpaddingtonar@ocn.ne.jp,Graphic Designer,1092,213,1305
1959,Irina,Daldry,idaldryas@dropbox.com,VP Product Management,5833,1875,7708
1775,Harland,Girodon,hgirodonaw@engadget.com,Senior Developer,8360,580,8940
1707,Faustine,Hargreave,fhargreaveax@amazon.com,Staff Accountant III,4871,842,5713
1727,Marcello,Dray,mdrayb1@guardian.co.uk,Structural Analysis Engineer,6520,1935,8455
1320,Gilli,Beaney,gbeaneyb4@techcrunch.com,Senior Editor,9340,1638,10978
1442,Law,Brightling,lbrightlingb7@reverbnation.com,Dental Hygienist,3917,1261,5178
1596,Blakeley,Paten,bpatenb8@nasa.gov,Occupational Therapist,9226,1137,10363
1996,Nikolaos,Cruxton,ncruxtonba@hhs.gov,Accountant III,6110,1295,7405
1306,Florella,O'Sculley,fosculleybb@cdbaby.com,Assistant Professor,7620,856,8476
1533,Herold,Mattersey,hmatterseybc@paginegialle.it,Desktop Support Technician,1262,322,1584
1774,Jennie,Ramirez,jramirezbd@amazonaws.com,Project Manager,5139,1986,7125
1307,Marigold,Duckwith,mduckwithbf@etsy.com,Chemical Engineer,7442,1191,8633
1169,Sutherlan,Stolz,sstolzbg@pagesperso-orange.fr,Analog Circuit Design manager,2391,730,3121
1857,Clerissa,Sisley,csisleybh@instagram.com,Physical Therapy Assistant,2876,1980,4856
1219,Ber,McNickle,bmcnicklebi@techcrunch.com,Product Engineer,4509,1102,5611
1943,Ofella,Scawn,oscawnbj@hp.com,Geologist IV,8564,917,9481
1628,Delila,Maccaig,dmaccaigbk@nhs.uk,Help Desk Operator,2960,1359,4319
1208,Zandra,Bradbeer,zbradbeerbl@epa.gov,Desktop Support Technician,8218,396,8614
1074,Gerda,Kettlestringe,gkettlestringebm@cdc.gov,Research Associate,9763,1006,10769
1001,Richmond,Byram,rbyrambn@google.pl,Operator,5158,1700,6858
1334,Pansy,Perceval,ppercevalbo@netvibes.com,Senior Editor,9112,1847,10959
1655,Shurlock,Yeowell,syeowellbq@state.tx.us,Engineer IV,7738,1468,9206
1924,Kalvin,Lipson,klipsonbr@elpais.com,Web Designer IV,4863,540,5403
1808,Johnathon,Raulin,jraulinbt@creativecommons.org,Dental Hygienist,8335,1129,9464
1721,Vonni,Dumphries,vdumphriesbu@topsy.com,Occupational Therapist,8900,728,9628
1948,Barron,Shutte,bshuttebv@cnbc.com,Quality Engineer,4849,311,5160
1728,Uriel,Waghorne,uwaghornebw@twitpic.com,Design Engineer,8538,901,9439
1066,Lise,Fisbburne,lfisbburnebx@statcounter.com,Administrative Officer,1785,1991,3776
1520,Hestia,Haddleston,hhaddlestonby@wp.com,Quality Engineer,5106,298,5404
1659,Alic,McGeffen,amcgeffenc0@flavors.me,Community Outreach Specialist,2157,1519,3676
1914,Kory,Klambt,kklambtc1@homestead.com,Sales Associate,5911,589,6500
1817,Eugene,Kingham,ekinghamc2@jalbum.net,Teacher,3794,943,4737
1601,Wenona,Behnecken,wbehneckenc9@europa.eu,VP Accounting,9144,1074,10218
1776,Britt,Tumini,btuminicb@comcast.net,Senior Sales Associate,8048,1931,9979
1853,Floria,Santello,fsantellocc@ameblo.jp,Tax Accountant,4497,868,5365
1922,Dulcine,Caton,dcatoncd@ted.com,Engineer IV,2092,1599,3691
1515,Cymbre,Chesters,cchestersce@technorati.com,Director of Sales,7570,705,8275
1476,Samson,Mathiasen,smathiasencf@yahoo.co.jp,Pharmacist,2489,1196,3685
1348,Fitz,Blenkhorn,fblenkhorncl@salon.com,Systems Administrator IV,8907,684,9591
1026,Gratia,Tivers,gtiverscm@sakura.ne.jp,Environmental Tech,3017,1061,4078
1447,Marmaduke,Adess,madesscn@loc.gov,Help Desk Technician,2786,624,3410
1049,Meggi,Cudbird,mcudbirdco@deviantart.com,Technical Writer,6114,1404,7518
1157,Blayne,Dresse,bdressecp@yolasite.com,Technical Writer,1130,1731,2861
1287,Douglass,Revie,dreviecq@imgur.com,Staff Scientist,6253,331,6584
1436,Barbabra,Dunne,bdunnecs@ucsd.edu,Librarian,6208,1660,7868
1841,Halsy,Earle,hearlecu@opensource.org,Information Systems Manager,4926,1808,6734
1744,Noreen,Jenicke,njenickecx@g.co,Help Desk Technician,1321,1450,2771
1459,Brien,Stroder,bstrodercy@wikia.com,Civil Engineer,6904,1943,8847
1383,Shane,Jardin,sjardincz@blogger.com,Human Resources Manager,6099,231,6330
1002,Christian,Knotte,cknotted0@nhs.uk,Structural Analysis Engineer,6798,699,7497
1172,Linnet,Esbrook,lesbrookd2@mac.com,Human Resources Manager,4358,1735,6093
1530,Guy,Yeatman,gyeatmand3@comsenz.com,Recruiting Manager,5927,1431,7358
1802,Eryn,Garlic,egarlicd5@1688.com,Accounting Assistant IV,8238,1814,10052
1342,Danyette,Loades,dloadesd6@about.com,Marketing Assistant,1846,1543,3389
1747,Shel,McKnockiter,smcknockiterd7@zdnet.com,Electrical Engineer,6785,328,7113
1350,Scarlet,Siehard,ssiehardd8@abc.net.au,Safety Technician I,8677,918,9595
1189,Shea,Eck,seckd9@xing.com,Professor,7673,336,8009
1916,Jennica,Scarsbrick,jscarsbrickdb@dropbox.com,Marketing Assistant,5443,655,6098
1173,Prent,Lowdwell,plowdwelldc@google.com.au,Community Outreach Specialist,4580,420,5000
1355,Alan,Rainger,araingerdd@usa.gov,Account Executive,8982,1174,10156
1387,Almeria,Charman,acharmande@miibeian.gov.cn,Electrical Engineer,2070,1754,3824
1181,Tulley,Blackie,tblackiedf@bloomberg.com,Environmental Tech,7618,390,8008
1477,Magdalen,Rodgier,mrodgierdi@apple.com,Help Desk Operator,4096,1028,5124
1567,Trevor,Hymas,thymasdj@ustream.tv,Chemical Engineer,9979,694,10673
1938,Kali,Traice,ktraicedo@senate.gov,Help Desk Operator,6869,1047,7916
1073,Darb,Ley,dleydq@un.org,Biostatistician III,9516,250,9766
1712,Noble,Crowth,ncrowthdv@symantec.com,Web Designer III,9578,1249,10827
1620,Arlen,Crocker,acrockerdx@vk.com,Nurse Practicioner,1250,1490,2740
1528,Hewet,Chillistone,hchillistonee0@alibaba.com,Developer II,6998,765,7763
1100,Rebekkah,Bissill,rbissille3@dagondesign.com,Structural Analysis Engineer,1911,380,2291
1020,Gerrie,Snoxill,gsnoxille4@wired.com,Clinical Specialist,6846,1309,8155
1828,Ashly,Cominetti,acominettie5@163.com,Staff Accountant IV,5209,1345,6554
1909,Hermann,Pellissier,hpellissiere8@nationalgeographic.com,Mechanical Systems Engineer,8601,1615,10216
1616,Carlita,Troppmann,ctroppmanne9@shareasale.com,Internal Auditor,9497,910,10407
1305,Florie,Birdis,fbirdisea@skype.com,Administrative Officer,2479,678,3157
1463,Ericka,Brimblecomb,ebrimblecombed@ameblo.jp,Mechanical Systems Engineer,5924,944,6868
1162,Carlin,Trustie,ctrustieee@seesaa.net,Desktop Support Technician,8172,1186,9358
1761,Scotti,Ladd,sladdef@marriott.com,Sales Associate,8097,215,8312
1866,Mireille,Grinin,mgrinineg@dailymotion.com,Computer Systems Analyst III,3950,1941,5891
1231,Odessa,Ballinger,oballingerei@columbia.edu,Programmer Analyst I,6973,1368,8341
1982,Margie,Spohr,mspohrej@accuweather.com,VP Marketing,1859,1625,3484
1618,Mayor,Stripling,mstriplingek@edublogs.org,Environmental Specialist,4018,1797,5815
1351,Freida,Keeley,fkeeleyel@unicef.org,Human Resources Manager,1373,611,1984
1034,Llewellyn,Joreau,ljoreauem@lulu.com,Speech Pathologist,4897,1899,6796
1778,Pauletta,Tregiddo,ptregiddoeo@nature.com,Biostatistician I,8828,1789,10617
1542,Rosalinde,McArthur,rmcarthurep@pagesperso-orange.fr,Senior Developer,9336,1844,11180
1734,Dawna,Fenelon,dfenelones@meetup.com,Pharmacist,6920,1000,7920
1690,Clair,Kiddell,ckiddellet@nyu.edu,Staff Scientist,7888,803,8691
1633,Lilli,Reddihough,lreddihougheu@jimdo.com,Analog Circuit Design manager,4386,1220,5606
1552,Cly,Raggett,craggettev@toplist.cz,Business Systems Development Analyst,2335,470,2805
1868,Umeko,Brockwell,ubrockwellex@google.ru,Staff Accountant II,2205,1344,3549
1998,Harp,Loffhead,hloffheadez@foxnews.com,Junior Executive,1324,267,1591
1365,Abelard,O'Hoolahan,aohoolahanf0@ox.ac.uk,Research Assistant II,5828,1921,7749
1082,Nataline,Attwill,nattwillf2@flavors.me,Senior Editor,2308,1727,4035
1797,Archy,Schorah,aschorahf3@hud.gov,Administrative Officer,7122,1287,8409
1212,Kellia,Pomeroy,kpomeroyf4@icq.com,Geologist I,1841,482,2323
1743,Forbes,Marke,fmarkef5@indiegogo.com,VP Accounting,7554,1826,9380
1748,Maxim,Linturn,mlinturnf7@bigcartel.com,Recruiting Manager,9112,1734,10846
1671,Bink,Lyman,blymanf8@yahoo.co.jp,Marketing Manager,4482,1483,5965
1135,Drona,Monck,dmonckfa@geocities.jp,Marketing Assistant,7425,213,7638
1080,Maressa,Killimister,mkillimisterfg@examiner.com,Software Test Engineer IV,8849,560,9409
1952,Maurie,Thwaites,mthwaitesfi@unblog.fr,Electrical Engineer,3298,413,3711
1549,Byram,Martschke,bmartschkefl@psu.edu,Assistant Professor,3046,1090,4136
1930,Maryanne,Misk,mmiskfo@xrea.com,Clinical Specialist,6707,595,7302
1780,Hilarius,Paeckmeyer,hpaeckmeyerfp@jiathis.com,Occupational Therapist,9882,399,10281
1877,Shannah,Castilla,scastillafr@time.com,Quality Control Specialist,3451,295,3746
1674,Dannel,Feasby,dfeasbyfs@abc.net.au,Data Coordiator,6536,713,7249
1150,Marmaduke,Arrighi,marrighift@uiuc.edu,Analog Circuit Design manager,1325,1017,2342
1330,Bentley,Layfield,blayfieldfu@a8.net,Food Chemist,1162,1955,3117
1413,Phip,Sieghard,psieghardfv@loc.gov,Marketing Assistant,7663,1556,9219
1284,Carlen,Klimas,cklimasfw@cnn.com,Pharmacist,1139,1456,2595
1634,Hildagard,Roman,hromanfx@census.gov,Automation Specialist IV,2539,503,3042
1867,Joyan,Loadman,jloadmanfz@usgs.gov,Research Associate,5188,1292,6480
1312,Wood,Ortega,wortegag0@instagram.com,Physical Therapy Assistant,7895,733,8628
1010,Ruperto,Bellerby,rbellerbyg1@google.cn,Civil Engineer,5311,282,5593
1501,Avery,Fayerbrother,afayerbrotherg2@ftc.gov,Senior Editor,2246,1556,3802
1395,Renee,Pickburn,rpickburng4@scribd.com,Recruiting Manager,2123,1188,3311
1662,Sven,Drain,sdraing5@moonfruit.com,Sales Associate,6757,1732,8489
1266,Lissy,McCrillis,lmccrillisg6@pen.io,Analog Circuit Design manager,8173,859,9032
1873,Georgi,Widdop,gwiddopg7@mit.edu,Software Consultant,1393,1510,2903
1670,Andreana,Derill,aderillg9@edublogs.org,Software Test Engineer IV,8246,930,9176
1737,Cully,Durdy,cdurdyga@cafepress.com,Information Systems Manager,1006,225,1231
1250,Pepito,Aumerle,paumerlegb@reverbnation.com,Chief Design Engineer,2500,1999,4499
1891,Lawrence,Inchley,linchleygc@ehow.com,Community Outreach Specialist,8052,439,8491
1031,Parrnell,Bothie,pbothiegh@bigcartel.com,Social Worker,1275,1011,2286
1309,Stacie,Gray,sgraygi@cpanel.net,Geologist II,3502,976,4478
1518,Bastien,Weinham,bweinhamgk@virginia.edu,Teacher,2563,364,2927
1332,Kalie,le Keux,klekeuxgn@admin.ch,Executive Secretary,3044,251,3295
1545,Sydel,Esposito,sespositogp@webnode.com,Software Consultant,4939,653,5592
1233,Garret,Demead,gdemeadgs@disqus.com,Web Designer III,6928,420,7348
1765,Elliot,Kulas,ekulasgt@ycombinator.com,Systems Administrator I,2156,998,3154
1435,Abigale,Ledingham,aledinghamgu@unblog.fr,Structural Engineer,6840,1565,8405
1527,Margarethe,Stanlock,mstanlockgv@istockphoto.com,Graphic Designer,5251,915,6166
1708,Caroljean,Hackin,chackingw@artisteer.com,General Manager,3960,633,4593
1976,Bess,Pontefract,bpontefractgx@histats.com,Safety Technician I,5773,1162,6935
1009,Paloma,Matteotti,pmatteottigy@dyndns.org,Accounting Assistant I,4909,211,5120
1264,Mariana,Condy,mcondyh0@hostgator.com,Software Consultant,6559,1373,7932
1075,Julee,Kleinsmuntz,jkleinsmuntzh1@ocn.ne.jp,Geological Engineer,7855,969,8824
1077,Rowe,Goold,rgooldh3@forbes.com,Safety Technician III,4873,885,5758
1161,Raffaello,Scrowby,rscrowbyh4@weebly.com,Senior Cost Accountant,8218,1377,9595
1920,Jedidiah,Winterflood,jwinterfloodh6@tripadvisor.com,Engineer III,5836,1250,7086
1718,Connie,Tort,ctorth7@imageshack.us,Sales Associate,3259,939,4198
1637,Sonny,Wethey,swetheyhb@kickstarter.com,Teacher,5033,1255,6288
1525,Kirby,Pykett,kpyketthd@wiley.com,Environmental Specialist,4510,772,5282
1726,Reagen,Wolfindale,rwolfindalehf@chicagotribune.com,General Manager,9677,1151,10828
1679,Billie,Reilingen,breilingenhh@meetup.com,Pharmacist,8006,233,8239
1640,Daniella,Pirouet,dpirouethm@vk.com,Web Developer IV,7399,1613,9012
1022,Vanda,Drogan,vdroganhp@about.me,Graphic Designer,7567,565,8132
1595,Isidora,Fruen,ifruenhr@wikimedia.org,Analyst Programmer,9260,1602,10862
1464,Emmy,Coulthard,ecoulthardhu@baidu.com,Payment Adjustment Coordinator,8067,1492,9559
1586,Andria,Kassidy,akassidyhv@nytimes.com,Associate Professor,9985,1977,11962
1490,Wilden,Loach,wloachhw@wp.com,Internal Auditor,3350,1620,4970
1613,Jerrold,Cestard,jcestardhx@ow.ly,VP Quality Control,7688,1813,9501
1221,Gwenora,Trimmill,gtrimmillhz@dailymail.co.uk,VP Product Management,6908,620,7528
1050,Georgine,Eastwood,geastwoodi0@go.com,VP Sales,5706,1435,7141
1085,Adan,Verson,aversoni2@ycombinator.com,Graphic Designer,5361,1057,6418
1725,Jesse,Lamyman,jlamymani3@zimbio.com,Administrative Officer,5268,1680,6948
1594,Germayne,Boteman,gbotemani5@hugedomains.com,VP Sales,9735,747,10482
1195,Lesly,Goodwyn,lgoodwyni7@squidoo.com,Mechanical Systems Engineer,5805,1760,7565
1178,Emlyn,Elfe,eelfei9@mit.edu,Help Desk Technician,3710,1604,5314
1420,Ermanno,Lorenc,elorencia@yelp.com,Data Coordiator,3879,654,4533
1666,Shurwood,O Mullen,somullenic@fc2.com,Graphic Designer,4828,922,5750
1434,Risa,Mc Carrick,rmccarrickid@wikimedia.org,Research Assistant II,1835,744,2579
1969,Ericha,Kowal,ekowalie@freewebs.com,Budget/Accounting Analyst II,6544,886,7430
1994,Kimbra,Woolger,kwoolgerif@forbes.com,Data Coordiator,5985,1852,7837
1159,Perla,Shepley,pshepleyih@slate.com,Nuclear Power Engineer,1108,1007,2115
1044,Matthaeus,Tettley,mtettleyij@dailymail.co.uk,Product Engineer,1956,418,2374
1903,Pansie,Hillitt,phillittin@studiopress.com,Web Designer II,8426,777,9203
1461,Claudius,Schimoni,cschimoniis@fema.gov,Cost Accountant,4875,332,5207
1639,Kasey,Filippozzi,kfilippozziiu@geocities.com,Human Resources Manager,9493,282,9775
1359,Shea,Punchard,spunchardiv@spiegel.de,Administrative Assistant II,3925,1578,5503
1193,Jamey,Whitsey,jwhitseyiy@irs.gov,Associate Professor,3671,939,4610
1906,Connie,Rahlof,crahlofiz@ibm.com,Librarian,9288,1642,10930
1328,Leslie,Aberkirder,laberkirderj0@google.co.jp,Senior Sales Associate,5462,1056,6518
1651,Goraud,Fosse,gfossej1@nba.com,Computer Systems Analyst II,6153,1338,7491
1791,Mord,Alfonso,malfonsoj3@yahoo.com,Sales Associate,8503,696,9199
1249,Norene,Bambery,nbamberyj4@uol.com.br,Financial Analyst,6059,1894,7953
1908,Ken,Birtwistle,kbirtwistlej6@stumbleupon.com,Junior Executive,2577,447,3024
1205,Marve,Bulle,mbullej8@delicious.com,Statistician II,9040,1420,10460
1956,Pepita,Gayden,pgaydenjb@dell.com,Quality Control Specialist,3648,499,4147
1936,Garland,Tolson,gtolsonjc@hostgator.com,Executive Secretary,7197,1563,8760
1142,Felix,Tran,ftranjd@hc360.com,Financial Advisor,3110,966,4076
1450,Myrlene,Winspar,mwinsparje@webeden.co.uk,Account Coordinator,6021,605,6626
1119,Shae,Harvett,sharvettjh@nih.gov,Research Nurse,5598,774,6372
1389,Tallie,Nannizzi,tnannizziji@woothemes.com,Pharmacist,5503,495,5998
1141,Weider,Whitney,wwhitneyjj@princeton.edu,Internal Auditor,9785,1435,11220
1106,Alleyn,Kubera,akuberajk@hibu.com,Chemical Engineer,5437,336,5773
1968,Valaria,Giovanazzi,vgiovanazzijl@cnn.com,VP Accounting,4707,432,5139
1381,Elyssa,Deuss,edeussjn@army.mil,Senior Sales Associate,2963,1886,4849
1437,Laird,Brazel,lbrazeljo@reverbnation.com,Professor,5755,1622,7377
1678,Tedman,Craighead,tcraigheadjq@mapquest.com,Analog Circuit Design manager,8777,1835,10612
1187,Kaye,Burnie,kburnieju@barnesandnoble.com,Research Associate,5506,359,5865
1003,Yorke,Fellgate,yfellgatejv@wisc.edu,Web Developer I,6336,1564,7900
1013,Rodrique,Andriveau,randriveaujw@economist.com,Mechanical Systems Engineer,8967,687,9654
1315,Mercy,Ghelerdini,mghelerdinijz@sun.com,Internal Auditor,8111,1809,9920
1896,Phillie,Pues,ppuesk1@skype.com,Project Manager,6337,743,7080
1898,Trish,Elgram,telgramk3@amazon.co.uk,VP Accounting,1145,952,2097
1467,Richmond,Digan,rdigank5@tamu.edu,Research Assistant I,5205,1195,6400
1729,Gregor,Leare,glearek6@macromedia.com,Internal Auditor,9537,1076,10613
1483,Martainn,Oxherd,moxherdk8@quantcast.com,Software Consultant,8891,476,9367
1702,Shaina,Hurdiss,shurdisskd@pcworld.com,Budget/Accounting Analyst III,6152,1970,8122
1272,Doloritas,Cerman,dcermankj@t-online.de,Staff Scientist,7284,1233,8517
1509,Robin,Champkins,rchampkinskk@nymag.com,Financial Analyst,7057,1944,9001
1356,Jaime,Willerstone,jwillerstonekl@narod.ru,Social Worker,4811,1674,6485
1587,Row,Lepope,rlepopekm@chron.com,Associate Professor,4410,1158,5568
1846,Cindi,Ebhardt,cebhardtkp@sogou.com,Graphic Designer,6181,1604,7785
1081,Scottie,Gaunter,sgaunterku@sourceforge.net,Librarian,3826,1588,5414
1524,Amalee,Jobb,ajobbkw@furl.net,Account Representative III,7510,1373,8883
1804,Luisa,Arkley,larkleykx@hud.gov,Structural Analysis Engineer,3356,1246,4602
1192,Dru,Grigorescu,dgrigorescuky@mac.com,VP Product Management,9285,1947,11232
1369,Elroy,Nelm,enelml0@addtoany.com,Biostatistician III,7934,1954,9888
1883,Bobinette,Lavington,blavingtonl3@un.org,VP Marketing,2461,1675,4136
1654,Blythe,Risbrough,brisbroughl4@skype.com,Chemical Engineer,9291,1598,10889
1871,Anna-diana,Pitway,apitwayl7@nih.gov,Staff Accountant IV,4269,1787,6056
1978,Alfons,Robardey,arobardeyl9@cbsnews.com,Marketing Assistant,3444,817,4261
1128,Ray,Portriss,rportrisslc@usnews.com,Administrative Officer,5668,1135,6803
1092,Tito,Burdess,tburdessld@economist.com,Senior Financial Analyst,7210,744,7954
1166,Willard,Broadberrie,wbroadberrielg@icio.us,VP Accounting,9038,1858,10896
1560,Christoforo,Fransman,cfransmanlj@sciencedaily.com,Teacher,5282,261,5543
1643,Gay,McGeouch,gmcgeouchll@soup.io,Community Outreach Specialist,7464,282,7746
1913,Albrecht,Heaford,aheafordln@umich.edu,Assistant Media Planner,4538,265,4803
1324,Normie,Wratten,nwrattenlo@usda.gov,Senior Developer,5885,1206,7091
1185,Clem,Elwel,celwells@toplist.cz,Senior Financial Analyst,2896,1988,4884
1122,Gunar,Patershall,gpatershalllu@scribd.com,Payment Adjustment Coordinator,4114,1047,5161
1688,Randene,Pretti,rprettilw@cdbaby.com,Account Representative IV,8648,1075,9723
1625,Adan,Farry,afarrylx@cisco.com,Nurse Practicioner,9286,258,9544
1653,Arvie,Parlatt,aparlattly@symantec.com,Administrative Assistant II,3392,835,4227
1488,Ragnar,Wathall,rwathalllz@nih.gov,Account Representative III,7439,1954,9393
1227,Cecile,Crowest,ccrowestm1@webeden.co.uk,Quality Control Specialist,5143,1853,6996
1907,Minette,Pevsner,mpevsnerm3@barnesandnoble.com,Food Chemist,6019,1972,7991
1897,Elisa,Ventura,eventuram5@nifty.com,Automation Specialist IV,8415,1737,10152
1933,Neddy,Sergeant,nsergeantm7@constantcontact.com,Environmental Specialist,2312,1659,3971
1687,Gamaliel,Secret,gsecretma@elegantthemes.com,Financial Advisor,1959,1468,3427
1805,Michaela,Lambirth,mlambirthmc@ovh.net,Assistant Media Planner,6678,1139,7817
1407,Melodee,McAndrew,mmcandrewmd@google.ru,Analyst Programmer,2171,1783,3954
1454,Chip,Polak,cpolakme@prweb.com,Financial Analyst,2660,214,2874
1405,Jamaal,McPake,jmcpakemf@examiner.com,Systems Administrator I,5654,617,6271
1709,Eachelle,Dregan,edreganmg@unesco.org,Analyst Programmer,2454,1885,4339
1872,Karena,Packham,kpackhammh@reddit.com,Staff Scientist,2096,1184,3280
1988,Mureil,Doolan,mdoolanmj@goo.ne.jp,Database Administrator IV,9019,1620,10639
1014,Karee,Tesdale,ktesdalemk@webnode.com,Electrical Engineer,3092,630,3722
1888,Phaidra,Pettecrew,ppettecrewmm@biblegateway.com,Occupational Therapist,5335,289,5624
1252,Lonna,Huggett,lhuggettmo@about.com,Social Worker,8501,1715,10216
1061,Flin,Servante,fservantemt@typepad.com,Geologist III,8836,743,9579
1754,Chrissy,Bagnold,cbagnoldmw@blog.com,Occupational Therapist,6111,954,7065
1433,Dulcinea,Radden,draddenmx@etsy.com,Assistant Media Planner,7707,465,8172
1900,Hall,Carnock,hcarnockmz@rakuten.co.jp,Automation Specialist III,2107,1396,3503
1156,Patty,Matityahu,pmatityahun1@netlog.com,Design Engineer,5563,1049,6612
1393,Neille,Applin,napplinn6@icq.com,Civil Engineer,7526,1917,9443
1505,Donny,Prine,dprinen7@squarespace.com,Senior Financial Analyst,2093,1770,3863
1578,Gradey,Cantos,gcantosn8@rambler.ru,Statistician I,3446,1914,5360
1733,Hadria,Pencost,hpencostn9@angelfire.com,VP Quality Control,3730,1539,5269
1510,Brucie,Fass,bfassna@pinterest.com,Research Assistant IV,9264,201,9465
1253,Layla,Barnsdall,lbarnsdallnd@dell.com,Human Resources Manager,3352,575,3927
1033,Cly,Snary,csnarynh@hibu.com,Librarian,3990,1991,5981
1059,Nora,Sibary,nsibaryni@elpais.com,Legal Assistant,1321,1507,2828
1548,Imogene,Whittenbury,iwhittenburynj@google.com.au,Speech Pathologist,1828,1230,3058
1918,Lucas,Perotti,lperottino@chronoengine.com,Staff Accountant II,5519,1501,7020
1203,Nicoline,Shiell,nshiellnq@umich.edu,Librarian,6712,1603,8315
1180,Nissie,MacFarlan,nmacfarlannt@shareasale.com,Geologist II,8859,529,9388
1683,Micah,Upsale,mupsalenv@angelfire.com,Nurse Practicioner,7169,1177,8346
1730,Barton,Mattiussi,bmattiussiny@edublogs.org,Project Manager,4833,1007,5840
1107,Khalil,M'Chirrie,kmchirrieo0@zdnet.com,Financial Advisor,7134,1074,8208
1295,Purcell,Molnar,pmolnaro2@odnoklassniki.ru,Graphic Designer,4449,1794,6243
1216,Quintilla,Tolmie,qtolmieo5@naver.com,Structural Engineer,8201,1724,9925
1579,Nanete,Duran,ndurano9@cpanel.net,Geological Engineer,7934,1701,9635
1540,Adrian,Iacabucci,aiacabucciob@imdb.com,Marketing Assistant,4874,1201,6075
1145,Desmund,Suddock,dsuddockoc@nytimes.com,Safety Technician I,8733,996,9729
1641,Tiebout,Glasspool,tglasspoolod@google.co.uk,Software Consultant,7280,1375,8655
1646,Arne,Schenkel,aschenkeloe@theglobeandmail.com,Dental Hygienist,5985,1219,7204
1353,Harman,Twine,htwineoh@cisco.com,Recruiter,2327,897,3224
1807,Lissy,Dolle,ldolleoi@example.com,Analog Circuit Design manager,3019,1836,4855
1188,Rosaline,Tibbits,rtibbitsom@si.edu,Nurse Practicioner,2772,576,3348
1856,Cyrus,Evanson,cevansonoo@howstuffworks.com,Senior Developer,7105,1979,9084
1340,Hollyanne,Wort,hwortop@nhs.uk,Chemical Engineer,5317,1542,6859
1472,Lucita,Cotillard,lcotillardor@europa.eu,Physical Therapy Assistant,3284,583,3867
1465,Kissiah,Natalie,knatalieot@desdev.cn,Programmer IV,3624,995,4619
1534,Bella,Southwick,bsouthwickou@ihg.com,Media Manager I,3778,1408,5186
1112,Lammond,Wastall,lwastallow@forbes.com,Project Manager,9316,938,10254
1642,Iggie,Joddins,ijoddinsoz@ucoz.ru,Executive Secretary,7180,795,7975
1792,Rosalia,Allsebrook,rallsebrookp0@prweb.com,Project Manager,4311,463,4774
1839,Eimile,Clive,eclivep1@yahoo.co.jp,Desktop Support Technician,7590,1486,9076
1535,Sheffy,Fermin,sferminp2@biblegateway.com,Account Coordinator,3393,879,4272
1576,Javier,Begg,jbeggp3@chronoengine.com,Quality Control Specialist,5789,1786,7575
1432,Walt,Sabban,wsabbanp4@biglobe.ne.jp,Graphic Designer,1699,1287,2986
1176,Terri,Mayze,tmayzep9@51.la,Geologist IV,4767,813,5580
1876,Sigismond,Blues,sbluespa@tuttocitta.it,Marketing Manager,7381,973,8354
1800,Zonnya,Enser,zenserpb@qq.com,Health Coach II,2851,319,3170
1457,Manon,Ingry,mingrypd@qq.com,Nuclear Power Engineer,1848,1302,3150
1885,Dixie,Gaskins,dgaskinspe@1688.com,Senior Developer,9035,801,9836
1270,Humbert,Wadeson,hwadesonph@ucoz.ru,Dental Hygienist,9223,567,9790
1206,Antoine,Halm,ahalmpl@ow.ly,Senior Quality Engineer,6273,1427,7700
1915,Harriette,Walkley,hwalkleypp@state.tx.us,Systems Administrator III,9235,990,10225
1480,Tiffy,Darwent,tdarwentps@hubpages.com,Executive Secretary,1219,551,1770
1647,Tiffani,Stirtle,tstirtlepx@ning.com,Food Chemist,1772,1272,3044
1583,Demott,Temporal,dtemporalq0@netlog.com,Desktop Support Technician,8815,1846,10661
1931,Janette,Skene,jskeneq8@livejournal.com,Tax Accountant,6853,1406,8259
1861,Christina,Emanuele,cemanueleq9@mozilla.org,Office Assistant I,9531,1155,10686
1458,Shandee,Kovalski,skovalskiqc@blinklist.com,Account Coordinator,3705,1286,4991
1711,Hannie,Hazeldene,hhazeldeneqd@ning.com,Director of Sales,3855,1915,5770
1860,Imelda,Skakunas,iskakunasqm@webs.com,GIS Technical Architect,6472,319,6791
1104,Julita,Hintzer,jhintzerqn@addtoany.com,Geological Engineer,7355,1613,8968
1357,Benyamin,Gebhardt,bgebhardtqo@histats.com,Accounting Assistant IV,5948,925,6873
1133,Lissa,Borrows,lborrowsqq@apple.com,Web Developer II,2002,1683,3685
1489,Robert,Plom,rplomqt@drupal.org,Assistant Media Planner,8544,811,9355
1627,Lorant,Thwaites,lthwaitesqv@github.com,Web Developer IV,2865,1715,4580
1547,Rozelle,Winders,rwindersqx@amazon.co.uk,Dental Hygienist,4636,1007,5643
1024,Cameron,Jedrzejkiewicz,cjedrzejkiewiczqy@columbia.edu,Research Assistant I,4199,645,4844
1430,Fredek,Renackowna,frenackownaqz@sphinn.com,Teacher,1472,1579,3051
1363,Liam,Kinghorn,lkinghornr0@wsj.com,VP Accounting,3042,1809,4851
1057,Fritz,Maxstead,fmaxsteadr3@tinyurl.com,Health Coach IV,7103,599,7702
1299,Saunder,Iacovucci,siacovuccir6@nytimes.com,Project Manager,8737,1817,10554
1847,Ruby,Rickert,rrickertr9@angelfire.com,Programmer I,8182,1971,10153
1960,Danell,Feely,dfeelyre@weather.com,Web Developer I,6050,1517,7567
1016,Gertrudis,Dalligan,gdalliganrf@simplemachines.org,GIS Technical Architect,8124,513,8637
1904,Moore,Treacy,mtreacyrg@dailymail.co.uk,Software Engineer I,7919,422,8341
1993,Avery,McKelvey,amckelveyrh@liveinternet.ru,Safety Technician I,8498,1940,10438
1451,Israel,Hammell,ihammellri@archive.org,Geologist IV,9652,395,10047
1473,Pierce,Biggar,pbiggarrj@trellian.com,Civil Engineer,5793,1176,6969
1887,Mireille,Hardey,mhardeyrl@yale.edu,Editor,6860,1403,8263
1346,Ben,Kahler,bkahlerrn@amazon.co.jp,Web Developer IV,5189,439,5628
1652,Nertie,Cowern,ncowernrq@amazon.co.jp,Statistician III,2550,900,3450
Second Highest Salary = 11975,Average Salary = 6609.59,,,,,,
